"city","point_latitude","point_longitude","covid_status_no_symptoms","covid_status_self_isolation_after_exposure","covid_status_test_positive","covid_status_symptoms","covid_status_symptoms_not_covid","covid_status_test_positive_recovered","covid_status_symptoms_recovered","covid_status_total_responses","self_isolation_steps_not_leaving_house","self_isolation_steps_work_and_essentials","self_isolation_steps_essentials","self_isolation_steps_none","self_isolation_steps_total_responses","amount_of_contact_no_large_groups","amount_of_contact_reduced_contact","amount_of_contact_minimal_contact","amount_of_contact_none","amount_of_contact_total_responses","current_work_car","current_work_retired","current_work_wfh","current_work_public_transport","current_work_bike_or_walk","current_work_total_responses"
"10 de Abril","16.82917","-99.74083","1","0","0","0","0","0","0","1","0","1","0","0","1","0","0","1","0","1","1","0","0","0","0","1"
"12 de Diciembre (Sombreretillo)","24.70833","-103.57361","1","0","0","0","0","0","0","1","0","0","0","0","0","1","0","0","0","1","1","0","0","0","0","1"
"17 de Octubre","26.79806","-109.70222","1","0","0","0","0","0","0","1","0","1","0","0","1","0","1","0","0","1","0","0","1","0","0","1"
"1 Decembrie","44.29083","26.05806","1","0","0","0","0","0","0","1","0","1","0","0","1","0","0","1","0","1","1","0","0","0","0","1"
"23 August","45.52303","22.3993","2","0","0","0","0","0","0","2","0","0","0","0","0","2","0","0","0","2","0","0","2","0","0","2"
"23 August","43.91667","28.58333","2","0","0","0","0","0","0","2","0","0","0","0","0","2","0","0","0","2","0","0","2","0","0","2"
"2.Bezirk","46.6251","14.3091","0","1","0","0","1","0","0","2","0","1","1","0","2","1","0","1","0","2","0","0","1","0","1","2"
"3.Bezirk","46.62263","14.31036","1","0","0","0","0","0","0","1","0","1","0","0","1","1","0","0","0","1","0","0","1","0","0","1"
"Aach","49.78333","6.6","1","0","0","0","0","0","0","1","0","0","0","0","0","1","0","0","0","1","1","0","0","0","0","1"
"Aach","47.8424","8.85384","1","0","0","0","0","0","0","1","0","0","0","0","0","1","0","0","0","1","1","0","0","0","0","1"
"Aachen","50.77664","6.08342","3","0","0","0","0","0","0","3","0","2","1","0","3","0","1","2","0","3","0","0","2","1","0","3"
"Aagtdorp","52.69","4.70417","2","0","0","0","0","0","0","2","0","2","0","0","2","2","0","0","0","2","0","1","1","0","0","2"
"Aagtekerke","51.54667","3.50972","1","0","0","0","0","0","0","1","0","0","1","0","1","0","0","1","0","1","0","0","1","0","0","1"
"Aalborg","57.048","9.9187","3","0","0","0","0","0","0","3","0","1","0","0","1","2","0","1","0","3","0","2","1","0","0","3"
"Aalburg","51.75482","5.13156","0","1","0","0","0","0","0","1","0","0","1","0","1","0","0","1","0","1","0","1","0","0","0","1"
"Aaley","33.80528","35.6","3","0","0","0","0","0","0","3","2","0","1","0","3","0","2","2","0","4","1","0","2","0","0","3"
"Aalst","50.93604","4.0355","1","1","0","0","0","0","0","2","1","1","0","0","2","0","0","1","1","2","0","0","1","0","1","2"
"Aalst","51.7825","5.12778","1","1","0","0","0","0","0","2","1","1","0","0","2","0","0","1","1","2","0","0","1","0","1","2"
"Aalst","51.39667","5.47778","1","1","0","0","0","0","0","2","1","1","0","0","2","0","0","1","1","2","0","0","1","0","1","2"
"Aalter","51.09017","3.44693","2","0","0","0","0","0","0","2","0","1","0","1","2","2","0","0","0","2","0","0","2","0","0","2"
"Aarau","47.39254","8.04422","2","0","0","0","0","0","0","2","1","0","0","0","1","0","1","1","0","2","0","1","1","0","0","2"
"Aarberg","47.04439","7.27578","1","0","0","0","0","0","0","1","0","0","0","0","0","0","0","1","0","1","0","0","1","0","0","1"
"Aaronsburg","40.89979","-77.45332","2","1","0","1","0","0","0","4","2","1","1","0","4","1","0","2","1","4","0","0","1","1","2","4"
"Aarschot","50.98715","4.83695","1","0","0","0","0","0","0","1","0","0","1","0","1","0","0","1","0","1","0","1","0","0","0","1"
"Aba","5.10658","7.36667","6","0","0","0","0","0","0","6","2","0","2","0","4","1","4","1","0","6","2","0","4","0","0","6"
"Aba","47.02907","18.52172","6","0","0","0","0","0","0","6","2","0","2","0","4","1","4","1","0","6","2","0","4","0","0","6"
"Aba","32.90594","101.70625","6","0","0","0","0","0","0","6","2","0","2","0","4","1","4","1","0","6","2","0","4","0","0","6"
"Abaca","11.1342","122.7156","8","0","0","0","0","0","0","8","3","3","0","1","7","6","1","1","0","8","1","0","5","0","2","8"
"Abaca","9.9204","124.5051","8","0","0","0","0","0","0","8","3","3","0","1","7","6","1","1","0","8","1","0","5","0","2","8"
"Abadan","30.3392","48.3043","1","0","0","0","0","0","0","1","1","0","0","0","1","1","0","0","0","1","0","0","1","0","0","1"
"Abadan","38.05415","58.19721","1","0","0","0","0","0","0","1","1","0","0","0","1","1","0","0","0","1","0","0","1","0","0","1"
"Abades","40.91646","-4.26937","1","0","0","0","0","0","0","1","1","0","0","0","1","0","0","1","0","1","0","0","1","0","0","1"
"Abadou","31.57917","-7.31308","1","0","0","0","0","0","0","1","1","0","0","0","1","0","0","1","0","1","0","1","0","0","0","1"
"Abádszalók","47.46667","20.6","1","0","0","0","0","0","0","1","0","1","0","0","1","0","0","1","0","1","0","0","1","0","0","1"
"Abaeté","-19.16","-45.44583","4","0","0","0","0","0","0","4","0","0","1","1","2","2","1","1","0","4","2","0","2","0","0","4"
"Abagana","6.19031","6.99357","7","0","0","0","0","0","1","8","2","4","0","0","6","6","2","0","0","8","3","0","3","1","1","8"
"Abaji","8.47372","6.94453","3","0","0","0","0","0","0","3","1","1","0","1","3","2","0","0","1","3","0","0","2","0","1","3"
"Abak","4.98236","7.78922","1","0","0","0","0","0","0","1","1","0","0","0","1","1","0","0","0","1","0","0","1","0","0","1"
"Abakaliki","6.32485","8.11368","4","0","0","0","0","0","0","4","1","2","0","0","3","2","1","0","0","3","1","0","2","0","1","4"
"Abalak","15.4509","6.2793","0","0","0","0","0","0","0","0","0","0","0","0","0","0","0","1","0","1","1","0","0","0","0","1"
"Abalak","58.12861","68.59444","0","0","0","0","0","0","0","0","0","0","0","0","0","0","0","1","0","1","1","0","0","0","0","1"
"Abana","41.97858","34.011","2","0","0","0","0","0","0","2","1","1","0","0","2","1","0","1","0","2","0","0","1","0","1","2"
"Abancay","-13.63389","-72.88139","1","0","0","0","0","0","0","1","0","0","1","0","1","0","0","1","0","1","0","0","1","0","0","1"
"Abancourt","49.69607","1.76512","0","0","0","0","1","0","0","1","0","0","0","0","0","0","0","1","0","1","0","1","0","0","0","1"
"Abano Terme","45.35753","11.78725","0","1","0","0","0","0","0","1","0","0","1","0","1","0","0","1","0","1","0","0","1","0","0","1"
"‘Abasān al Jadīdah","31.34158","34.34592","1","0","0","0","0","0","0","1","0","0","0","0","0","1","0","0","0","1","1","0","0","0","0","1"
"Abbadia","43.48821","13.53644","2","0","0","0","0","0","0","2","0","0","1","0","1","0","0","2","0","2","0","0","1","0","1","2"
"Abbaretz","47.55314","-1.532","6","0","0","0","0","0","0","6","0","2","2","0","4","2","2","2","0","6","0","1","5","0","0","6"
"Abberton","51.83435","0.91084","50","2","0","1","3","0","1","57","11","9","18","1","39","15","6","34","2","57","9","16","31","1","0","57"
"Abbeville","29.97465","-92.13429","39","3","2","4","4","0","3","55","17","7","7","2","33","13","13","28","1","55","10","8","35","2","0","55"
"Abbeville","31.57184","-85.25049","39","3","2","4","4","0","3","55","17","7","7","2","33","13","13","28","1","55","10","8","35","2","0","55"
"Abbeville","31.99212","-83.30682","39","3","2","4","4","0","3","55","17","7","7","2","33","13","13","28","1","55","10","8","35","2","0","55"
"Abbeville","34.17817","-82.37901","39","3","2","4","4","0","3","55","17","7","7","2","33","13","13","28","1","55","10","8","35","2","0","55"
"Abbeville","50.10521","1.83547","39","3","2","4","4","0","3","55","17","7","7","2","33","13","13","28","1","55","10","8","35","2","0","55"
"Abbévillers","47.43205","6.91651","1","0","0","0","0","0","0","1","0","1","0","0","1","0","0","0","1","1","0","1","0","0","0","1"
"Abbey","-33.66364","115.25635","1","0","0","0","0","0","0","1","0","1","0","0","1","0","0","1","0","1","0","1","0","0","0","1"
"Abbey Dore","51.96667","-2.9","302","13","1","24","47","0","30","417","75","136","122","10","343","168","57","186","7","418","73","87","243","4","11","418"
"Abbeyfeale","52.38139","-9.3025","1","0","0","0","1","0","0","2","0","0","2","0","2","1","1","0","0","2","0","1","1","0","0","2"
"Abbeyleix","52.91331","-7.34456","1","1","0","0","0","0","1","3","0","2","1","0","3","0","2","1","0","3","1","1","1","0","0","3"
"Abbey Wood","51.48688","0.10747","26","1","0","1","4","0","1","33","3","7","18","0","28","17","4","13","0","34","6","9","18","0","1","34"
"Abbots Bromley","52.81705","-1.87694","13","0","0","0","1","0","0","14","2","3","2","0","7","7","1","6","0","14","2","3","9","0","0","14"
"Abbotsbury","-33.8701","150.86119","12","0","0","0","1","0","0","13","0","10","2","1","13","6","7","0","0","13","9","0","4","0","0","13"
"Abbotsford","49.05798","-122.25257","11","1","0","0","1","0","0","13","5","3","2","0","10","4","2","7","0","13","4","2","7","0","0","13"
"Abbotsford","44.94636","-90.31597","11","1","0","0","1","0","0","13","5","3","2","0","10","4","2","7","0","13","4","2","7","0","0","13"
"Abbotsford","-37.8","145","11","1","0","0","1","0","0","13","5","3","2","0","10","4","2","7","0","13","4","2","7","0","0","13"
"Abbotsford","-33.84889","151.12801","11","1","0","0","1","0","0","13","5","3","2","0","10","4","2","7","0","13","4","2","7","0","0","13"
"Abbotskerswell","50.50816","-3.61342","4","1","0","0","0","0","0","5","0","2","2","0","4","2","2","1","0","5","0","0","5","0","0","5"
"Abbots Langley","51.70573","-0.41757","7","0","0","0","2","0","0","9","2","0","2","3","7","3","1","3","2","9","0","3","6","0","0","9"
"Abbottabad","34.1463","73.21168","20","2","0","0","0","0","1","23","10","2","4","1","17","12","3","6","1","22","6","4","11","0","2","23"
"Abbotts Ann","51.19016","-1.53234","1","0","0","0","0","0","0","1","1","0","0","0","1","0","0","1","0","1","0","0","1","0","0","1"
"Āb-e Kamarī","35.08796","63.0678","1","0","0","0","0","0","0","1","0","0","1","0","1","0","1","0","0","1","0","0","1","0","0","1"
"Abeokuta","7.15571","3.34509","4","0","0","0","1","0","0","5","0","4","0","1","5","1","3","1","0","5","2","0","1","0","2","5"
"Abepura","-2.5964","140.6324","5","0","0","0","0","0","0","5","0","3","1","0","4","2","1","2","0","5","2","1","1","1","0","5"
"Aber","53.23333","-4.01667","2","0","0","0","0","0","0","2","0","0","1","0","1","2","0","0","0","2","0","1","1","0","0","2"
"Abercanaid","51.72361","-3.36611","2","0","0","0","0","0","0","2","0","1","1","0","2","1","1","0","0","2","1","1","0","0","0","2"
"Abercarn","51.64733","-3.13476","3","0","0","0","0","0","0","3","1","0","2","0","3","0","1","2","0","3","1","2","0","0","0","3"
"Abercrombie","-33.38867","149.5458","2","0","0","0","0","0","0","2","0","0","1","0","1","1","0","1","0","2","0","2","0","0","0","2"
"Abercynon","51.64548","-3.32727","1","0","0","0","0","0","1","2","0","0","1","0","1","0","0","2","0","2","0","0","2","0","0","2"
"Aberdare","51.71438","-3.44918","8","0","0","0","0","0","0","8","1","6","1","0","8","3","3","2","0","8","3","2","2","1","0","8"
"Aberdare","-32.84112","151.38168","8","0","0","0","0","0","0","8","1","6","1","0","8","3","3","2","0","8","3","2","2","1","0","8"
"Aberdeen","46.97537","-123.81572","23","0","0","0","3","0","1","27","7","9","9","0","25","9","6","12","0","27","3","7","16","0","1","27"
"Aberdeen","42.94408","-112.83833","23","0","0","0","3","0","1","27","7","9","9","0","25","9","6","12","0","27","3","7","16","0","1","27"
"Aberdeen","45.4647","-98.48648","23","0","0","0","3","0","1","27","7","9","9","0","25","9","6","12","0","27","3","7","16","0","1","27"
"Aberdeen","33.82511","-88.54366","23","0","0","0","3","0","1","27","7","9","9","0","25","9","6","12","0","27","3","7","16","0","1","27"
"Aberdeen","41.43893","-87.11142","23","0","0","0","3","0","1","27","7","9","9","0","25","9","6","12","0","27","3","7","16","0","1","27"
"Aberdeen","38.65563","-83.76103","23","0","0","0","3","0","1","27","7","9","9","0","25","9","6","12","0","27","3","7","16","0","1","27"
"Aberdeen","26.55063","-80.14866","23","0","0","0","3","0","1","27","7","9","9","0","25","9","6","12","0","27","3","7","16","0","1","27"
"Aberdeen","35.13155","-79.42948","23","0","0","0","3","0","1","27","7","9","9","0","25","9","6","12","0","27","3","7","16","0","1","27"
"Aberdeen","39.50956","-76.16412","23","0","0","0","3","0","1","27","7","9","9","0","25","9","6","12","0","27","3","7","16","0","1","27"
"Aberdeen","57.14369","-2.09814","23","0","0","0","3","0","1","27","7","9","9","0","25","9","6","12","0","27","3","7","16","0","1","27"
"Aberdeen","-32.16588","150.89003","23","0","0","0","3","0","1","27","7","9","9","0","25","9","6","12","0","27","3","7","16","0","1","27"
"Aberdyfi","52.544","-4.04606","1","0","0","0","0","0","1","2","0","1","0","0","1","1","1","0","0","2","0","2","0","0","0","2"
"Aberfan","51.68892","-3.34178","0","0","0","0","1","0","0","1","0","0","1","0","1","0","0","1","0","1","1","0","0","0","0","1"
"Aberfeldy","56.62196","-3.86693","2","0","0","0","0","0","0","2","0","0","2","0","2","1","0","1","0","2","0","0","2","0","0","2"
"Aberford","53.82604","-1.34231","0","0","0","0","1","0","0","1","1","0","0","0","1","1","0","0","0","1","0","0","1","0","0","1"
"Abergavenny","51.82098","-3.01743","17","2","0","0","1","0","0","20","3","7","9","0","19","4","4","12","0","20","7","3","10","0","0","20"
"Abergele","53.28436","-3.5822","1","0","0","0","0","0","0","1","0","1","0","0","1","0","1","0","0","1","1","0","0","0","0","1"
"Abergwili","51.86593","-4.26969","1","0","0","0","0","0","0","1","0","1","0","0","1","1","0","0","0","1","1","0","0","0","0","1"
"Abersoch","52.82437","-4.50584","1","0","0","0","0","0","0","1","0","1","0","0","1","1","0","0","0","1","0","1","0","0","0","1"
"Abertillery","51.72981","-3.13432","3","0","0","0","1","0","0","4","2","0","2","0","4","0","1","2","1","4","0","2","2","0","0","4"
"Abertridwr","51.59583","-3.26833","0","0","0","0","1","0","0","1","0","1","0","0","1","0","0","1","0","1","1","0","0","0","0","1"
"Aberystwyth","52.41548","-4.08292","4","0","0","0","1","0","0","5","2","0","3","0","5","0","1","4","0","5","1","0","4","0","0","5"
"Abha","18.21639","42.50528","4","0","0","0","1","0","0","5","0","1","1","1","3","2","1","2","0","5","2","1","2","0","0","5"
"Abhaneri","27.00743","76.6076","7","0","0","0","0","0","0","7","5","0","1","0","6","2","0","4","1","7","0","0","6","0","0","6"
"Abhayāpuri","26.32255","90.68526","61","1","0","1","0","1","1","65","40","2","13","3","58","22","14","25","4","65","3","6","49","1","6","65"
"Abidjan","5.35444","-4.00167","7","0","0","0","0","0","0","7","0","1","3","0","4","4","3","0","0","7","2","0","4","1","0","7"
"Abiko","35.86667","140.01667","3","0","0","0","0","0","0","3","0","0","0","1","1","2","0","0","1","3","1","0","0","1","1","3"
"Abingdon","40.80448","-90.4018","9","1","0","0","1","0","1","12","1","2","7","0","10","3","3","6","0","12","2","1","9","0","0","12"
"Abingdon","36.70983","-81.97735","9","1","0","0","1","0","1","12","1","2","7","0","10","3","3","6","0","12","2","1","9","0","0","12"
"Abingdon","51.67109","-1.28278","9","1","0","0","1","0","1","12","1","2","7","0","10","3","3","6","0","12","2","1","9","0","0","12"
"Abirāmam","9.4423","78.4399","2","0","0","0","0","0","0","2","2","0","0","0","2","1","0","0","1","2","0","1","1","0","0","2"
"Abnūb","27.26881","31.15232","1","0","0","0","0","0","0","1","0","0","0","0","0","0","1","0","0","1","1","0","0","0","0","1"
"Aboh","5.54781","6.52588","0","0","0","0","0","0","0","0","0","0","0","0","0","0","0","0","0","0","0","0","0","0","0","0"
"Aboh","5.47569","7.27161","0","0","0","0","0","0","0","0","0","0","0","0","0","0","0","0","0","0","0","0","0","0","0","0"
"Abohar","30.14453","74.19552","2","0","0","0","0","0","0","2","1","0","0","1","2","2","0","0","0","2","0","1","1","0","0","2"
"Abovyan","40.04851","44.54742","1","0","0","0","0","0","0","1","0","0","1","0","1","0","0","1","0","1","0","0","1","0","0","1"
"Abovyan","40.27368","44.63348","1","0","0","0","0","0","0","1","0","0","1","0","1","0","0","1","0","1","0","0","1","0","0","1"
"Aboyne","57.07546","-2.78023","1","0","0","0","1","0","0","2","0","0","2","0","2","0","0","2","0","2","0","1","1","0","0","2"
"Abqaiq","25.93402","49.6688","4","0","0","0","0","0","0","4","1","1","0","0","2","2","1","1","0","4","1","1","1","1","0","4"
"Abrantes","39.46667","-8.2","1","0","0","0","0","0","0","1","0","1","0","0","1","1","0","0","0","1","0","0","1","0","0","1"
"Abra Pampa","-22.72049","-65.69697","5","1","0","0","0","0","0","6","3","1","0","0","4","1","1","3","1","6","2","1","2","1","0","6"
"Abrikosovka","45.27058","33.19125","1","0","0","0","0","0","0","1","0","1","0","0","1","0","1","0","0","1","0","0","0","0","1","1"
"Abrikosovka","45.10759","35.10139","1","0","0","0","0","0","0","1","0","1","0","0","1","0","1","0","0","1","0","0","0","0","1","1"
"Abrikosovo","45.69236","34.10156","1","0","0","0","0","0","0","1","0","1","0","0","1","0","0","1","0","1","0","0","1","0","0","1"
"Abs","16.00295","43.19725","1","0","0","0","0","0","0","1","0","1","0","0","1","0","0","0","0","0","0","0","0","0","1","1"
"Abua","4.85763","6.64519","1","0","0","0","0","0","0","1","0","1","0","0","1","1","0","0","0","1","1","0","0","0","0","1"
"Abū al Maţāmīr","30.91018","30.17438","7","0","0","0","1","0","0","8","1","6","1","0","8","4","2","2","0","8","5","0","2","1","0","8"
"Abū ‘Arīsh","16.96887","42.83251","2","0","0","0","0","0","0","2","1","1","0","0","2","1","1","0","0","2","0","0","1","0","0","1"
"Abu Dhabi","24.45118","54.39696","26","0","0","0","0","0","0","26","6","9","0","0","15","13","4","9","0","26","11","2","8","4","2","27"
"Abudu","6.29489","6.02995","1","0","0","0","0","0","0","1","0","0","0","0","0","0","0","0","0","0","0","0","0","0","1","1"
"Abudula","46.84635","83.27552","0","1","0","0","0","0","0","1","1","0","0","0","1","0","0","1","0","1","0","0","1","0","0","1"
"Abu Fatira","29.19746","48.10278","1","0","0","0","0","0","0","1","0","1","0","0","1","0","1","0","0","1","1","0","0","0","0","1"
"Abū Ghurayb","33.30563","44.18477","3","0","0","0","0","0","0","3","3","0","0","0","3","1","0","2","0","3","0","0","3","0","0","3"
"Abuja","9.05785","7.49508","23","0","0","0","2","0","0","25","6","13","1","3","23","16","2","7","1","26","13","0","9","1","4","27"
"Abū Kabīr","30.72508","31.67148","3","1","0","1","0","0","0","5","2","2","0","0","4","2","2","1","0","5","2","1","2","0","0","5"
"Abū Qalqal","36.43806","38.11984","1","0","0","0","0","0","0","1","0","1","0","0","1","1","0","0","0","1","0","0","1","0","0","1"
"Aburi","5.84802","-0.17449","1","0","0","0","0","0","0","1","0","1","0","0","1","1","0","0","0","1","1","0","0","0","0","1"
"Abū Tīj","27.04514","31.31845","1","0","0","0","0","0","0","1","0","0","0","1","1","1","0","0","0","1","0","0","1","0","0","1"
"Åbybro","57.16249","9.72996","1","0","0","0","0","0","0","1","1","0","0","0","1","0","0","1","0","1","0","1","0","0","0","1"
"Acarí","-15.42393","-74.61361","1","0","0","0","0","0","0","1","0","0","0","0","0","0","0","1","0","1","0","0","1","0","0","1"
"Acarigua","9.55451","-69.19564","4","0","0","0","0","0","0","4","1","1","1","0","3","1","2","1","0","4","1","1","1","1","0","4"
"Acarlar","37.82444","27.74667","2","0","0","1","0","0","0","3","0","1","1","0","2","1","0","2","0","3","0","0","2","0","1","3"
"Acas","-10.45778","-77.32729","0","0","0","0","0","0","1","1","0","0","0","0","0","0","0","1","0","1","0","1","0","0","0","1"
"Accra","5.55602","-0.1969","34","0","0","0","1","0","0","35","11","10","2","2","25","17","10","6","1","34","13","1","13","2","6","35"
"Accrington","53.75379","-2.35863","8","0","0","0","0","0","1","9","2","5","2","0","9","2","1","5","0","8","1","1","7","0","0","9"
"Achacachi","-16.05","-68.68333","1","0","0","0","0","0","0","1","0","1","0","0","1","0","0","1","0","1","0","0","1","0","0","1"
"Acharávi","39.7936","19.81736","1","0","0","0","0","0","0","1","0","1","0","0","1","1","0","0","0","1","1","0","0","0","0","1"
"Acharnés","38.08333","23.73333","2","0","0","0","0","0","0","2","1","1","0","0","2","1","0","1","0","2","1","0","1","0","0","2"
"Achhām","29.05","81.3","2","0","0","0","0","0","0","2","1","1","0","0","2","0","1","1","0","2","0","0","1","0","1","2"
"Achladochóri","40.83703","22.34227","1","0","0","0","0","0","0","1","1","0","0","0","1","1","0","0","0","1","0","0","1","0","0","1"
"Achladochóri","41.31976","23.54026","1","0","0","0","0","0","0","1","1","0","0","0","1","1","0","0","0","1","0","0","1","0","0","1"
"Acıpayam","37.42385","29.34941","1","0","0","0","0","0","0","1","1","0","0","0","1","0","0","1","0","1","0","0","1","0","0","1"
"A Coruña","43.37135","-8.396","1","0","0","0","0","0","0","1","1","0","0","0","1","1","0","0","0","1","0","1","0","0","0","1"
"Acoyapa","11.97028","-85.17113","1","0","0","0","0","0","0","1","0","1","0","0","1","1","0","0","0","1","0","0","1","0","0","1"
"Acre","32.92814","35.07647","1","1","0","0","0","0","0","2","1","0","0","0","1","2","0","0","0","2","1","0","1","0","0","2"
"Acton","34.46999","-118.19674","1","0","0","0","0","0","0","1","0","0","0","0","0","1","0","0","0","1","0","0","1","0","0","1"
"Acton","42.48509","-71.43284","1","0","0","0","0","0","0","1","0","0","0","0","0","1","0","0","0","1","0","0","1","0","0","1"
"Acton","43.53425","-70.90978","1","0","0","0","0","0","0","1","0","0","0","0","0","1","0","0","0","1","0","0","1","0","0","1"
"Acton","52.45","-3.01667","1","0","0","0","0","0","0","1","0","0","0","0","0","1","0","0","0","1","0","0","1","0","0","1"
"Acton","51.50901","-0.2762","1","0","0","0","0","0","0","1","0","0","0","0","0","1","0","0","0","1","0","0","1","0","0","1"
"Acton","-35.27767","149.11829","1","0","0","0","0","0","0","1","0","0","0","0","0","1","0","0","0","1","0","0","1","0","0","1"
"Acton Vale","45.65007","-72.56582","1","0","0","0","0","0","0","1","0","1","0","0","1","0","0","1","0","1","0","0","0","1","0","1"
"Acworth","34.06635","-84.67837","1","0","0","0","0","0","0","1","0","0","0","0","0","1","0","0","0","1","0","0","1","0","0","1"
"Acworth","43.21785","-72.29203","1","0","0","0","0","0","0","1","0","0","0","0","0","1","0","0","0","1","0","0","1","0","0","1"
"Ada","34.77453","-96.67834","1","0","0","0","1","0","0","2","1","0","0","0","1","0","2","0","0","2","1","1","0","0","0","2"
"Ada","47.29969","-96.51535","1","0","0","0","1","0","0","2","1","0","0","0","1","0","2","0","0","2","1","1","0","0","0","2"
"Ada","40.7695","-83.82271","1","0","0","0","1","0","0","2","1","0","0","0","1","0","2","0","0","2","1","1","0","0","0","2"
"Ada","45.8025","20.12583","1","0","0","0","1","0","0","2","1","0","0","0","1","0","2","0","0","2","1","1","0","0","0","2"
"Adado","6.13603","46.62761","0","0","0","0","1","0","0","1","0","0","1","0","1","0","0","0","1","1","0","0","1","0","0","1"
"Adam","46.02868","27.73296","1","0","0","0","0","0","0","1","0","1","0","0","1","0","1","0","0","1","1","0","0","0","0","1"
"Adam","22.37934","57.52718","1","0","0","0","0","0","0","1","0","1","0","0","1","0","1","0","0","1","1","0","0","0","0","1"
"Adampur","31.43224","75.71484","1","0","0","0","0","0","0","1","1","0","0","0","1","0","0","1","0","1","0","0","1","0","0","1"
"Adana","36.98615","35.32531","1","0","0","0","0","0","0","1","0","0","0","0","0","0","1","0","0","1","0","0","1","0","0","1"
"Adâncata","47.73333","26.3","1","0","0","0","0","0","0","1","1","0","0","0","1","0","0","1","0","1","0","1","0","0","0","1"
"Adâncata","44.76667","26.43333","1","0","0","0","0","0","0","1","1","0","0","0","1","0","0","1","0","1","0","1","0","0","0","1"
"Adapazarı","40.78056","30.40333","1","0","0","0","0","0","0","1","0","0","1","0","1","0","1","0","0","1","0","1","0","0","0","1"
"Adar","30.14111","-8.37221","1","0","0","0","0","0","0","1","1","0","0","0","1","0","0","0","1","1","0","0","1","0","0","1"
"Adare","52.56194","-8.79556","2","0","0","0","0","0","0","2","0","2","0","0","2","1","1","0","0","2","2","0","0","0","0","2"
"Adare","-27.51267","152.29537","2","0","0","0","0","0","0","2","0","2","0","0","2","1","1","0","0","2","2","0","0","0","0","2"
"Adaúfe","41.58732","-8.39817","1","0","0","0","0","0","0","1","0","0","0","0","0","1","0","0","0","1","0","1","0","0","0","1"
"Ad Dawādimī","24.50772","44.39237","1","0","0","0","0","0","0","1","0","1","0","0","1","0","1","0","0","1","0","0","1","0","0","1"
"Addingham","53.94452","-1.88424","1","0","0","0","0","0","0","1","0","1","1","0","2","0","0","2","0","2","0","0","2","0","0","2"
"Addis Ababa","9.02497","38.74689","44","3","0","0","0","0","0","47","11","18","3","11","43","17","17","8","4","46","18","4","12","9","4","47"
"Ad Dīwānīyah","31.99289","44.92552","6","1","0","0","0","0","0","7","3","1","1","1","6","2","1","3","1","7","2","0","5","0","0","7"
"Addlestone","51.37135","-0.49353","5","0","0","1","0","0","0","6","1","2","2","0","5","3","0","3","0","6","1","2","3","0","0","6"
"Adeje","28.12271","-16.726","1","0","0","0","0","0","0","1","0","0","0","0","0","0","0","1","0","1","0","1","0","0","0","1"
"Adelaide","-32.70747","26.29564","4","0","0","0","0","0","0","4","0","1","1","0","2","3","0","1","0","4","2","1","1","0","0","4"
"Adelaide","-34.92866","138.59863","4","0","0","0","0","0","0","4","0","1","1","0","2","3","0","1","0","4","2","1","1","0","0","4"
"Adelaide city centre","-34.92873","138.60334","0","0","0","0","1","0","0","1","1","0","0","0","1","1","0","0","0","1","0","0","1","0","0","1"
"Aden","12.77944","45.03667","4","0","0","0","0","0","0","4","0","2","0","1","3","2","2","0","0","4","4","0","0","0","0","4"
"Ādīgrat","14.277","39.462","0","0","0","0","0","0","0","0","0","0","0","0","0","0","0","0","0","0","0","0","0","0","0","0"
"Ādilābād","19.67203","78.5359","0","1","0","0","0","0","0","1","1","0","0","0","1","0","1","0","0","1","0","0","1","0","0","1"
"Adil Makmur","5.19843","96.87015","1","0","0","0","0","0","0","1","0","0","0","1","1","0","0","0","1","1","0","0","0","0","1","1"
"Adilpur","27.93677","69.31941","58","6","0","1","1","0","0","66","30","21","3","7","61","36","12","16","2","66","12","4","37","4","9","66"
"Adjumani","3.37786","31.7909","2","0","0","0","0","0","0","2","0","1","0","1","2","1","1","0","0","2","0","0","0","0","2","2"
"Adjuntas","18.16274","-66.72212","1","0","0","0","0","0","0","1","0","1","0","0","1","0","1","0","0","1","1","0","0","0","0","1"
"Adlington","53.61323","-2.60676","1","0","0","0","0","0","0","1","0","0","1","0","1","0","0","1","0","1","0","0","1","0","0","1"
"Adlington","53.32042","-2.13658","1","0","0","0","0","0","0","1","0","0","1","0","1","0","0","1","0","1","0","0","1","0","0","1"
"Ado-Odo","6.59546","2.94176","1","0","0","0","0","0","0","1","0","0","1","0","1","0","1","0","0","1","0","0","1","0","0","1"
"Adorjan","46.00333","20.04007","2","0","0","0","0","0","0","2","0","0","1","0","1","0","1","1","0","2","1","1","0","0","0","2"
"Adrar","27.87429","-0.29388","1","0","0","0","0","0","0","1","0","1","0","0","1","0","1","0","0","1","1","0","0","0","0","1"
"Adraskan","33.64573","62.26959","2","0","0","0","0","0","0","2","1","0","0","1","2","2","0","0","0","2","0","0","1","0","1","2"
"Adria","45.05445","12.05599","1","0","0","0","0","0","0","1","0","0","0","0","0","0","0","1","0","1","1","0","0","0","0","1"
"Adwick le Street","53.57077","-1.18454","6","0","0","0","0","0","0","6","5","1","0","0","6","1","0","5","0","6","1","0","5","0","0","6"
"Adzopé","6.10694","-3.86194","0","0","0","0","0","0","0","0","0","0","0","1","1","0","0","0","1","1","1","0","0","0","0","1"
"Äetsä","61.28333","22.68333","1","0","0","0","0","0","0","1","0","1","0","0","1","0","1","0","0","1","0","1","0","0","0","1"
"Afaha Offiong","4.86226","7.90626","1","0","0","0","0","0","0","1","1","0","0","0","1","0","1","0","0","1","0","0","0","0","0","0"
"Afgooye","2.1381","45.1212","4","0","0","0","0","0","0","4","1","0","0","1","2","3","0","0","1","4","0","0","3","0","1","4"
"Afidnés","38.20332","23.83982","1","0","0","0","0","0","0","1","1","0","0","0","1","0","1","0","0","1","1","0","0","0","0","1"
"Aflao","6.11982","1.19012","2","0","0","0","0","0","0","2","0","1","1","0","2","1","0","1","0","2","0","0","0","1","1","2"
"Aflou","34.11279","2.10228","0","1","0","0","0","0","0","1","0","1","0","0","1","0","0","1","0","1","0","0","0","1","0","1"
"Afula","32.60907","35.2892","1","0","0","0","0","0","0","1","1","0","0","0","1","0","0","1","0","1","0","0","1","0","0","1"
"Afyonkarahisar","38.75667","30.54333","2","0","0","0","0","0","0","2","0","0","0","1","1","1","0","1","0","2","2","0","0","0","0","2"
"Agadez","16.97333","7.99111","5","0","0","0","0","0","0","5","0","5","0","0","5","0","5","0","0","5","0","0","5","0","0","5"
"Agadir","30.42018","-9.59815","6","1","0","0","0","0","0","7","3","2","2","0","7","3","1","3","0","7","1","2","2","1","1","7"
"Agawam","42.06954","-72.61481","1","0","0","0","0","0","0","1","0","1","0","0","1","0","1","0","0","1","0","0","1","0","0","1"
"Agege","6.61563","3.33337","2","0","0","0","0","0","0","2","0","1","1","0","2","0","1","1","0","2","0","0","0","0","1","1"
"Agen","44.20199","0.62055","1","0","0","0","0","0","0","1","0","0","1","0","1","0","0","1","0","1","0","1","0","0","0","1"
"Agía Paraskeví","39.09903","20.99108","2","1","0","0","0","0","0","3","1","1","0","0","2","0","3","0","0","3","2","1","0","0","0","3"
"Agía Paraskeví","40.4815","23.04863","2","1","0","0","0","0","0","3","1","1","0","0","2","0","3","0","0","3","2","1","0","0","0","3"
"Agía Paraskeví","40.94935","23.45706","2","1","0","0","0","0","0","3","1","1","0","0","2","0","3","0","0","3","2","1","0","0","0","3"
"Agía Paraskeví","38.01667","23.83333","2","1","0","0","0","0","0","3","1","1","0","0","2","0","3","0","0","3","2","1","0","0","0","3"
"Agía Paraskeví","39.24792","26.27178","2","1","0","0","0","0","0","3","1","1","0","0","2","0","3","0","0","3","2","1","0","0","0","3"
"Agios Dimitrios","37.93333","23.73333","1","0","0","0","0","0","0","1","0","1","0","0","1","0","0","1","0","1","0","0","1","0","0","1"
"Ágios Nikólaos","38.86886","20.80425","0","0","0","0","0","0","0","0","0","0","0","0","0","0","0","0","0","0","0","0","0","0","0","0"
"Ágios Nikólaos","40.24926","23.69616","0","0","0","0","0","0","0","0","0","0","0","0","0","0","0","0","0","0","0","0","0","0","0","0"
"Ágios Nikólaos","35.19106","25.71524","0","0","0","0","0","0","0","0","0","0","0","0","0","0","0","0","0","0","0","0","0","0","0","0"
"Ágios Panteleímonas","40.72398","21.74825","1","0","0","0","0","0","0","1","0","1","0","0","1","0","0","1","0","1","0","1","0","0","0","1"
"Ágios Pávlos","40.64075","22.96039","1","0","0","0","0","0","0","1","0","0","1","0","1","0","0","1","0","1","1","0","0","0","0","1"
"Ágios Týchon","34.72606","33.13872","0","0","0","0","0","0","1","1","0","0","0","1","1","0","0","0","1","1","0","0","0","0","1","1"
"Agra","46.03668","8.76833","4","0","0","0","0","0","0","4","2","1","0","1","4","1","1","2","0","4","0","0","3","0","1","4"
"Agra","27.18333","78.01667","4","0","0","0","0","0","0","4","2","1","0","1","4","1","1","2","0","4","0","0","3","0","1","4"
"Ağrı","39.71944","43.05139","1","0","0","0","0","0","0","1","1","0","0","0","1","0","0","1","0","1","0","0","1","0","0","1"
"Agrigento","37.31065","13.57661","1","0","0","0","0","0","0","1","0","0","0","0","0","0","0","1","0","1","1","0","0","0","0","1"
"Agua Azul Rancho","14.9","-87.95","1","0","0","0","0","0","0","1","0","1","0","0","1","1","0","0","0","1","1","0","0","0","0","1"
"Agua Blanca","27.11407","-109.73425","2","0","0","0","0","0","0","2","1","1","0","0","2","1","1","0","0","2","1","0","1","0","0","2"
"Agua Blanca","25.8763","-108.11623","2","0","0","0","0","0","0","2","1","1","0","0","2","1","1","0","0","2","1","0","1","0","0","2"
"Agua Blanca","19.22056","-99.47056","2","0","0","0","0","0","0","2","1","1","0","0","2","1","1","0","0","2","1","0","1","0","0","2"
"Agua Blanca","17.48584","-92.6218","2","0","0","0","0","0","0","2","1","1","0","0","2","1","1","0","0","2","1","0","1","0","0","2"
"Agua Blanca","14.49805","-89.64961","2","0","0","0","0","0","0","2","1","1","0","0","2","1","1","0","0","2","1","0","1","0","0","2"
"Agua Blanca","-6.72343","-76.69643","2","0","0","0","0","0","0","2","1","1","0","0","2","1","1","0","0","2","1","0","1","0","0","2"
"Agua Blanca","9.66205","-69.10677","2","0","0","0","0","0","0","2","1","1","0","0","2","1","1","0","0","2","1","0","1","0","0","2"
"Aguascalientes","21.88234","-102.28259","3","0","0","0","0","0","0","3","1","0","0","0","1","1","2","0","0","3","1","1","1","0","0","3"
"Agugliaro","45.3251","11.58496","1","0","0","0","0","0","0","1","0","1","0","0","1","0","0","1","0","1","0","0","0","0","1","1"
"Aguiar da Beira","40.81726","-7.54431","1","0","0","0","0","0","0","1","0","1","0","0","1","0","0","1","0","1","1","0","0","0","0","1"
"Ahero","-0.17359","34.9189","2","0","0","0","0","0","0","2","0","2","0","0","2","0","1","1","0","2","0","0","1","0","1","2"
"Ahmadnagar","19.09457","74.73843","2","0","0","0","0","0","0","2","1","0","0","1","2","2","0","0","0","2","0","0","2","0","0","2"
"Ahmadpur East","29.14269","71.25771","3","0","0","0","0","0","0","3","1","1","1","0","3","1","1","1","0","3","0","0","3","0","0","3"
"Ahmadpur Sial","30.67791","71.74344","2","0","0","0","0","0","0","2","0","1","0","0","1","1","0","1","0","2","1","0","0","1","0","2"
"Ahmedabad","23.02579","72.58727","20","0","0","0","1","0","0","21","13","6","1","0","20","5","2","13","1","21","0","1","15","0","5","21"
"Ahtopol","42.09768","27.93961","1","0","0","0","0","0","0","1","0","0","0","1","1","0","0","0","1","1","0","0","0","0","1","1"
"Ahvaz","31.31901","48.6842","1","0","0","0","0","0","0","1","0","1","0","0","1","1","0","0","0","1","1","0","0","0","0","1"
"Aībak","36.26468","68.01551","1","0","0","0","0","0","0","1","0","1","0","0","1","0","1","0","0","1","0","0","1","0","0","1"
"Aïn Arnat","36.18683","5.31347","1","0","0","0","0","0","0","1","0","0","1","0","1","0","0","1","0","1","0","0","1","0","0","1"
"Aïn Beïda","35.79639","7.39278","1","0","0","0","1","0","0","2","1","0","1","0","2","0","1","1","0","2","0","1","1","0","0","2"
"’Aïn Benian","36.80277","2.92185","1","0","0","0","0","0","0","1","1","0","0","0","1","0","0","1","0","1","0","0","1","0","0","1"
"’Aïn Deheb","34.84218","1.54697","1","0","0","0","0","0","0","1","0","1","0","0","1","0","0","1","0","1","0","0","0","1","0","1"
"Aïn Fakroun","35.97108","6.87374","1","0","0","0","0","0","0","1","1","0","0","0","1","0","0","1","0","1","0","1","0","0","0","1"
"Aïn Touta","35.37675","5.90001","1","0","0","0","0","0","0","1","1","0","0","0","1","1","0","0","0","1","0","0","1","0","0","1"
"Airdrie","51.30011","-114.03528","5","0","0","0","0","0","0","5","0","2","3","0","5","1","2","2","0","5","1","3","1","0","0","5"
"Airdrie","55.86602","-3.98025","5","0","0","0","0","0","0","5","0","2","3","0","5","1","2","2","0","5","1","3","1","0","0","5"
"Airmadidi","1.42804","124.97774","1","0","0","0","0","0","0","1","0","1","0","0","1","1","0","0","0","1","1","0","0","0","0","1"
"Aix-en-Provence","43.5283","5.44973","1","0","0","1","0","0","0","2","1","1","0","0","2","0","1","1","0","2","1","0","1","0","0","2"
"Aizawl","23.72894","92.71791","2","1","0","0","0","0","0","3","1","0","1","0","2","1","2","0","0","3","0","1","1","0","1","3"
"Ajā","30.94162","31.29039","1","0","0","0","0","0","0","1","0","1","0","0","1","0","1","0","0","1","0","0","1","0","0","1"
"‘Ajlūn","32.33326","35.75279","1","1","0","0","0","0","0","2","1","1","0","0","2","0","1","1","0","2","1","0","1","0","0","2"
"Ajman City","25.40177","55.47878","2","0","0","0","0","0","0","2","0","1","0","0","1","0","1","1","0","2","1","0","0","0","1","2"
"Ajmer","26.4521","74.63867","3","0","0","0","1","0","0","4","3","0","2","0","5","0","0","5","0","5","0","2","3","0","0","5"
"Ajodhya","26.79909","82.2047","2","0","0","0","0","0","0","2","2","0","0","0","2","0","0","2","0","2","0","0","2","0","0","2"
"Akademija (Kaunas)","54.8964","23.82411","2","0","0","0","0","0","0","2","0","1","0","0","1","0","1","1","0","2","1","0","0","0","1","2"
"Akaroa","-43.80384","172.96817","1","0","0","0","0","0","0","1","1","0","0","0","1","0","0","1","0","1","0","1","0","0","0","1"
"Akbarpur","26.38371","79.94926","1","0","0","0","0","0","0","1","0","0","0","1","1","1","0","0","0","1","0","0","1","0","0","1"
"Akbarpur","26.42953","82.53431","1","0","0","0","0","0","0","1","0","0","0","1","1","1","0","0","0","1","0","0","1","0","0","1"
"Åkersberga","59.47944","18.29967","1","0","0","0","0","0","0","1","0","0","1","0","1","0","0","1","0","1","0","0","0","1","0","1"
"Akim Swedru","5.8938","-1.01636","1","0","0","0","0","0","0","1","0","0","0","0","0","1","0","0","0","1","0","0","0","0","1","1"
"Akko","10.28899","10.9732","1","0","0","0","0","0","0","1","0","0","0","1","1","0","0","1","0","1","0","0","1","0","0","1"
"Akkol","51.99374","70.94704","0","1","0","0","0","0","0","1","1","0","0","0","1","0","0","1","0","1","0","0","1","0","0","1"
"Akola","20.70957","76.9981","2","0","0","0","0","0","0","2","2","0","0","0","2","0","0","2","0","2","0","0","2","0","0","2"
"Akron","40.16054","-103.21438","2","0","0","0","0","0","0","2","0","0","1","0","1","1","0","1","0","2","1","0","1","0","0","2"
"Akron","42.82888","-96.55948","2","0","0","0","0","0","0","2","0","0","1","0","1","1","0","1","0","2","1","0","1","0","0","2"
"Akron","41.03838","-86.02805","2","0","0","0","0","0","0","2","0","0","1","0","1","1","0","1","0","2","1","0","1","0","0","2"
"Akron","41.08144","-81.51901","2","0","0","0","0","0","0","2","0","0","1","0","1","1","0","1","0","2","1","0","1","0","0","2"
"Akron","43.02089","-78.4953","2","0","0","0","0","0","0","2","0","0","1","0","1","1","0","1","0","2","1","0","1","0","0","2"
"Akron","40.15676","-76.20217","2","0","0","0","0","0","0","2","0","0","1","0","1","1","0","1","0","2","1","0","1","0","0","2"
"Akure","7.25256","5.19312","10","0","0","0","0","0","0","10","0","1","2","5","8","2","2","1","0","5","3","0","7","0","0","10"
"Akureyri","65.68353","-18.0878","1","0","0","0","0","0","0","1","1","0","0","0","1","1","0","0","0","1","0","0","1","0","0","1"
"Al Abyār","32.19","20.59653","1","0","0","0","0","0","0","1","0","0","0","0","0","0","0","1","0","1","1","0","0","0","0","1"
"Al Aḩmadī","29.07694","48.08389","3","0","0","0","0","0","0","3","0","0","2","1","3","1","2","0","0","3","3","0","0","0","0","3"
"Al Ain City","24.19167","55.76056","4","0","0","0","0","0","0","4","1","2","0","0","3","3","1","0","0","4","2","0","2","0","0","4"
"Alajuela","10.01625","-84.21163","3","0","0","0","0","0","0","3","1","1","0","0","2","1","1","1","0","3","2","1","0","0","0","3"
"Alanya","36.54375","31.99982","1","0","0","0","0","0","0","1","0","0","0","0","0","1","0","0","0","1","0","0","1","0","0","1"
"Alappuzha","9.49004","76.3264","3","0","0","0","0","0","0","3","2","0","0","0","2","0","0","3","0","3","0","0","3","0","0","3"
"Alaverdi","41.09766","44.67316","1","0","0","0","0","0","0","1","1","0","0","0","1","0","0","1","0","1","0","0","1","0","0","1"
"Al ‘Azīzīyah","32.53194","13.0175","1","0","0","0","0","0","0","1","0","1","0","0","1","0","1","0","0","1","1","0","0","0","0","1"
"Al ‘Azīzīyah","32.90941","45.06359","1","0","0","0","0","0","0","1","0","1","0","0","1","0","1","0","0","1","1","0","0","0","0","1"
"Al Azraq ash Shamālī","31.88209","36.83017","1","0","0","0","0","0","0","1","0","0","0","0","0","0","1","0","0","1","1","0","0","0","0","1"
"Albacete","38.99424","-1.85643","0","0","0","0","0","0","1","1","0","0","0","0","0","0","0","1","0","1","0","0","0","0","1","1"
"Al Bahah","20.01288","41.46767","5","0","0","0","0","0","0","5","0","3","0","0","3","4","1","0","0","5","4","0","0","0","1","5"
"Alba Iulia","46.06667","23.58333","1","0","0","0","0","0","0","1","1","0","0","0","1","0","0","1","0","1","1","0","0","0","0","1"
"Albany","44.63651","-123.10593","1","0","0","0","0","0","0","1","0","1","0","0","1","1","0","0","0","1","0","0","1","0","0","1"
"Albany","37.88687","-122.29775","1","0","0","0","0","0","0","1","0","1","0","0","1","1","0","0","0","1","0","0","1","0","0","1"
"Albany","32.72345","-99.2973","1","0","0","0","0","0","0","1","0","1","0","0","1","1","0","0","0","1","0","0","1","0","0","1"
"Albany","45.62996","-94.57","1","0","0","0","0","0","0","1","0","1","0","0","1","1","0","0","0","1","0","0","1","0","0","1"
"Albany","40.24861","-94.33107","1","0","0","0","0","0","0","1","0","1","0","0","1","1","0","0","0","1","0","0","1","0","0","1"
"Albany","39.22334","-94.11328","1","0","0","0","0","0","0","1","0","1","0","0","1","1","0","0","0","1","0","0","1","0","0","1"
"Albany","30.50436","-90.58231","1","0","0","0","0","0","0","1","0","1","0","0","1","1","0","0","0","1","0","0","1","0","0","1"
"Albany","41.78947","-90.21929","1","0","0","0","0","0","0","1","0","1","0","0","1","1","0","0","0","1","0","0","1","0","0","1"
"Albany","42.70778","-89.43706","1","0","0","0","0","0","0","1","0","1","0","0","1","1","0","0","0","1","0","0","1","0","0","1"
"Albany","40.30088","-85.24191","1","0","0","0","0","0","0","1","0","1","0","0","1","1","0","0","0","1","0","0","1","0","0","1"
"Albany","36.6909","-85.13468","1","0","0","0","0","0","0","1","0","1","0","0","1","1","0","0","0","1","0","0","1","0","0","1"
"Albany","31.57851","-84.15574","1","0","0","0","0","0","0","1","0","1","0","0","1","1","0","0","0","1","0","0","1","0","0","1"
"Albany","39.22757","-82.20237","1","0","0","0","0","0","0","1","0","1","0","0","1","1","0","0","0","1","0","0","1","0","0","1"
"Albany","42.65258","-73.75623","1","0","0","0","0","0","0","1","0","1","0","0","1","1","0","0","0","1","0","0","1","0","0","1"
"Albany","43.95785","-71.16757","1","0","0","0","0","0","0","1","0","1","0","0","1","1","0","0","0","1","0","0","1","0","0","1"
"Albany","-35.02692","117.88369","1","0","0","0","0","0","0","1","0","1","0","0","1","1","0","0","0","1","0","0","1","0","0","1"
"Al Başrah al Qadīmah","30.50316","47.81507","1","0","0","0","0","0","0","1","0","0","0","0","0","1","0","0","0","1","1","0","0","0","0","1"
"Al Bayḑā’","32.76272","21.75506","3","0","0","0","0","0","0","3","0","1","0","0","1","1","1","1","0","3","0","0","2","1","0","3"
"Albersdorf","54.15","9.28333","1","0","0","0","0","0","0","1","0","0","0","0","0","0","1","0","0","1","0","0","1","0","0","1"
"Albersdorf","50.9033","11.77297","1","0","0","0","0","0","0","1","0","0","0","0","0","0","1","0","0","1","0","0","1","0","0","1"
"Albersdorf","47.12166","15.69826","1","0","0","0","0","0","0","1","0","0","0","0","0","0","1","0","0","1","0","0","1","0","0","1"
"Albertina","-34.20544","21.58001","4","0","0","0","0","0","0","4","1","1","0","0","2","3","0","0","0","3","1","0","2","0","1","4"
"Alberton","46.81685","-64.06542","2","0","0","0","0","0","0","2","1","1","0","0","2","1","0","1","0","2","1","0","1","0","0","2"
"Alberton","-26.26786","28.12225","2","0","0","0","0","0","0","2","1","1","0","0","2","1","0","1","0","2","1","0","1","0","0","2"
"Alberton","-34.85925","138.52138","2","0","0","0","0","0","0","2","1","1","0","0","2","1","0","1","0","2","1","0","1","0","0","2"
"Alberton","-27.7","153.25","2","0","0","0","0","0","0","2","1","1","0","0","2","1","0","1","0","2","1","0","1","0","0","2"
"Albignasego","45.34705","11.86781","0","1","0","0","0","0","0","1","1","0","0","0","1","0","0","1","0","1","0","1","0","0","0","1"
"Albrighton","52.6364","-2.27966","1","0","0","0","0","0","0","1","0","1","0","0","1","0","0","1","0","1","0","0","0","0","1","1"
"Albstadt","48.21644","9.02596","1","0","0","0","0","0","0","1","0","1","0","0","1","1","0","0","0","1","0","0","1","0","0","1"
"Albufeira","37.08819","-8.2503","1","0","0","0","0","0","0","1","0","0","0","0","0","0","1","0","0","1","1","0","0","0","0","1"
"Albuquerque","35.08449","-106.65114","0","1","0","0","0","0","0","1","0","0","1","0","1","1","0","0","0","1","0","0","1","0","0","1"
"Al Burayj","31.43944","34.40306","1","0","0","0","0","0","0","1","0","0","0","0","0","1","0","0","0","1","0","0","1","0","0","1"
"Alcester","43.02138","-96.63087","0","1","0","0","1","0","2","4","1","2","1","0","4","0","0","4","0","4","1","1","2","0","0","4"
"Alcester","52.21667","-1.86667","0","1","0","0","1","0","2","4","1","2","1","0","4","0","0","4","0","4","1","1","2","0","0","4"
"Aldbourne","51.48098","-1.61827","1","0","0","0","0","0","0","1","0","1","0","0","1","1","0","0","0","1","0","0","1","0","0","1"
"Alderley Edge","53.30393","-2.23773","1","0","0","1","0","0","1","3","1","1","1","0","3","0","0","3","0","3","1","0","2","0","0","3"
"Aldershot","51.24827","-0.76389","10","0","0","0","1","0","1","12","2","6","3","0","11","4","4","4","0","12","5","4","3","0","0","12"
"Aldershot","-25.46312","152.66348","10","0","0","0","1","0","1","12","2","6","3","0","11","4","4","4","0","12","5","4","3","0","0","12"
"Alebtong","2.24472","33.25472","1","0","0","0","0","0","0","1","0","0","1","0","1","0","0","1","0","1","0","0","1","0","0","1"
"Além Paraíba","-21.88778","-42.70444","1","0","0","0","0","0","0","1","1","0","0","0","1","0","0","1","0","1","0","1","0","0","0","1"
"Aleppo","36.20124","37.16117","1","0","0","0","1","0","0","2","0","1","0","1","2","0","2","0","0","2","2","0","0","0","0","2"
"Alessandria","44.90924","8.61007","1","0","0","0","0","0","1","2","0","0","0","0","0","0","1","1","0","2","2","0","0","0","0","2"
"Ålesund","62.47225","6.15492","1","0","0","0","0","0","0","1","0","1","0","0","1","0","1","0","0","1","1","0","0","0","0","1"
"Alexandria","43.65359","-97.78285","44","1","0","1","4","0","0","50","14","11","6","5","36","21","18","11","0","50","13","6","21","6","2","48"
"Alexandria","45.88524","-95.37754","44","1","0","1","4","0","0","50","14","11","6","5","36","21","18","11","0","50","13","6","21","6","2","48"
"Alexandria","31.31129","-92.44514","44","1","0","1","4","0","0","50","14","11","6","5","36","21","18","11","0","50","13","6","21","6","2","48"
"Alexandria","36.07756","-86.03332","44","1","0","1","4","0","0","50","14","11","6","5","36","21","18","11","0","50","13","6","21","6","2","48"
"Alexandria","33.77399","-85.88552","44","1","0","1","4","0","0","50","14","11","6","5","36","21","18","11","0","50","13","6","21","6","2","48"
"Alexandria","40.26282","-85.67581","44","1","0","1","4","0","0","50","14","11","6","5","36","21","18","11","0","50","13","6","21","6","2","48"
"Alexandria","38.95951","-84.38799","44","1","0","1","4","0","0","50","14","11","6","5","36","21","18","11","0","50","13","6","21","6","2","48"
"Alexandria","40.08895","-82.61239","44","1","0","1","4","0","0","50","14","11","6","5","36","21","18","11","0","50","13","6","21","6","2","48"
"Alexandria","18.30768","-77.35335","44","1","0","1","4","0","0","50","14","11","6","5","36","21","18","11","0","50","13","6","21","6","2","48"
"Alexandria","38.80484","-77.04692","44","1","0","1","4","0","0","50","14","11","6","5","36","21","18","11","0","50","13","6","21","6","2","48"
"Alexandria","43.61146","-71.79286","44","1","0","1","4","0","0","50","14","11","6","5","36","21","18","11","0","50","13","6","21","6","2","48"
"Alexandria","-6.4125","-38.01583","44","1","0","1","4","0","0","50","14","11","6","5","36","21","18","11","0","50","13","6","21","6","2","48"
"Alexandria","55.99379","-4.5864","44","1","0","1","4","0","0","50","14","11","6","5","36","21","18","11","0","50","13","6","21","6","2","48"
"Alexandria","43.98333","25.33333","44","1","0","1","4","0","0","50","14","11","6","5","36","21","18","11","0","50","13","6","21","6","2","48"
"Alexandria","31.20176","29.91582","44","1","0","1","4","0","0","50","14","11","6","5","36","21","18","11","0","50","13","6","21","6","2","48"
"Alexandria","-33.89989","151.19951","44","1","0","1","4","0","0","50","14","11","6","5","36","21","18","11","0","50","13","6","21","6","2","48"
"Al Fallūjah","33.34913","43.78599","2","0","0","0","0","0","0","2","1","1","0","0","2","0","2","0","0","2","1","0","1","0","0","2"
"Al Fandaqūmīyah","32.3206","35.20329","1","0","0","0","0","0","0","1","0","0","0","1","1","1","0","0","0","1","0","0","1","0","0","1"
"Al Farwānīyah","29.2775","47.95861","9","2","0","0","0","0","0","11","2","7","0","1","10","6","2","2","1","11","8","2","1","0","0","11"
"Al Fashn","28.82431","30.89948","1","0","0","0","0","0","0","1","1","0","0","0","1","0","0","1","0","1","0","0","1","0","0","1"
"Al Fayyūm","29.30995","30.8418","2","0","0","0","0","0","1","3","2","1","0","0","3","1","1","1","0","3","0","0","2","1","0","3"
"Al Finţās","29.17389","48.12111","2","0","0","0","0","0","0","2","0","2","0","0","2","1","0","1","0","2","1","0","1","0","0","2"
"Alfredo Baquerizo Moreno","-1.91667","-79.51667","3","1","0","0","0","0","0","4","0","2","0","0","2","0","4","0","0","4","1","2","1","0","0","4"
"Alfredo Chaves","-20.635","-40.74972","1","0","0","0","0","0","0","1","0","0","1","0","1","0","0","1","0","1","0","0","1","0","0","1"
"Alfreton","53.09766","-1.38376","9","0","0","1","1","0","0","11","1","7","1","0","9","3","1","7","0","11","5","3","3","0","0","11"
"Al Fujairah City","25.11641","56.34141","3","0","0","0","0","0","0","3","0","1","0","0","1","1","1","0","1","3","2","0","0","0","1","3"
"Algeciras","2.52385","-75.31733","1","0","0","0","0","0","0","1","0","0","0","1","1","0","0","0","1","1","0","0","1","0","0","1"
"Algeciras","36.13326","-5.45051","1","0","0","0","0","0","0","1","0","0","0","1","1","0","0","0","1","1","0","0","1","0","0","1"
"Algeciras","11.4154","120.8168","1","0","0","0","0","0","0","1","0","0","0","1","1","0","0","0","1","1","0","0","1","0","0","1"
"Al Ghuwayrīyah","25.82882","51.24567","1","0","0","0","0","0","0","1","0","0","0","0","0","1","0","0","0","1","1","0","0","0","0","1"
"Algiers","36.73225","3.08746","31","2","0","0","0","0","0","33","12","10","8","1","31","14","4","15","0","33","9","10","13","1","0","33"
"Al Hadā","21.35903","40.2803","1","0","0","0","0","0","0","1","0","1","0","0","1","0","0","1","0","1","1","0","0","0","0","1"
"Al Ḩadd","26.24556","50.65417","1","0","0","0","0","0","0","1","1","0","0","0","1","1","0","0","0","1","0","0","1","0","0","1"
"Al Ḩaqlānīyah","34.08599","42.36174","1","0","0","0","0","0","0","1","0","1","0","0","1","0","1","0","0","1","1","0","0","0","0","1"
"Al Hārithah","30.58481","47.76114","1","0","0","0","0","0","0","1","1","0","0","0","1","1","0","0","0","1","0","0","0","0","0","0"
"Al Hāshimīyah","32.46392","35.21938","0","0","0","0","0","0","0","0","0","0","0","0","0","0","0","0","0","0","0","0","0","0","0","0"
"Al Hāshimīyah","32.12901","36.1213","0","0","0","0","0","0","0","0","0","0","0","0","0","0","0","0","0","0","0","0","0","0","0","0"
"Al Hāshimīyah","32.36351","44.66011","0","0","0","0","0","0","0","0","0","0","0","0","0","0","0","0","0","0","0","0","0","0","0","0"
"Al Ḩillah","32.46367","44.41963","8","0","0","1","0","0","0","9","3","2","4","0","9","4","1","4","0","9","2","1","6","0","0","9"
"Al Hufūf","25.36467","49.58764","10","0","0","0","0","0","0","10","0","2","2","2","6","5","4","0","1","10","6","0","3","0","1","10"
"Aliabad","41.4829","46.63483","3","0","0","0","0","0","0","3","0","3","0","0","3","0","2","1","0","3","0","0","0","0","3","3"
"Aliabad","36.52115","68.89985","3","0","0","0","0","0","0","3","0","3","0","0","3","0","2","1","0","3","0","0","0","0","3","3"
"Aliabad","36.30703","74.61545","3","0","0","0","0","0","0","3","0","3","0","0","3","0","2","1","0","3","0","0","0","0","3","3"
"Al Ibrāhīmīyah","30.71877","31.56299","2","0","0","0","0","0","0","2","2","0","0","0","2","1","0","1","0","2","0","0","2","0","0","2"
"Alicante","38.34517","-0.48149","1","0","0","0","0","0","0","1","0","0","0","0","0","1","0","0","0","1","0","0","0","0","1","1"
"Alicante","10.89704","123.0185","1","0","0","0","0","0","0","1","0","0","0","0","0","1","0","0","0","1","0","0","0","0","1","1"
"Alīgarh","27.88145","78.07464","2","0","0","0","0","0","0","2","2","0","0","0","2","1","0","1","0","2","0","0","2","0","0","2"
"Aliko","39.85861","20.07917","0","1","0","0","0","0","0","1","0","0","0","0","0","0","1","0","0","1","1","0","0","0","0","1"
"Alipur","29.38242","70.91106","0","1","0","0","0","0","0","1","1","0","0","0","1","0","1","0","0","1","0","0","1","0","0","1"
"'Ali Sabieh","11.15583","42.7125","1","0","0","0","0","0","0","1","1","0","0","0","1","1","0","0","0","1","0","0","1","0","0","1"
"Alizai","33.53613","70.34607","2","0","0","0","0","0","0","2","1","1","0","0","2","1","1","0","0","2","1","0","0","0","0","1"
"Al Jabāyish","30.96588","47.00196","5","0","0","0","0","0","0","5","0","0","5","0","5","5","0","0","0","5","0","0","5","0","0","5"
"Al Jahrā’","29.3375","47.65806","2","0","0","0","0","0","0","2","1","0","0","0","1","2","0","0","0","2","1","0","1","0","0","2"
"Al Jammālīyah","31.18065","31.86497","1","0","0","0","0","0","0","1","1","0","0","0","1","1","0","0","0","1","0","0","1","0","0","1"
"Aljmaš","45.52889","18.95056","1","0","0","0","0","0","0","1","0","0","0","0","0","1","0","0","0","1","0","0","0","0","1","1"
"Al Jubayhah","32.01071","35.89802","1","0","0","0","0","0","0","1","1","0","0","0","1","0","0","1","0","1","1","0","0","0","0","1"
"Al Jubayl","27.0174","49.62251","1","0","0","0","0","0","0","1","0","0","0","0","0","1","0","0","0","1","0","0","1","0","0","1"
"Al Jubayl","25.4","49.65","1","0","0","0","0","0","0","1","0","0","0","0","0","1","0","0","0","1","0","0","1","0","0","1"
"Al Khafjī","28.43905","48.49132","3","0","0","0","0","0","0","3","0","3","0","0","3","1","2","0","0","3","1","0","1","0","1","3"
"Al Khāliş","33.85118","44.52047","2","0","0","0","0","0","0","2","2","0","0","0","2","0","0","0","2","2","0","2","0","0","0","2"
"Al Khānkah","30.21035","31.36812","6","0","0","0","0","0","0","6","6","0","0","0","6","0","0","6","0","6","0","0","6","0","0","6"
"Al Khawr","25.68389","51.50583","1","0","0","0","0","0","0","1","0","0","0","0","0","0","1","0","0","1","0","0","0","0","1","1"
"Al Khums","32.64861","14.26191","1","0","0","0","0","0","0","1","0","1","0","0","1","0","0","0","1","1","0","0","1","0","0","1"
"Allahābād","25.44478","81.84322","1","0","0","0","0","0","0","1","1","0","0","0","1","0","0","1","0","1","0","0","1","0","0","1"
"Allanton","55.79945","-3.83492","0","0","0","0","0","0","2","2","0","0","1","1","2","1","0","1","0","2","1","1","0","0","0","2"
"Allanton","55.78333","-2.21667","0","0","0","0","0","0","2","2","0","0","1","1","2","1","0","1","0","2","1","1","0","0","0","2"
"Allkaj","40.8575","19.75528","2","0","0","0","0","0","0","2","1","0","1","0","2","1","0","1","0","2","0","0","2","0","0","2"
"Alloa","56.11586","-3.78997","2","0","0","0","1","0","0","3","1","0","2","0","3","1","1","1","0","3","0","0","3","0","0","3"
"Almada","38.67902","-9.1569","3","0","0","0","0","0","0","3","1","0","0","1","2","0","1","2","0","3","0","0","2","0","1","3"
"Al Madīnah","30.96324","47.26998","2","0","0","0","0","0","0","2","2","0","0","0","2","0","0","2","0","2","0","0","2","0","0","2"
"Al Maḩallah al Kubrá","30.97063","31.1669","4","0","0","0","1","0","0","5","1","1","1","0","3","3","2","0","0","5","1","1","1","1","1","5"
"Al Maḩāwīl","32.66138","44.40854","1","0","0","0","0","0","0","1","1","0","0","0","1","0","0","1","0","1","0","0","0","0","0","0"
"Al Majāridah","19.12361","41.91111","1","0","0","0","0","0","0","1","0","1","0","0","1","0","0","0","0","0","1","0","0","0","0","1"
"Al Majd","31.48095","34.95063","1","0","0","0","0","0","0","1","0","1","0","0","1","1","0","0","0","1","0","0","1","0","0","1"
"Al Manqaf","29.09611","48.13278","1","0","0","0","0","0","0","1","0","1","0","0","1","0","0","1","0","1","1","0","0","0","0","1"
"Al Manşūrah","31.03637","31.38069","10","0","0","0","0","0","0","10","2","4","2","0","8","2","4","4","0","10","5","1","3","0","1","10"
"Al Manşūrah","35.83917","38.74288","10","0","0","0","0","0","0","10","2","4","2","0","8","2","4","4","0","10","5","1","3","0","1","10"
"Al Manşūrah","12.86019","44.98166","10","0","0","0","0","0","0","10","2","4","2","0","8","2","4","4","0","10","5","1","3","0","1","10"
"Al Marsá","36.87818","10.32466","2","0","0","0","0","0","1","3","1","0","0","0","1","0","1","2","0","3","1","0","2","0","0","3"
"Almaty","43.25667","76.92861","2","0","0","0","0","0","0","2","0","0","0","0","0","0","1","1","0","2","0","0","2","0","0","2"
"Al Mawşil al Jadīdah","36.33271","43.10555","1","1","0","0","0","0","0","2","0","0","2","0","2","1","1","0","0","2","0","0","0","1","1","2"
"Al Mazra‘ah","32.78398","36.47695","1","0","0","0","0","0","0","1","1","0","0","0","1","0","0","1","0","1","0","0","1","0","0","1"
"Almere Stad","52.37025","5.21413","0","1","0","0","0","0","0","1","1","0","0","0","1","0","0","1","0","1","0","0","1","0","0","1"
"Al Minyā","28.09193","30.75813","3","0","0","0","0","0","0","3","1","0","1","1","3","1","0","1","1","3","1","0","2","0","0","3"
"Al Muharraq","26.25722","50.61194","2","0","0","0","1","0","0","3","0","1","0","1","2","3","0","0","0","3","2","0","1","0","0","3"
"Al Musayyib","32.77872","44.29005","3","1","0","0","0","0","0","4","2","1","1","0","4","1","2","1","0","4","2","0","1","0","0","3"
"Al Muzayrīb","32.71084","36.02751","0","1","0","0","0","0","0","1","0","1","0","0","1","0","1","0","0","1","1","0","0","0","0","1"
"Alness","57.69596","-4.2551","2","0","0","0","0","0","0","2","1","0","1","0","2","2","0","0","0","2","0","2","0","0","0","2"
"Alnmouth","55.4","-1.6","7","0","0","0","0","0","0","7","2","2","3","0","7","0","1","6","0","7","1","3","3","0","0","7"
"Alnwick","55.41318","-1.70563","7","0","0","0","0","0","1","8","3","1","2","0","6","1","2","5","0","8","0","4","3","0","1","8"
"Alor Gajah","2.3804","102.2089","3","0","0","0","0","0","0","3","1","0","2","0","3","2","0","1","0","3","1","0","2","0","0","3"
"Alor Setar","6.12104","100.36014","7","0","0","1","0","0","0","8","4","2","0","0","6","3","3","2","0","8","5","1","2","0","0","8"
"Alpharetta","34.07538","-84.29409","1","0","0","0","0","0","0","1","0","1","0","0","1","0","0","1","0","1","0","0","1","0","0","1"
"Alpington","52.56728","1.38229","7","0","0","0","2","0","2","11","1","2","4","2","9","4","2","5","0","11","4","5","2","0","0","11"
"Alpurai","34.92039","72.63265","1","1","0","0","0","0","0","2","2","0","0","0","2","2","0","0","0","2","0","0","2","0","0","2"
"Al Qanāţir al Khayrīyah","30.19327","31.13703","8","1","0","1","0","0","0","10","1","5","2","0","8","3","4","2","1","10","2","1","5","0","2","10"
"Al Qaţan","15.84056","48.45556","1","0","0","0","0","0","0","1","0","0","0","0","0","0","0","0","0","0","1","0","0","0","0","1"
"Al Qurayn","30.61618","31.73514","1","0","0","0","0","0","0","1","0","0","0","1","1","1","0","0","0","1","0","0","1","0","0","1"
"Al Qurayn","25.48333","49.6","1","0","0","0","0","0","0","1","0","0","0","1","1","1","0","0","0","1","0","0","1","0","0","1"
"Al Quşayr","26.10611","34.27716","1","0","0","0","0","0","0","1","1","0","0","0","1","1","0","0","0","1","0","0","0","0","1","1"
"Al Quşayr","34.5078","36.58029","1","0","0","0","0","0","0","1","1","0","0","0","1","1","0","0","0","1","0","0","0","0","1","1"
"Alresford","51.85389","1.00203","4","1","0","1","0","0","0","6","2","2","1","0","5","0","0","6","0","6","0","3","2","0","1","6"
"Alrewas","52.73278","-1.74968","2","0","0","0","0","0","0","2","0","1","1","0","2","1","0","1","0","2","0","2","0","0","0","2"
"Alsager","53.09617","-2.30649","2","0","0","0","0","0","0","2","0","0","2","0","2","0","0","2","0","2","0","2","0","0","0","2"
"Altamira","23.38173","-102.98674","1","1","0","0","0","0","0","2","2","0","0","0","2","1","0","1","0","2","0","0","2","0","0","2"
"Altamira","22.39215","-97.93867","1","1","0","0","0","0","0","2","2","0","0","0","2","1","0","1","0","2","0","0","2","0","0","2"
"Altamira","2.06278","-75.78722","1","1","0","0","0","0","0","2","2","0","0","0","2","1","0","1","0","2","0","0","2","0","0","2"
"Altamira","19.6773","-70.84428","1","1","0","0","0","0","0","2","2","0","0","0","2","1","0","1","0","2","0","0","2","0","0","2"
"Altamira","8.82359","-70.50244","1","1","0","0","0","0","0","2","2","0","0","0","2","1","0","1","0","2","0","0","2","0","0","2"
"Altamira","-3.20333","-52.20639","1","1","0","0","0","0","0","2","2","0","0","0","2","1","0","1","0","2","0","0","2","0","0","2"
"Altamonte Springs","28.66111","-81.36562","1","0","0","0","0","0","0","1","0","1","0","0","1","0","1","0","0","1","1","0","0","0","0","1"
"Altenbeken","51.76455","8.94201","1","0","0","0","0","0","0","1","0","0","1","0","1","0","1","0","0","1","0","0","1","0","0","1"
"Althorne","51.65722","0.76085","2","0","0","0","0","0","0","2","0","0","2","0","2","1","0","1","0","2","0","2","0","0","0","2"
"Alton","26.28729","-98.31335","8","0","0","0","0","0","0","8","2","1","3","0","6","2","0","6","0","8","0","5","3","0","0","8"
"Alton","42.98749","-96.01057","8","0","0","0","0","0","0","8","2","1","3","0","6","2","0","6","0","8","0","5","3","0","0","8"
"Alton","36.69423","-91.3993","8","0","0","0","0","0","0","8","2","1","3","0","6","2","0","6","0","8","0","5","3","0","0","8"
"Alton","38.8906","-90.18428","8","0","0","0","0","0","0","8","2","1","3","0","6","2","0","6","0","8","0","5","3","0","0","8"
"Alton","43.4523","-71.21757","8","0","0","0","0","0","0","8","2","1","3","0","6","2","0","6","0","8","0","5","3","0","0","8"
"Alton","45.03145","-68.72865","8","0","0","0","0","0","0","8","2","1","3","0","6","2","0","6","0","8","0","5","3","0","0","8"
"Alton","51.14931","-0.97469","8","0","0","0","0","0","0","8","2","1","3","0","6","2","0","6","0","8","0","5","3","0","0","8"
"Altrincham","53.38752","-2.34848","8","3","0","1","0","0","2","14","8","1","2","0","11","7","1","6","0","14","0","2","12","0","0","14"
"Alvechurch","52.35173","-1.96531","2","0","0","0","0","0","0","2","0","1","1","0","2","1","0","1","0","2","1","0","1","0","0","2"
"Alvor","37.12994","-8.59174","0","0","0","0","0","0","1","1","0","1","0","0","1","1","0","0","0","1","0","1","0","0","0","1"
"Al Wakrah","25.17151","51.60337","1","0","0","0","0","0","0","1","0","1","0","0","1","1","0","0","0","1","0","0","1","0","0","1"
"Alwar","27.56246","76.625","2","0","0","0","0","0","0","2","1","0","1","0","2","1","0","0","1","2","0","0","2","0","0","2"
"Al Wāsiţah","29.33778","31.20556","1","0","0","0","0","0","0","1","0","0","0","1","1","0","1","0","0","1","0","0","0","0","1","1"
"Amadora","38.75382","-9.23083","2","0","0","0","0","0","0","2","1","0","0","0","1","1","1","0","0","2","1","1","0","0","0","2"
"Amanalco de Becerra","19.25374","-100.0198","0","0","0","0","1","0","0","1","0","0","1","0","1","1","0","0","0","1","1","0","0","0","0","1"
"Amanalco de Becerra","19.31667","-100.01667","0","0","0","0","1","0","0","1","0","0","1","0","1","1","0","0","0","1","1","0","0","0","0","1"
"Amarpur","25.03967","86.90247","1","0","0","0","0","0","0","1","1","0","0","0","1","0","0","0","1","1","0","0","1","0","0","1"
"Amarpur","23.5257","91.65879","1","0","0","0","0","0","0","1","1","0","0","0","1","0","0","0","1","1","0","0","1","0","0","1"
"Amaury","-20.13083","57.65917","1","0","0","0","0","0","0","1","1","0","0","0","1","1","0","0","0","1","0","0","1","0","0","1"
"Ambājogāi","18.73312","76.38616","2","0","0","0","0","0","0","2","2","0","0","0","2","1","0","1","0","2","0","0","2","0","0","2"
"Ambato","-1.24908","-78.61675","1","0","0","0","0","0","0","1","0","1","0","0","1","1","0","0","0","1","1","0","0","0","0","1"
"Ambattūr","13.09818","80.16152","1","0","0","0","0","0","0","1","1","0","0","0","1","0","0","1","0","1","1","0","0","0","0","1"
"Ambikāpur","23.11892","83.19537","1","0","0","0","0","0","0","1","1","0","0","0","1","0","1","0","0","1","0","1","0","0","0","1"
"Ambleside","54.43261","-2.96167","2","0","0","0","0","0","0","2","0","1","0","0","1","0","1","1","0","2","1","1","0","0","0","2"
"Ambleside","-41.20316","146.37225","2","0","0","0","0","0","0","2","0","1","0","0","1","0","1","1","0","2","1","1","0","0","0","2"
"Amersham","51.66667","-0.61667","4","0","0","0","0","0","1","5","1","1","2","0","4","2","1","2","0","5","0","1","4","0","0","5"
"Amersham on the Hill","51.67468","-0.60742","3","0","0","0","0","0","1","4","0","1","2","0","3","1","0","3","0","4","0","0","4","0","0","4"
"Ames","31.52099","-97.77947","1","0","0","0","0","0","0","1","0","0","0","0","0","0","1","0","0","1","0","0","1","0","0","1"
"Ames","30.05383","-94.74353","1","0","0","0","0","0","0","1","0","0","0","0","0","0","1","0","0","1","0","0","1","0","0","1"
"Ames","42.03471","-93.61994","1","0","0","0","0","0","0","1","0","0","0","0","0","0","1","0","0","1","0","0","1","0","0","1"
"Ames","50.54079","2.41512","1","0","0","0","0","0","0","1","0","0","0","0","0","0","1","0","0","1","0","0","1","0","0","1"
"Amesbury","42.85842","-70.93005","1","0","0","0","0","0","0","1","0","1","0","0","1","0","0","1","0","1","0","0","1","0","0","1"
"Amesbury","51.17509","-1.78064","1","0","0","0","0","0","0","1","0","1","0","0","1","0","0","1","0","1","0","0","1","0","0","1"
"Amioûn","34.3","35.80889","1","0","0","0","0","0","0","1","0","0","0","0","0","0","0","1","0","1","1","0","0","0","0","1"
"Amlwch","53.40986","-4.34712","1","0","0","0","0","0","0","1","0","0","1","0","1","0","0","1","0","1","0","0","1","0","0","1"
"Amman","31.95522","35.94503","48","1","0","0","0","0","0","49","28","4","11","1","44","13","13","22","1","49","13","13","20","0","3","49"
"Ammanford","51.79279","-3.98833","5","1","0","0","0","0","1","7","1","4","2","0","7","4","0","3","0","7","1","3","3","0","0","7"
"Ampang","3.15","101.76667","3","0","0","0","0","0","0","3","2","1","0","0","3","2","0","1","0","3","0","0","3","0","0","3"
"Ampara","7.29754","81.68202","9","0","0","0","0","0","0","9","7","0","0","0","7","3","3","3","1","10","0","1","7","0","1","9"
"Ampelókipoi","40.46582","21.31001","1","0","0","0","0","0","0","1","0","1","0","0","1","0","0","1","0","1","0","0","0","0","1","1"
"Ampelókipoi","40.65304","22.92624","1","0","0","0","0","0","0","1","0","1","0","0","1","0","0","1","0","1","0","0","0","0","1","1"
"Ampleforth","54.19956","-1.10691","1","0","0","0","0","0","0","1","0","0","1","0","1","0","0","1","0","1","0","0","1","0","0","1"
"Ampthill","52.02694","-0.49567","5","0","0","0","1","0","0","6","1","1","4","0","6","3","2","1","0","6","0","0","6","0","0","6"
"Amrāvati","20.93333","77.75","1","0","0","0","0","0","0","1","1","0","0","0","1","1","0","0","0","1","0","0","1","0","0","1"
"Amritsar","31.62234","74.87534","5","0","0","0","1","0","0","6","5","0","0","1","6","2","0","3","1","6","0","0","6","0","0","6"
"Amsterdam","39.95757","-82.37821","12","1","1","1","0","0","2","17","2","1","7","1","11","2","7","7","1","17","2","3","9","0","8","22"
"Amsterdam","42.93869","-74.18819","12","1","1","1","0","0","2","17","2","1","7","1","11","2","7","7","1","17","2","3","9","0","8","22"
"Amsterdam","52.37403","4.88969","12","1","1","1","0","0","2","17","2","1","7","1","11","2","7","7","1","17","2","3","9","0","8","22"
"Amsterdam-Zuidoost","52.3075","4.97222","0","0","0","0","0","0","1","1","1","0","0","0","1","0","1","0","0","1","0","0","1","0","0","1"
"Anand","22.55251","72.9552","1","1","0","0","0","0","0","2","2","0","0","0","2","0","1","0","1","2","0","0","1","1","0","2"
"Anantapur","14.67784","77.60813","3","0","0","0","0","0","0","3","3","0","0","0","3","1","0","2","0","3","0","0","3","0","0","3"
"Anantnag","33.73068","75.15418","2","0","0","0","0","0","0","2","2","0","0","0","2","1","0","1","0","2","0","1","1","0","0","2"
"Anchau","10.96245","8.39233","1","0","0","0","0","0","0","1","0","1","0","0","1","0","0","0","0","0","0","0","0","0","0","0"
"Ancón","8.96015","-79.5514","1","0","0","0","0","0","0","1","0","1","0","0","1","1","0","0","0","1","1","0","0","0","0","1"
"Andong","30.26823","121.21582","0","0","0","0","0","0","1","1","0","0","0","1","1","0","1","0","0","1","1","0","0","0","0","1"
"Andong","36.56636","128.72275","0","0","0","0","0","0","1","1","0","0","0","1","1","0","1","0","0","1","1","0","0","0","0","1"
"Andorra la Vella","42.50779","1.52109","1","0","0","0","0","0","0","1","0","1","0","0","1","0","0","1","0","1","0","0","1","0","0","1"
"Andoung Meas","13.86724","107.29682","2","0","0","0","0","0","0","2","1","0","0","0","1","1","1","0","0","2","1","0","1","0","0","2"
"Andover","37.7139","-97.13643","7","0","0","2","1","0","2","12","4","1","4","0","9","5","0","7","0","12","0","2","9","0","1","12"
"Andover","45.2333","-93.29134","7","0","0","2","1","0","2","12","4","1","4","0","9","5","0","7","0","12","0","2","9","0","1","12"
"Andover","41.29392","-90.29207","7","0","0","2","1","0","2","12","4","1","4","0","9","5","0","7","0","12","0","2","9","0","1","12"
"Andover","41.60672","-80.5723","7","0","0","2","1","0","2","12","4","1","4","0","9","5","0","7","0","12","0","2","9","0","1","12"
"Andover","25.96843","-80.21283","7","0","0","2","1","0","2","12","4","1","4","0","9","5","0","7","0","12","0","2","9","0","1","12"
"Andover","42.15646","-77.79555","7","0","0","2","1","0","2","12","4","1","4","0","9","5","0","7","0","12","0","2","9","0","1","12"
"Andover","40.98593","-74.74211","7","0","0","2","1","0","2","12","4","1","4","0","9","5","0","7","0","12","0","2","9","0","1","12"
"Andover","43.43702","-71.82341","7","0","0","2","1","0","2","12","4","1","4","0","9","5","0","7","0","12","0","2","9","0","1","12"
"Andover","42.65843","-71.137","7","0","0","2","1","0","2","12","4","1","4","0","9","5","0","7","0","12","0","2","9","0","1","12"
"Andover","44.63562","-70.75118","7","0","0","2","1","0","2","12","4","1","4","0","9","5","0","7","0","12","0","2","9","0","1","12"
"Andover","51.21135","-1.49393","7","0","0","2","1","0","2","12","4","1","4","0","9","5","0","7","0","12","0","2","9","0","1","12"
"An Dương","20.86382","106.6133","1","0","0","0","0","0","0","1","0","1","0","0","1","1","0","0","0","1","0","0","0","0","1","1"
"Angarsk","52.53667","103.88639","1","0","0","0","0","0","0","1","1","0","0","0","1","0","0","1","0","1","0","1","0","0","0","1"
"Angeles City","15.15","120.58333","2","0","0","0","0","0","0","2","1","0","1","0","2","1","0","1","0","2","0","1","1","0","0","2"
"Ängelholm","56.2428","12.86219","1","0","0","0","0","0","0","1","0","1","0","0","1","0","0","0","0","0","0","0","1","0","0","1"
"Angol","-37.79519","-72.71636","1","0","0","0","0","0","0","1","0","0","0","0","0","0","1","0","0","1","1","0","0","0","0","1"
"Angri","40.73815","14.5707","1","0","0","0","0","0","0","1","1","0","0","0","1","0","0","1","0","1","0","0","1","0","0","1"
"Angul","20.84089","85.10192","1","0","0","0","0","0","0","1","0","0","1","0","1","1","0","0","0","1","0","1","0","0","0","1"
"Ankara","39.91987","32.85427","29","0","0","0","1","0","1","31","12","9","3","0","24","11","6","13","1","31","10","3","14","3","1","31"
"Ankeny","41.72971","-93.60577","1","0","0","0","0","0","0","1","0","0","0","0","0","0","0","1","0","1","0","0","1","0","0","1"
"Annaba","36.9","7.76667","5","0","0","0","0","0","1","6","3","1","1","0","5","0","2","4","0","6","1","1","3","0","1","6"
"Annacotty","52.66768","-8.53121","1","0","0","0","0","0","0","1","0","1","0","0","1","0","0","1","0","1","0","0","1","0","0","1"
"An Najd","14.42152","45.29596","1","0","0","0","0","0","0","1","0","1","0","0","1","0","1","0","0","1","0","0","0","1","0","1"
"Annandale","45.26274","-94.12443","1","0","0","0","0","0","0","1","0","0","1","0","1","0","0","1","0","1","0","0","1","0","0","1"
"Annandale","38.83039","-77.19637","1","0","0","0","0","0","0","1","0","0","1","0","1","0","0","1","0","1","0","0","1","0","0","1"
"Annandale","40.64093","-74.88128","1","0","0","0","0","0","0","1","0","0","1","0","1","0","0","1","0","1","0","0","1","0","0","1"
"Annandale","-19.31503","146.79069","1","0","0","0","0","0","0","1","0","0","1","0","1","0","0","1","0","1","0","0","1","0","0","1"
"Annandale","-33.88333","151.16667","1","0","0","0","0","0","0","1","0","0","1","0","1","0","0","1","0","1","0","0","1","0","0","1"
"Annapolis","38.97859","-76.49184","1","0","0","0","0","0","0","1","0","0","0","0","0","0","0","1","0","1","0","1","0","0","0","1"
"Ann Arbor","42.27756","-83.74088","2","0","0","0","0","0","0","2","0","0","1","0","1","0","0","2","0","2","1","0","1","0","0","2"
"An Naşr","31.28137","34.30253","1","0","0","0","0","0","0","1","0","1","0","0","1","1","0","0","0","1","0","1","0","0","0","1"
"Annemasse","46.19439","6.23775","1","0","0","0","0","0","0","1","0","1","0","0","1","0","1","0","0","1","1","0","0","0","0","1"
"Anoixi","38.13267","23.85874","0","2","0","0","0","0","0","2","0","2","0","0","2","2","0","0","0","2","2","0","0","0","0","2"
"Antakya","36.20655","36.15722","1","0","0","0","0","0","0","1","1","0","0","0","1","0","1","0","0","1","0","1","0","0","0","1"
"Antalya","36.90812","30.69556","4","0","0","0","1","0","0","5","2","1","1","0","4","1","0","4","0","5","2","1","2","0","0","5"
"Antananarivo","-18.91368","47.53613","1","1","0","0","0","0","0","2","0","0","2","0","2","1","0","1","0","2","0","1","1","0","0","2"
"Antipolo","14.62578","121.12251","1","0","0","0","0","0","0","1","1","0","0","0","1","0","0","1","0","1","0","0","1","0","0","1"
"Antipolo","15.6181","121.19","1","0","0","0","0","0","0","1","1","0","0","0","1","0","0","1","0","1","0","0","1","0","0","1"
"Antipolo","10.3565","122.9646","1","0","0","0","0","0","0","1","1","0","0","0","1","0","0","1","0","1","0","0","1","0","0","1"
"Antipolo","13.5286","123.1622","1","0","0","0","0","0","0","1","1","0","0","0","1","0","0","1","0","1","0","0","1","0","0","1"
"Antipolo","13.3927","123.5231","1","0","0","0","0","0","0","1","1","0","0","0","1","0","0","1","0","1","0","0","1","0","0","1"
"Antipolo","11.16667","123.95","1","0","0","0","0","0","0","1","1","0","0","0","1","0","0","1","0","1","0","0","1","0","0","1"
"Antofagasta","-23.65236","-70.3954","2","0","0","0","0","0","0","2","1","0","1","0","2","1","0","1","0","2","1","0","1","0","0","2"
"Antoniny","49.80974","26.87714","1","0","0","0","0","0","0","1","1","0","0","0","1","0","0","1","0","1","0","0","1","0","0","1"
"Antrim","43.03091","-71.93897","3","0","0","0","0","0","0","3","0","2","1","0","3","3","0","0","0","3","1","1","1","0","0","3"
"Antrim","54.7","-6.2","3","0","0","0","0","0","0","3","0","2","1","0","3","3","0","0","0","3","1","1","1","0","0","3"
"Antwerpen","51.22047","4.40026","2","0","0","0","0","0","0","2","0","0","1","0","1","1","0","1","0","2","0","1","1","0","0","2"
"Apalachin","42.06952","-76.15465","1","0","0","0","0","0","0","1","0","0","0","0","0","0","0","1","0","1","0","1","0","0","0","1"
"Apalit","14.95333","120.77","1","0","0","0","0","0","0","1","1","0","0","0","1","0","0","1","0","1","0","0","1","0","0","1"
"Apeldoorn","52.21","5.96944","1","0","0","0","0","0","1","2","0","0","0","0","0","1","0","1","0","2","1","1","0","0","0","2"
"Apopa","13.80722","-89.17917","1","0","0","0","0","0","0","1","0","1","0","0","1","1","0","0","0","1","0","0","0","1","0","1"
"Apple Valley","34.50083","-117.18588","0","0","0","0","0","0","1","1","1","0","0","0","1","1","0","0","0","1","0","0","1","0","0","1"
"Apple Valley","37.08971","-113.12439","0","0","0","0","0","0","1","1","1","0","0","0","1","1","0","0","0","1","0","0","1","0","0","1"
"Apple Valley","44.73191","-93.21772","0","0","0","0","0","0","1","1","1","0","0","0","1","1","0","0","0","1","0","0","1","0","0","1"
"Apple Valley","40.4389","-82.35391","0","0","0","0","0","0","1","1","1","0","0","0","1","1","0","0","0","1","0","0","1","0","0","1"
"Appomattox","37.35709","-78.82529","1","0","0","0","0","0","0","1","0","0","0","0","0","1","0","0","0","1","1","0","0","0","0","1"
"Aprilia","41.59452","12.65419","1","0","0","0","0","0","0","1","0","0","0","0","0","0","1","0","0","1","1","0","0","0","0","1"
"Aqaba","29.52667","35.00778","2","0","0","0","0","0","0","2","1","0","1","0","2","0","1","1","0","2","1","1","0","0","0","2"
"Aquin","18.27974","-73.39433","1","0","0","0","0","0","0","1","0","0","0","0","0","0","1","0","0","1","1","0","0","0","0","1"
"Arad","46.18333","21.31667","2","0","0","1","0","0","0","3","1","2","0","0","3","2","0","0","1","3","1","0","2","0","0","3"
"Arad","31.25882","35.21282","2","0","0","1","0","0","0","3","1","2","0","0","3","2","0","0","1","3","1","0","2","0","0","3"
"Araguari","-18.64722","-48.18722","1","0","0","0","0","0","0","1","0","1","0","0","1","0","1","0","0","1","1","0","0","0","0","1"
"Aramango","-5.41639","-78.43583","1","0","0","0","0","0","0","1","1","0","0","0","1","1","0","0","0","1","0","0","1","0","0","1"
"Aranitas","40.59444","19.80667","1","0","0","0","0","0","0","1","0","1","0","0","1","0","1","0","0","1","0","0","0","0","1","1"
"Aranos","-24.13333","19.11667","1","0","0","0","0","0","0","1","0","1","0","0","1","1","0","0","0","1","0","0","1","0","0","1"
"Arar","30.97531","41.03808","2","0","0","0","0","0","0","2","0","2","0","0","2","1","1","0","0","2","2","0","0","0","0","2"
"Arba Minch","6.03333","37.55","0","0","0","0","0","0","0","0","0","0","0","0","0","0","0","0","0","0","0","0","0","0","0","0"
"Arbroath","56.56317","-2.58736","2","0","0","0","0","0","0","2","0","1","1","0","2","1","0","1","0","2","1","0","1","0","0","2"
"Ardee","53.85972","-6.54056","1","0","0","0","0","0","0","1","0","0","1","0","1","0","0","1","0","1","0","0","1","0","0","1"
"Arecibo","18.47245","-66.71573","1","0","0","0","0","0","0","1","0","0","0","0","0","0","0","1","0","1","1","0","0","0","0","1"
"Arendonk","51.32267","5.08289","1","0","0","0","0","0","0","1","1","0","0","0","1","0","0","1","0","1","0","0","1","0","0","1"
"Arequipa","-16.39889","-71.535","2","0","0","0","0","0","0","2","0","0","0","0","0","0","0","2","0","2","1","0","1","0","0","2"
"Århus","56.15674","10.21076","1","0","0","0","1","0","0","2","0","0","1","0","1","0","2","0","0","2","0","0","2","0","0","2"
"Ariana","36.86012","10.19337","2","1","0","1","1","0","0","5","2","1","1","0","4","0","2","2","1","5","1","2","2","0","0","5"
"Arifwala","30.29058","73.06574","2","0","0","0","0","0","0","2","1","0","0","1","2","2","0","0","0","2","0","0","1","0","1","2"
"Arima","10.63737","-61.28228","2","0","0","0","0","0","0","2","0","2","0","0","2","0","2","0","0","2","2","0","0","0","0","2"
"Arish","31.13159","33.79844","3","0","0","0","0","0","0","3","1","2","0","0","3","1","2","0","0","3","0","0","1","2","0","3"
"Arles","42.45654","2.63457","1","0","0","0","0","0","0","1","1","0","0","0","1","0","0","1","0","1","0","1","0","0","0","1"
"Arles","43.67681","4.63031","1","0","0","0","0","0","0","1","1","0","0","0","1","0","0","1","0","1","0","1","0","0","0","1"
"Arlesey","52.00713","-0.26565","0","0","0","0","0","0","1","1","0","0","1","0","1","0","1","0","0","1","0","1","0","0","0","1"
"Arlington","48.19871","-122.12514","2","0","0","0","0","0","0","2","0","0","2","0","2","0","1","1","0","2","0","1","1","0","0","2"
"Arlington","45.7168","-120.20088","2","0","0","0","0","0","0","2","0","0","2","0","2","0","1","1","0","2","0","1","1","0","0","2"
"Arlington","44.36441","-97.13312","2","0","0","0","0","0","0","2","0","0","2","0","2","0","1","1","0","2","0","1","1","0","0","2"
"Arlington","32.73569","-97.10807","2","0","0","0","0","0","0","2","0","0","2","0","2","0","1","1","0","2","0","1","1","0","0","2"
"Arlington","41.4525","-96.35113","2","0","0","0","0","0","0","2","0","0","2","0","2","0","1","1","0","2","0","1","1","0","0","2"
"Arlington","44.6083","-94.08053","2","0","0","0","0","0","0","2","0","0","2","0","2","0","1","1","0","2","0","1","1","0","0","2"
"Arlington","35.2962","-89.66147","2","0","0","0","0","0","0","2","0","0","2","0","2","0","1","1","0","2","0","1","1","0","0","2"
"Arlington","43.33804","-89.3804","2","0","0","0","0","0","0","2","0","0","2","0","2","0","1","1","0","2","0","1","1","0","0","2"
"Arlington","31.4399","-84.72492","2","0","0","0","0","0","0","2","0","0","2","0","2","0","1","1","0","2","0","1","1","0","0","2"
"Arlington","40.89366","-83.65021","2","0","0","0","0","0","0","2","0","0","2","0","2","0","1","1","0","2","0","1","1","0","0","2"
"Arlington","36.22736","-80.8334","2","0","0","0","0","0","0","2","0","0","2","0","2","0","1","1","0","2","0","1","1","0","0","2"
"Arlington","38.88101","-77.10428","2","0","0","0","0","0","0","2","0","0","2","0","2","0","1","1","0","2","0","1","1","0","0","2"
"Arlington","39.34857","-76.68324","2","0","0","0","0","0","0","2","0","0","2","0","2","0","1","1","0","2","0","1","1","0","0","2"
"Arlington","41.69593","-73.8968","2","0","0","0","0","0","0","2","0","0","2","0","2","0","1","1","0","2","0","1","1","0","0","2"
"Arlington","43.0748","-73.154","2","0","0","0","0","0","0","2","0","0","2","0","2","0","1","1","0","2","0","1","1","0","0","2"
"Arlington","42.41537","-71.15644","2","0","0","0","0","0","0","2","0","0","2","0","2","0","1","1","0","2","0","1","1","0","0","2"
"Arlington","51.75884","-1.83604","2","0","0","0","0","0","0","2","0","0","2","0","2","0","1","1","0","2","0","1","1","0","0","2"
"Arluno","45.50344","8.94222","1","0","0","0","0","0","0","1","0","1","0","0","1","0","0","1","0","1","0","0","1","0","0","1"
"Armagh","54.35","-6.66667","2","1","0","0","0","0","1","4","1","1","2","0","4","0","2","2","0","4","0","2","2","0","0","4"
"Ar Ramthā","32.55873","36.00816","1","0","0","0","0","0","0","1","0","0","0","1","1","0","0","1","0","1","1","0","0","0","0","1"
"Ar Rass","25.86944","43.4973","0","1","0","0","0","0","0","1","0","0","1","0","1","0","0","1","0","1","0","0","1","0","0","1"
"Ar Rayyān","25.29194","51.42444","3","1","0","0","1","0","0","5","2","3","0","0","5","0","2","3","0","5","3","1","0","1","0","5"
"Ar Rifā‘","26.13","50.555","1","0","0","0","1","0","0","2","1","0","0","1","2","0","2","0","0","2","1","0","1","0","0","2"
"Arris","35.25881","6.34706","1","0","0","0","0","0","0","1","0","0","0","0","0","0","0","1","0","1","1","0","0","0","0","1"
"Ar Rumaythah","31.52845","45.20377","1","0","0","0","0","0","0","1","1","0","0","0","1","0","1","0","0","1","1","0","0","0","0","1"
"Arua","3.02013","30.91105","1","0","0","0","0","0","0","1","1","0","0","0","1","0","0","1","0","1","0","0","1","0","1","2"
"Arundel","43.38259","-70.47783","5","0","0","0","0","0","0","5","2","0","1","0","3","3","0","2","0","5","1","3","1","0","0","5"
"Arundel","50.85423","-0.55393","5","0","0","0","0","0","0","5","2","0","1","0","3","3","0","2","0","5","1","3","1","0","0","5"
"Arundel","-27.93768","153.36302","5","0","0","0","0","0","0","5","2","0","1","0","3","3","0","2","0","5","1","3","1","0","0","5"
"Arusha","-3.36667","36.68333","8","3","0","0","0","0","0","11","3","4","0","3","10","8","1","0","0","9","2","0","3","1","5","11"
"Asaba","6.19824","6.73187","2","0","0","0","0","0","0","2","0","0","0","0","0","2","0","0","0","2","1","0","0","0","1","2"
"Ascot","51.41082","-0.6748","8","0","0","0","0","0","3","11","2","5","2","0","9","5","1","5","0","11","0","3","7","0","1","11"
"Ascot","-31.93818","115.92258","8","0","0","0","0","0","3","11","2","5","2","0","9","5","1","5","0","11","0","3","7","0","1","11"
"Ascot","-36.7","144.33333","8","0","0","0","0","0","3","11","2","5","2","0","9","5","1","5","0","11","0","3","7","0","1","11"
"Ascot","-27.43154","153.058","8","0","0","0","0","0","3","11","2","5","2","0","9","5","1","5","0","11","0","3","7","0","1","11"
"Asenovgrad","42.01667","24.86667","1","0","0","0","0","0","0","1","0","1","0","0","1","1","0","0","0","1","1","0","0","0","0","1"
"Ashbourne","53.51163","-6.39821","7","0","0","0","0","0","1","8","1","6","0","0","7","7","0","1","0","8","7","0","1","0","0","8"
"Ashbourne","53.01667","-1.73333","7","0","0","0","0","0","1","8","1","6","0","0","7","7","0","1","0","8","7","0","1","0","0","8"
"Ashby-de-la-Zouch","52.74632","-1.4732","1","0","0","0","0","0","0","1","0","0","1","0","1","0","0","1","0","1","0","0","1","0","0","1"
"Asheville","35.60095","-82.55402","0","0","0","0","0","0","1","1","0","1","0","0","1","1","0","0","0","1","0","0","1","0","0","1"
"Ashford","43.58694","-88.37066","27","2","0","2","1","0","1","33","5","13","15","0","33","11","5","16","1","33","6","11","15","0","1","33"
"Ashford","31.18296","-85.23632","27","2","0","2","1","0","1","33","5","13","15","0","33","11","5","16","1","33","6","11","15","0","1","33"
"Ashford","53.00833","-6.11139","27","2","0","2","1","0","1","33","5","13","15","0","33","11","5","16","1","33","6","11","15","0","1","33"
"Ashford","51.43173","-0.45761","27","2","0","2","1","0","1","33","5","13","15","0","33","11","5","16","1","33","6","11","15","0","1","33"
"Ashford","51.14648","0.87376","27","2","0","2","1","0","1","33","5","13","15","0","33","11","5","16","1","33","6","11","15","0","1","33"
"Ashford","-34.94859","138.57457","27","2","0","2","1","0","1","33","5","13","15","0","33","11","5","16","1","33","6","11","15","0","1","33"
"Ashford","-29.32191","151.09308","27","2","0","2","1","0","1","33","5","13","15","0","33","11","5","16","1","33","6","11","15","0","1","33"
"Ashington","55.17719","-1.56412","5","0","0","0","2","0","0","7","1","3","0","0","4","4","0","3","0","7","1","2","3","0","1","7"
"Ashington","50.93312","-0.39087","5","0","0","0","2","0","0","7","1","3","0","0","4","4","0","3","0","7","1","2","3","0","1","7"
"Ashmūn","30.29735","30.97641","3","0","0","0","0","0","0","3","0","0","0","0","0","1","1","1","0","3","0","0","1","1","1","3"
"Ash Shafā","21.07268","40.31842","1","0","0","0","0","0","0","1","1","0","0","0","1","1","0","0","0","1","0","1","0","0","0","1"
"Ashtarak","40.2991","44.36204","1","0","0","0","0","0","0","1","0","1","0","0","1","1","0","0","0","1","0","0","1","0","0","1"
"Ashtead","51.30873","-0.29972","4","1","0","0","0","0","0","5","1","1","2","0","4","1","0","4","0","5","0","1","3","0","1","5"
"Ashton-under-Lyne","53.48876","-2.0989","2","0","0","0","0","0","0","2","0","0","1","0","1","1","1","0","0","2","0","0","2","0","0","2"
"Askøy","60.4","5.18333","1","0","0","0","0","0","0","1","0","1","0","0","1","1","0","0","0","1","1","0","0","0","0","1"
"Asnières-sur-Seine","48.91667","2.28333","1","0","0","0","0","0","0","1","1","0","0","0","1","0","0","1","0","1","0","0","1","0","0","1"
"Aş Şaff","29.56472","31.28111","0","0","0","0","1","0","0","1","1","0","0","0","1","0","1","0","0","1","0","0","0","0","1","1"
"As Sālimīyah","29.33389","48.07611","2","0","0","0","0","0","0","2","0","1","0","0","1","0","1","0","0","1","2","0","0","0","0","2"
"As Sulaymānīyah","35.56496","45.4329","13","1","0","0","0","0","0","14","8","3","2","0","13","5","2","7","0","14","3","2","9","0","0","14"
"As Sulayyil","20.46067","45.57792","1","0","0","0","0","0","0","1","0","1","0","0","1","1","0","0","0","1","1","0","0","0","0","1"
"As Suwayq","23.84944","57.43861","0","0","0","0","0","0","0","0","0","0","0","0","0","0","0","0","0","0","0","0","0","0","0","0"
"Astley","52.76667","-2.7","1","0","0","0","0","0","0","1","1","0","0","0","1","1","0","0","0","1","0","0","1","0","0","1"
"Aston Clinton","51.8002","-0.7254","1","0","0","0","0","0","0","1","0","1","0","0","1","1","0","0","0","1","0","0","1","0","0","1"
"Astoria","46.18788","-123.83125","2","0","0","0","0","0","0","2","0","0","1","0","1","0","0","2","0","2","0","1","1","0","0","2"
"Astoria","40.22754","-90.35957","2","0","0","0","0","0","0","2","0","0","1","0","1","0","0","2","0","2","0","1","1","0","0","2"
"Astoria","40.77205","-73.93014","2","0","0","0","0","0","0","2","0","0","1","0","1","0","0","2","0","2","0","1","1","0","0","2"
"Asunción","-25.28646","-57.647","2","1","0","0","0","0","0","3","1","2","0","0","3","3","0","0","0","3","1","0","2","0","0","3"
"Aswan","24.09082","32.89942","5","1","0","0","2","0","0","8","1","3","2","0","6","1","7","0","0","8","3","2","2","0","1","8"
"Asyūţ","27.18096","31.18368","8","0","0","0","0","0","0","8","1","4","0","2","7","3","2","2","1","8","2","1","3","0","2","8"
"Athens","32.20487","-95.85552","56","3","0","0","2","0","1","62","10","17","10","1","38","14","19","28","1","62","25","9","23","3","2","62"
"Athens","45.03302","-90.07402","56","3","0","0","2","0","1","62","10","17","10","1","38","14","19","28","1","62","25","9","23","3","2","62"
"Athens","39.96088","-89.72399","56","3","0","0","2","0","1","62","10","17","10","1","38","14","19","28","1","62","25","9","23","3","2","62"
"Athens","34.80243","-86.97219","56","3","0","0","2","0","1","62","10","17","10","1","38","14","19","28","1","62","25","9","23","3","2","62"
"Athens","42.08866","-85.23471","56","3","0","0","2","0","1","62","10","17","10","1","38","14","19","28","1","62","25","9","23","3","2","62"
"Athens","35.44285","-84.59299","56","3","0","0","2","0","1","62","10","17","10","1","38","14","19","28","1","62","25","9","23","3","2","62"
"Athens","33.96095","-83.37794","56","3","0","0","2","0","1","62","10","17","10","1","38","14","19","28","1","62","25","9","23","3","2","62"
"Athens","39.32924","-82.10126","56","3","0","0","2","0","1","62","10","17","10","1","38","14","19","28","1","62","25","9","23","3","2","62"
"Athens","37.42234","-81.0162","56","3","0","0","2","0","1","62","10","17","10","1","38","14","19","28","1","62","25","9","23","3","2","62"
"Athens","41.9573","-76.518","56","3","0","0","2","0","1","62","10","17","10","1","38","14","19","28","1","62","25","9","23","3","2","62"
"Athens","44.63341","-75.94936","56","3","0","0","2","0","1","62","10","17","10","1","38","14","19","28","1","62","25","9","23","3","2","62"
"Athens","42.26036","-73.80957","56","3","0","0","2","0","1","62","10","17","10","1","38","14","19","28","1","62","25","9","23","3","2","62"
"Athens","44.92311","-69.67283","56","3","0","0","2","0","1","62","10","17","10","1","38","14","19","28","1","62","25","9","23","3","2","62"
"Athens","37.98376","23.72784","56","3","0","0","2","0","1","62","10","17","10","1","38","14","19","28","1","62","25","9","23","3","2","62"
"Atherstone","52.57536","-1.54693","2","1","0","0","0","0","0","3","2","1","0","0","3","2","1","0","0","3","0","1","2","0","0","3"
"Athíenou","35.06183","33.54166","1","0","0","0","0","0","0","1","0","1","0","0","1","1","0","0","0","1","0","0","1","0","0","1"
"Athi River","-1.4563","36.97826","3","0","0","0","0","0","0","3","1","1","0","0","2","2","0","1","0","3","0","0","1","1","1","3"
"Athy","52.99139","-6.98028","1","0","0","0","0","0","0","1","1","0","0","0","1","1","0","0","0","1","0","0","1","0","0","1"
"Atlanta","33.11374","-94.16435","5","0","0","1","0","0","0","6","3","0","0","0","3","2","1","3","0","6","2","0","4","0","0","6"
"Atlanta","40.25948","-89.23342","5","0","0","1","0","0","0","6","3","0","0","0","3","2","1","3","0","6","2","0","4","0","0","6"
"Atlanta","40.21532","-86.02637","5","0","0","1","0","0","0","6","3","0","0","0","3","2","1","3","0","6","2","0","4","0","0","6"
"Atlanta","33.749","-84.38798","5","0","0","1","0","0","0","6","3","0","0","0","3","2","1","3","0","6","2","0","4","0","0","6"
"Atlanta","45.00473","-84.14389","5","0","0","1","0","0","0","6","3","0","0","0","3","2","1","3","0","6","2","0","4","0","0","6"
"Attock City","33.76671","72.35977","4","0","0","0","0","0","0","4","4","0","0","0","4","0","2","2","0","4","1","1","2","0","0","4"
"Atworth","51.39234","-2.19297","1","0","0","0","0","0","0","1","0","1","0","0","1","0","0","1","0","1","1","0","0","0","0","1"
"Auchinleck","55.47157","-4.29337","1","0","0","0","0","0","0","1","0","1","0","0","1","0","1","0","0","1","0","0","1","0","0","1"
"Auchterarder","56.29612","-3.70692","0","0","0","0","1","0","0","1","0","1","0","0","1","0","0","1","0","1","0","0","1","0","0","1"
"Auckland","-36.84853","174.76349","18","2","0","0","1","0","0","21","9","6","6","0","21","3","2","14","2","21","2","2","16","0","1","21"
"Audlem","52.98956","-2.50706","1","0","0","0","0","0","0","1","0","0","0","0","0","0","0","1","0","1","0","0","1","0","0","1"
"Augsburg","48.37154","10.89851","2","0","0","0","0","0","0","2","0","0","1","0","1","0","1","1","0","2","1","0","0","0","1","2"
"Augusta","37.68668","-96.9767","1","0","0","0","0","0","0","1","0","0","0","0","0","0","0","1","0","1","1","0","0","0","0","1"
"Augusta","35.28231","-91.36541","1","0","0","0","0","0","0","1","0","0","0","0","0","0","0","1","0","1","1","0","0","0","0","1"
"Augusta","44.68024","-91.11988","1","0","0","0","0","0","0","1","0","0","0","0","0","0","0","1","0","1","1","0","0","0","0","1"
"Augusta","40.23005","-90.95013","1","0","0","0","0","0","0","1","0","0","0","0","0","0","0","1","0","1","1","0","0","0","0","1"
"Augusta","42.33643","-85.35222","1","0","0","0","0","0","0","1","0","0","0","0","0","0","0","1","0","1","1","0","0","0","0","1"
"Augusta","38.77174","-84.00576","1","0","0","0","0","0","0","1","0","0","0","0","0","0","0","1","0","1","1","0","0","0","0","1"
"Augusta","33.47097","-81.97484","1","0","0","0","0","0","0","1","0","0","0","0","0","0","0","1","0","1","1","0","0","0","0","1"
"Augusta","42.97479","-75.50129","1","0","0","0","0","0","0","1","0","0","0","0","0","0","0","1","0","1","1","0","0","0","0","1"
"Augusta","44.31062","-69.77949","1","0","0","0","0","0","0","1","0","0","0","0","0","0","0","1","0","1","1","0","0","0","0","1"
"Augusta","37.24065","15.22121","1","0","0","0","0","0","0","1","0","0","0","0","0","0","0","1","0","1","1","0","0","0","0","1"
"Augusta","-34.31566","115.15922","1","0","0","0","0","0","0","1","0","0","0","0","0","0","0","1","0","1","1","0","0","0","0","1"
"Aurangabad","19.87757","75.34226","6","0","0","0","0","0","0","6","4","0","0","1","5","2","2","2","0","6","0","0","5","0","0","5"
"Aurora","45.23095","-122.75593","1","0","0","0","0","0","0","1","1","0","0","0","1","0","0","1","0","1","0","0","1","0","0","1"
"Aurora","38.92219","-111.93409","1","0","0","0","0","0","0","1","1","0","0","0","1","0","0","1","0","1","0","0","1","0","0","1"
"Aurora","39.72943","-104.83192","1","0","0","0","0","0","0","1","1","0","0","0","1","0","0","1","0","1","0","0","1","0","0","1"
"Aurora","40.86723","-98.00422","1","0","0","0","0","0","0","1","1","0","0","0","1","0","0","1","0","1","0","0","1","0","0","1"
"Aurora","33.06068","-97.50336","1","0","0","0","0","0","0","1","1","0","0","0","1","0","0","1","0","1","0","0","1","0","0","1"
"Aurora","44.28413","-96.68561","1","0","0","0","0","0","0","1","1","0","0","0","1","0","0","1","0","1","0","0","1","0","0","1"
"Aurora","36.97089","-93.71798","1","0","0","0","0","0","0","1","1","0","0","0","1","0","0","1","0","1","0","0","1","0","0","1"
"Aurora","47.52993","-92.23712","1","0","0","0","0","0","0","1","1","0","0","0","1","0","0","1","0","1","0","0","1","0","0","1"
"Aurora","41.76058","-88.32007","1","0","0","0","0","0","0","1","1","0","0","0","1","0","0","1","0","1","0","0","1","0","0","1"
"Aurora","39.057","-84.90134","1","0","0","0","0","0","0","1","1","0","0","0","1","0","0","1","0","1","0","0","1","0","0","1"
"Aurora","41.31755","-81.34539","1","0","0","0","0","0","0","1","1","0","0","0","1","0","0","1","0","1","0","0","1","0","0","1"
"Aurora","44.00011","-79.46632","1","0","0","0","0","0","0","1","1","0","0","0","1","0","0","1","0","1","0","0","1","0","0","1"
"Aurora","35.30545","-76.78854","1","0","0","0","0","0","0","1","1","0","0","0","1","0","0","1","0","1","0","0","1","0","0","1"
"Aurora","42.75396","-76.70245","1","0","0","0","0","0","0","1","1","0","0","0","1","0","0","1","0","1","0","0","1","0","0","1"
"Aurora","-6.9425","-38.9675","1","0","0","0","0","0","0","1","1","0","0","0","1","0","0","1","0","1","0","0","1","0","0","1"
"Aurora","44.19285","22.93916","1","0","0","0","0","0","0","1","1","0","0","0","1","0","0","1","0","1","0","0","1","0","0","1"
"Aurora","13.2322","121.1203","1","0","0","0","0","0","0","1","1","0","0","0","1","0","0","1","0","1","0","0","1","0","0","1"
"Aurora","16.99065","121.63664","1","0","0","0","0","0","0","1","1","0","0","0","1","0","0","1","0","1","0","0","1","0","0","1"
"Aurora","13.3476","122.5195","1","0","0","0","0","0","0","1","1","0","0","0","1","0","0","1","0","1","0","0","1","0","0","1"
"Aurora","7.9506","123.5826","1","0","0","0","0","0","0","1","1","0","0","0","1","0","0","1","0","1","0","0","1","0","0","1"
"Aurora","8.59306","125.8375","1","0","0","0","0","0","0","1","1","0","0","0","1","0","0","1","0","1","0","0","1","0","0","1"
"Austell","33.81261","-84.63438","1","0","0","0","0","0","0","1","0","1","0","0","1","0","0","1","0","1","1","0","0","0","0","1"
"Austin","30.26715","-97.74306","5","0","0","0","0","0","2","7","2","2","1","0","5","3","2","2","0","7","1","2","4","0","0","7"
"Austin","43.66663","-92.97464","5","0","0","0","0","0","2","7","2","2","1","0","5","3","2","2","0","7","1","2","4","0","0","7"
"Austin","34.99842","-91.98376","5","0","0","0","0","0","2","7","2","2","1","0","5","3","2","2","0","7","1","2","4","0","0","7"
"Austin","38.75839","-85.80803","5","0","0","0","0","0","2","7","2","2","1","0","5","3","2","2","0","7","1","2","4","0","0","7"
"Austin","41.63118","-78.09139","5","0","0","0","0","0","2","7","2","2","1","0","5","3","2","2","0","7","1","2","4","0","0","7"
"Avdiyivka","51.7766","32.79988","1","0","0","0","0","0","0","1","0","1","0","0","1","0","0","1","0","1","1","0","0","0","0","1"
"Avdiyivka","48.13989","37.74255","1","0","0","0","0","0","0","1","0","1","0","0","1","0","0","1","0","1","1","0","0","0","0","1"
"Aventura","25.95648","-80.13921","1","0","0","0","0","0","0","1","0","0","0","0","0","1","0","0","0","1","1","0","0","0","0","1"
"Avignon","43.94834","4.80892","1","0","0","0","0","0","0","1","0","1","0","0","1","0","1","0","0","1","0","0","0","0","1","1"
"Avilés","43.55473","-5.92483","1","0","0","0","0","0","0","1","1","0","0","0","1","0","0","1","0","1","0","0","1","0","0","1"
"Avoch","57.56898","-4.17675","0","0","0","0","1","0","0","1","0","0","1","0","1","1","0","0","0","1","1","0","0","0","0","1"
"Avon","39.63137","-106.52225","1","0","0","0","0","0","0","1","0","1","0","0","1","1","0","0","0","1","1","0","0","0","0","1"
"Avon","43.005","-98.0598","1","0","0","0","0","0","0","1","0","1","0","0","1","1","0","0","0","1","1","0","0","0","0","1"
"Avon","45.60913","-94.45167","1","0","0","0","0","0","0","1","0","1","0","0","1","1","0","0","0","1","1","0","0","0","0","1"
"Avon","40.66421","-90.43485","1","0","0","0","0","0","0","1","0","1","0","0","1","1","0","0","0","1","1","0","0","0","0","1"
"Avon","39.76282","-86.39972","1","0","0","0","0","0","0","1","0","1","0","0","1","1","0","0","0","1","1","0","0","0","0","1"
"Avon","31.18934","-85.28604","1","0","0","0","0","0","0","1","0","1","0","0","1","1","0","0","0","1","1","0","0","0","0","1"
"Avon","41.45171","-82.03542","1","0","0","0","0","0","0","1","0","1","0","0","1","1","0","0","0","1","1","0","0","0","0","1"
"Avon","42.91201","-77.74556","1","0","0","0","0","0","0","1","0","1","0","0","1","1","0","0","0","1","1","0","0","0","0","1"
"Avon","40.34565","-76.38996","1","0","0","0","0","0","0","1","0","1","0","0","1","1","0","0","0","1","1","0","0","0","0","1"
"Avon","35.35212","-75.51043","1","0","0","0","0","0","0","1","0","1","0","0","1","1","0","0","0","1","1","0","0","0","0","1"
"Avon","42.13066","-71.04116","1","0","0","0","0","0","0","1","0","1","0","0","1","1","0","0","0","1","1","0","0","0","0","1"
"Avon","44.80617","-70.27118","1","0","0","0","0","0","0","1","0","1","0","0","1","1","0","0","0","1","1","0","0","0","0","1"
"Avon","48.40219","2.72022","1","0","0","0","0","0","0","1","0","1","0","0","1","1","0","0","0","1","1","0","0","0","0","1"
"Avtury","43.16345","46.00152","1","0","0","0","0","0","0","1","0","0","0","1","1","0","0","0","1","1","0","1","0","0","0","1"
"Aweil","8.76194","27.39194","1","0","0","0","0","0","0","1","0","1","0","0","1","0","0","0","1","1","1","0","0","0","0","1"
"Awka","6.21269","7.07199","3","0","0","0","0","0","0","3","0","0","2","0","2","0","1","2","0","3","2","0","0","1","0","3"
"Axim","4.86641","-2.24181","3","0","0","0","0","0","0","3","0","3","0","0","3","1","0","0","1","2","0","0","2","0","1","3"
"Axminster","50.78259","-2.99787","4","0","0","0","0","0","0","4","1","0","0","0","1","2","0","2","0","4","0","2","2","0","0","4"
"Axum","14.12109","38.72337","3","0","0","0","0","0","0","3","1","0","1","0","2","1","1","1","0","3","0","0","1","0","2","3"
"Aydın","37.84501","27.83963","1","0","0","0","0","0","0","1","0","0","0","0","0","0","0","1","0","1","1","0","0","0","0","1"
"Ayia Napa","34.98213","34.00183","1","0","0","0","0","0","0","1","0","1","0","0","1","0","0","1","0","1","1","0","0","0","0","1"
"Aying","47.9701","11.77752","1","0","0","0","0","0","0","1","0","0","1","0","1","0","0","1","0","1","0","0","1","0","0","1"
"Aylburton","51.71506","-2.55312","1","0","0","0","0","0","0","1","0","0","1","0","1","0","0","1","0","1","0","1","0","0","0","1"
"Aylesbury","51.81665","-0.81458","18","2","0","1","2","0","2","25","5","11","5","0","21","11","0","12","1","24","5","12","7","0","1","25"
"Aylesford","51.30374","0.47936","2","0","0","0","0","0","0","2","0","2","0","0","2","1","0","1","0","2","1","0","1","0","0","2"
"Ayr","55.46273","-4.63393","2","1","0","0","0","0","1","4","0","0","4","0","4","3","0","1","0","4","0","2","2","0","0","4"
"Ayr","-19.57393","147.40666","2","1","0","0","0","0","1","4","0","0","4","0","4","3","0","1","0","4","0","2","2","0","0","4"
"Azamgarh","26.06832","83.18358","1","0","0","0","0","0","0","1","1","0","0","0","1","1","0","0","0","1","0","0","1","0","0","1"
"Azazga","36.74472","4.37222","2","0","0","0","0","0","0","2","0","0","2","0","2","2","0","0","0","2","0","1","1","0","0","2"
"Azimpur","23.7298","90.3854","2","0","0","0","0","0","0","2","0","1","0","1","2","1","0","0","1","2","0","0","2","0","0","2"
"Az Zāwīyah","32.7571","12.72764","2","0","0","0","0","0","0","2","1","0","0","1","2","0","0","1","1","2","0","1","1","0","0","2"
"Ba","-10.4771","121.9882","3","0","0","0","0","0","0","3","0","2","0","0","2","2","1","0","0","3","0","0","1","0","2","3"
"Ba","-17.5343","177.67407","3","0","0","0","0","0","0","3","0","2","0","0","2","2","1","0","0","3","0","0","1","0","2","3"
"Baabda","33.83389","35.54417","4","0","0","0","0","0","0","4","1","1","0","0","2","1","3","0","0","4","1","0","2","0","1","4"
"Baalbek","34.00583","36.21806","3","0","0","0","0","0","0","3","0","0","0","0","0","1","2","0","0","3","1","0","2","0","0","3"
"Baardheere","2.34464","42.27644","1","0","0","0","0","0","0","1","0","0","0","1","1","1","0","0","0","1","0","0","1","0","0","1"
"Baarle-Nassau","51.4475","4.92917","1","0","0","0","0","0","0","1","1","0","0","0","1","0","0","1","0","1","0","0","1","0","0","1"
"Baarn","52.21167","5.2875","1","0","0","0","0","0","0","1","0","0","0","0","0","0","1","0","0","1","0","1","0","0","0","1"
"Babati","-4.21667","35.75","1","0","0","0","0","0","0","1","0","0","0","1","1","1","0","0","0","1","0","0","0","0","0","0"
"Baboucar Toumbou","14.10898","-16.71909","1","0","0","0","0","0","0","1","0","1","0","0","1","1","0","0","0","1","0","0","1","0","0","1"
"Babworth","53.31799","-0.97583","1","0","0","0","0","0","0","1","0","0","0","0","0","0","0","1","0","1","0","0","1","0","0","1"
"Bacău","46.56718","26.91384","2","0","0","0","0","0","0","2","1","1","0","0","2","0","1","1","0","2","0","0","1","0","1","2"
"Bacolod City","10.66667","122.95","1","0","0","0","0","0","0","1","1","0","0","0","1","0","1","0","0","1","0","0","1","0","0","1"
"Bacoor","14.45896","120.93851","1","0","0","0","0","0","0","1","0","0","1","0","1","0","0","1","0","1","0","1","0","0","0","1"
"Bacup","53.70336","-2.2007","2","0","0","0","0","0","0","2","0","0","1","0","1","0","0","2","0","2","0","1","1","0","0","2"
"Badarganj","25.67419","89.05377","23","0","0","0","1","1","0","25","6","12","1","1","20","13","7","5","0","25","6","0","10","0","9","25"
"Bad Dürkheim","49.4618","8.17236","0","0","0","0","0","0","1","1","0","0","0","0","0","1","0","0","0","1","0","0","1","0","0","1"
"Badin","35.40597","-80.11672","3","0","0","0","0","0","0","3","2","0","0","0","2","2","1","0","0","3","0","1","2","0","0","3"
"Badin","24.656","68.837","3","0","0","0","0","0","0","3","2","0","0","0","2","2","1","0","0","3","0","1","2","0","0","3"
"Badlapur","19.15516","73.26553","1","0","0","0","0","0","0","1","1","0","0","0","1","0","0","1","0","1","0","0","1","0","0","1"
"Bad Segeberg","53.94313","10.30215","1","0","0","0","0","0","0","1","1","0","0","0","1","0","0","1","0","1","0","0","0","1","0","1"
"Badulla","6.9802","81.0577","2","0","0","0","0","0","0","2","1","1","0","0","2","1","0","0","1","2","0","0","1","0","1","2"
"Bafoussam","5.47775","10.41759","3","0","0","0","0","0","0","3","1","2","0","0","3","3","0","0","0","3","0","0","3","0","0","3"
"Bagamoyo","-6.44222","38.90422","3","0","0","0","0","0","0","3","0","0","1","0","1","0","1","1","0","2","0","0","3","0","0","3"
"Bagerhat","22.65657","89.79123","1","0","0","0","0","0","0","1","0","0","0","0","0","0","0","1","0","1","0","0","1","0","0","1"
"Bagh","33.98111","73.77608","1","0","0","0","0","0","0","1","0","1","0","0","1","0","1","0","0","1","0","0","0","0","1","1"
"Baghdad","33.34058","44.40088","63","1","0","1","1","0","1","67","28","16","9","0","53","24","18","21","4","67","25","9","30","0","3","67"
"Bāgh-e Maīdān","35.22156","69.21397","1","0","0","0","0","0","0","1","1","0","0","0","1","1","0","0","0","1","0","0","0","0","0","0"
"Bāglung","28.27189","83.58975","19","1","0","0","2","0","0","22","14","2","2","0","18","7","6","8","0","21","2","1","11","1","7","22"
"Bagneux","48.79565","2.30796","2","0","0","0","0","0","0","2","1","0","1","0","2","0","1","1","0","2","0","0","2","0","0","2"
"Bago","17.33521","96.48135","1","0","0","0","0","0","0","1","0","0","0","0","0","1","0","0","0","1","0","0","1","0","0","1"
"Bago","-8.0684","111.9091","1","0","0","0","0","0","0","1","0","0","0","0","0","1","0","0","0","1","0","0","1","0","0","1"
"Bagshot","51.36069","-0.68802","4","0","0","0","0","0","0","4","0","1","1","0","2","0","0","4","0","4","0","2","1","0","1","4"
"Baguio","16.41639","120.59306","3","0","0","0","0","0","0","3","1","1","1","0","3","1","1","1","0","3","0","1","2","0","0","3"
"Bahau","2.8079","102.4049","1","0","0","0","0","0","0","1","0","0","0","0","0","1","0","0","0","1","0","0","0","1","0","1"
"Bahawalnagar","29.99835","73.25272","2","0","0","0","0","0","0","2","0","0","1","1","2","2","0","0","0","2","0","0","1","0","1","2"
"Bahawalnagar","30.55083","73.39083","2","0","0","0","0","0","0","2","0","0","1","1","2","2","0","0","0","2","0","0","1","0","1","2"
"Bahawalpur","29.39779","71.6752","17","1","0","0","2","0","0","20","8","7","0","0","15","11","3","6","0","20","5","1","9","0","5","20"
"Bahçelievler","41.00231","28.8598","1","0","0","0","0","0","0","1","1","0","0","0","1","0","1","0","0","1","0","1","0","0","0","1"
"Bahía Blanca","-38.71959","-62.27243","1","0","0","0","0","0","0","1","0","1","0","0","1","0","0","1","0","1","0","0","1","0","0","1"
"Bahir Dar","11.59364","37.39077","4","0","0","0","0","0","0","4","1","0","1","3","5","2","0","2","1","5","2","0","1","0","1","4"
"Bahlā’","22.97886","57.3047","1","0","0","0","0","0","0","1","0","1","0","0","1","0","1","0","0","1","1","0","0","0","0","1"
"Baia Mare","47.65729","23.56808","2","0","0","0","0","0","0","2","0","0","1","0","1","2","0","0","0","2","0","0","2","0","0","2"
"Bairnsdale","-37.82289","147.61041","1","0","0","0","0","0","0","1","0","1","0","0","1","1","0","0","0","1","1","0","0","0","0","1"
"Bājitpur","24.21623","90.95002","1","0","0","0","0","0","0","1","1","0","0","0","1","0","1","0","0","1","0","0","1","0","0","1"
"Bakau","13.47806","-16.68194","1","0","0","0","0","0","0","1","0","0","1","0","1","1","0","0","0","1","0","0","1","0","0","1"
"Bakau","-2.4105","116.2387","1","0","0","0","0","0","0","1","0","0","1","0","1","1","0","0","0","1","0","0","1","0","0","1"
"Bakersfield","35.37329","-119.01871","0","0","0","0","0","0","1","1","0","1","0","0","1","1","0","0","0","1","1","0","0","0","0","1"
"Bakewell","53.21338","-1.67481","3","0","0","0","0","0","0","3","1","2","0","0","3","0","0","3","0","3","0","2","1","0","0","3"
"Bakewell","-12.49684","130.99344","3","0","0","0","0","0","0","3","1","2","0","0","3","0","0","3","0","3","0","2","1","0","0","3"
"Baku","40.37767","49.89201","7","0","0","1","0","0","0","8","1","2","0","2","5","2","1","4","1","8","3","3","1","0","1","8"
"Balad","34.01485","44.14574","1","0","0","0","1","0","0","2","0","1","0","0","1","0","2","0","0","2","1","0","1","0","0","2"
"Balakhani","40.46344","49.91893","1","0","0","0","0","0","0","1","1","0","0","0","1","0","0","1","0","1","0","0","1","0","0","1"
"Baldock","51.98781","-0.18835","5","0","0","1","0","0","0","6","1","2","2","0","5","2","1","3","0","6","2","1","3","0","0","6"
"Baldone","56.74451","24.40078","1","0","0","0","0","0","0","1","0","0","0","0","0","0","0","1","0","1","1","0","0","0","0","1"
"Baldoyle","53.39972","-6.12583","0","0","0","0","1","0","0","1","0","0","1","0","1","1","0","0","0","1","0","0","1","0","0","1"
"Balıkesir","39.64917","27.88611","1","0","0","0","0","0","0","1","0","1","0","0","1","0","0","1","0","1","1","0","0","0","0","1"
"Balikpapan","-1.26753","116.82887","1","0","0","0","0","0","0","1","0","0","0","0","0","0","0","1","0","1","0","0","1","0","0","1"
"Balkh","36.75635","66.8972","2","0","0","0","0","0","0","2","0","1","1","0","2","0","0","1","1","2","0","0","2","0","0","2"
"Ballater","57.05011","-3.03798","1","0","0","0","0","0","0","1","0","1","0","0","1","1","0","0","0","1","1","0","0","0","0","1"
"Ballerup","55.73165","12.36328","0","0","0","0","0","0","1","1","1","0","0","0","1","1","0","0","0","1","1","0","0","0","0","1"
"Ballina","54.11667","-9.16667","1","0","0","0","0","0","0","1","0","0","1","0","1","1","0","0","0","1","0","0","1","0","0","1"
"Ballina","52.80778","-8.43556","1","0","0","0","0","0","0","1","0","0","1","0","1","1","0","0","0","1","0","0","1","0","0","1"
"Ballina","-28.86414","153.56541","1","0","0","0","0","0","0","1","0","0","1","0","1","1","0","0","0","1","0","0","1","0","0","1"
"Ballingry","56.16392","-3.32841","1","0","0","0","0","0","0","1","0","1","0","0","1","1","0","0","0","1","1","0","0","0","0","1"
"Ballinrobe","53.63333","-9.23333","1","0","0","0","0","0","0","1","0","0","1","0","1","0","0","1","0","1","0","0","1","0","0","1"
"Ballito","-29.53897","31.21439","0","0","0","0","0","0","0","0","0","0","0","0","0","0","0","0","0","0","0","0","0","0","0","0"
"Ballsh","40.59889","19.73472","1","0","0","0","0","0","0","1","1","0","0","0","1","1","0","0","0","1","0","0","1","0","0","1"
"Ballyfermot","53.34283","-6.3548","1","0","0","0","0","0","0","1","0","0","1","0","1","0","0","1","0","1","0","0","1","0","0","1"
"Ballymena","54.86357","-6.27628","3","0","0","0","0","0","1","4","1","0","3","0","4","1","0","3","0","4","0","2","2","0","0","4"
"Ballymoney","55.0708","-6.51009","7","0","0","0","1","0","0","8","1","0","7","0","8","0","8","0","0","8","0","2","6","0","0","8"
"Baltimore","39.84534","-82.60072","5","0","0","0","0","0","0","5","0","1","2","1","4","2","0","3","0","5","3","0","2","0","0","5"
"Baltimore","39.29038","-76.61219","5","0","0","0","0","0","0","5","0","1","2","1","4","2","0","3","0","5","3","0","2","0","0","5"
"Baltimore Highlands","39.23316","-76.63663","1","0","0","0","0","0","0","1","0","0","0","0","0","0","0","1","0","1","1","0","0","0","0","1"
"Bamako","12.65","-8","1","0","0","0","0","0","0","1","1","0","0","0","1","0","0","0","1","1","0","0","0","0","1","1"
"Bamberg","33.2971","-81.03482","1","0","0","0","0","0","0","1","0","1","0","0","1","1","0","0","0","1","1","0","0","0","0","1"
"Bamberg","49.89873","10.90067","1","0","0","0","0","0","0","1","0","1","0","0","1","1","0","0","0","1","1","0","0","0","0","1"
"Bamenda","5.9597","10.14597","6","0","0","0","0","0","0","6","2","3","0","1","6","4","1","0","1","6","0","1","2","0","3","6"
"Bampton","51.72634","-1.54547","1","0","0","0","0","0","1","2","1","1","0","0","2","1","0","1","0","2","1","0","1","0","0","2"
"Banbridge","54.35","-6.28333","2","0","0","0","1","0","0","3","0","0","2","0","2","1","0","2","0","3","2","0","1","0","0","3"
"Banbury","52.0632","-1.34222","18","0","0","0","3","0","2","23","2","9","9","0","20","9","3","10","0","22","5","7","11","0","0","23"
"Banchory","57.05168","-2.48824","1","0","0","0","0","0","0","1","0","0","1","0","1","0","0","1","0","1","0","0","1","0","0","1"
"Bandar Seri Begawan","4.89035","114.94006","3","0","0","0","0","0","0","3","0","0","0","1","1","1","0","1","1","3","2","0","1","0","0","3"
"Banderilla","19.58893","-96.93727","1","0","0","0","0","0","0","1","1","0","0","0","1","0","0","1","0","1","0","1","0","0","0","1"
"Bandipura","34.41728","74.64308","3","0","0","0","0","0","0","3","2","1","0","0","3","2","0","1","0","3","0","1","2","0","0","3"
"Banepā","27.63245","85.52192","2","0","0","0","0","0","0","2","2","0","0","0","2","1","1","0","0","2","0","0","2","0","0","2"
"Banfora","10.63333","-4.76667","1","0","0","0","0","0","0","1","0","1","0","0","1","2","1","0","0","3","0","0","2","0","1","3"
"Bang Bua Thong","13.91783","100.42403","0","1","0","0","0","0","0","1","1","0","0","0","1","0","0","1","0","1","0","1","0","0","0","1"
"Bangkok","13.75398","100.50144","7","0","0","0","0","0","0","7","2","2","1","0","5","3","2","2","0","7","0","2","5","0","0","7"
"Bangkok Yai","13.72319","100.476","1","0","0","0","0","0","0","1","0","0","1","0","1","1","0","0","0","1","0","0","1","0","0","1"
"Bangor","39.3885","-121.40524","11","0","0","1","1","0","0","13","1","5","6","0","12","4","3","6","0","13","3","2","8","0","0","13"
"Bangor","43.89302","-90.99041","11","0","0","1","1","0","0","13","1","5","6","0","12","4","3","6","0","13","3","2","8","0","0","13"
"Bangor","42.31254","-86.11308","11","0","0","1","1","0","0","13","1","5","6","0","12","4","3","6","0","13","3","2","8","0","0","13"
"Bangor","40.86565","-75.20657","11","0","0","1","1","0","0","13","1","5","6","0","12","4","3","6","0","13","3","2","8","0","0","13"
"Bangor","44.80118","-68.77781","11","0","0","1","1","0","0","13","1","5","6","0","12","4","3","6","0","13","3","2","8","0","0","13"
"Bangor","54.65338","-5.66895","11","0","0","1","1","0","0","13","1","5","6","0","12","4","3","6","0","13","3","2","8","0","0","13"
"Bangor","53.22752","-4.12936","11","0","0","1","1","0","0","13","1","5","6","0","12","4","3","6","0","13","3","2","8","0","0","13"
"Bangor","47.31557","-3.1894","11","0","0","1","1","0","0","13","1","5","6","0","12","4","3","6","0","13","3","2","8","0","0","13"
"Bangor","-34.01667","151.03333","11","0","0","1","1","0","0","13","1","5","6","0","12","4","3","6","0","13","3","2","8","0","0","13"
"Banhā","30.45977","31.1842","8","1","0","0","0","0","0","9","4","0","3","0","7","1","5","3","0","9","0","0","8","1","0","9"
"Banī Mazār","28.5036","30.8004","5","0","0","0","0","0","0","5","0","0","5","0","5","5","0","0","0","5","0","0","5","0","0","5"
"Banī Suwayf","29.07441","31.09785","4","0","0","0","0","0","0","4","2","1","0","1","4","1","0","2","1","4","2","0","2","0","0","4"
"Banja Luka","44.77842","17.19386","15","1","0","0","0","0","0","16","1","2","1","0","4","7","8","1","0","16","15","1","0","0","0","16"
"Banjul","13.45274","-16.57803","1","1","0","0","0","0","0","2","1","1","0","0","2","1","1","0","0","2","1","0","0","0","1","2"
"Bannu","32.98527","70.60403","1","0","0","0","0","0","0","1","0","1","0","0","1","0","1","0","0","1","0","0","0","0","1","1"
"Banská Bystrica","48.73946","19.15349","1","1","0","0","1","0","0","3","0","0","0","0","0","0","1","2","0","3","0","0","2","0","1","3"
"Bansko","41.8383","23.48851","1","0","0","0","0","0","0","1","1","0","0","0","1","0","0","1","0","1","0","0","1","0","0","1"
"Banstead","51.32233","-0.20685","4","1","0","0","1","0","1","7","2","3","1","0","6","1","1","5","0","7","2","1","4","0","0","7"
"Banting","2.8136","101.50185","1","0","0","0","0","0","0","1","0","1","0","0","1","0","0","1","0","1","0","0","1","0","0","1"
"Baoma","7.99344","-11.71468","0","0","0","0","1","0","0","1","0","0","0","0","0","1","0","0","0","1","0","1","0","0","0","1"
"Baqubah","33.75403","44.60518","3","1","0","0","0","0","0","4","3","0","0","0","3","2","0","2","0","4","0","0","3","0","1","4"
"Bar","42.0937","19.09841","1","0","0","0","0","0","0","1","0","0","0","1","1","1","0","0","0","1","0","1","0","0","0","1"
"Bar","49.07717","27.68256","1","0","0","0","0","0","0","1","0","0","0","1","1","1","0","0","0","1","0","1","0","0","0","1"
"Barcelona","10.13625","-64.68618","15","1","0","1","1","0","0","18","7","1","0","0","8","2","3","13","0","18","2","2","12","1","1","18"
"Barcelona","41.38879","2.15899","15","1","0","1","1","0","0","18","7","1","0","0","8","2","3","13","0","18","2","2","12","1","1","18"
"Barcelona","13.7715","123.0485","15","1","0","1","1","0","0","18","7","1","0","0","8","2","3","13","0","18","2","2","12","1","1","18"
"Barcelona","8.5275","123.4587","15","1","0","1","1","0","0","18","7","1","0","0","8","2","3","13","0","18","2","2","12","1","1","18"
"Barcelona","12.8683","124.1419","15","1","0","1","1","0","0","18","7","1","0","0","8","2","3","13","0","18","2","2","12","1","1","18"
"Barcelona","8.15917","126.43417","15","1","0","1","1","0","0","18","7","1","0","0","8","2","3","13","0","18","2","2","12","1","1","18"
"Barddhamān","23.25572","87.85691","3","0","0","0","1","0","0","4","1","1","0","0","2","1","2","1","0","4","1","0","2","0","1","4"
"Bardiyā","28.30058","81.3536","1","0","0","0","0","0","1","2","2","0","0","0","2","1","0","1","0","2","0","0","2","0","0","2"
"Bareilly","28.36678","79.43167","1","2","0","0","0","0","0","3","0","1","2","0","3","1","2","0","0","3","0","0","3","0","0","3"
"Bargaal","11.28636","51.0773","0","0","0","0","0","0","1","1","1","0","0","0","1","0","0","1","0","1","0","0","1","0","0","1"
"Bargoed","51.68333","-3.23333","1","1","0","0","1","0","1","4","1","1","2","0","4","2","2","0","0","4","2","1","1","0","0","4"
"Bari","41.12066","16.86982","2","0","0","0","0","0","0","2","0","0","0","0","0","0","1","1","0","2","1","0","0","0","1","2"
"Bari","-8.3518","120.1822","2","0","0","0","0","0","0","2","0","0","0","0","0","0","1","1","0","2","1","0","0","0","1","2"
"Bariadi","-2.8","33.98333","1","0","0","0","0","0","0","1","0","1","0","0","1","1","0","0","0","1","0","0","0","0","0","0"
"Barika","35.38901","5.36584","1","0","0","0","0","0","0","1","0","0","0","1","1","0","1","0","0","1","0","0","0","0","1","1"
"Baringo","0.46667","35.96667","4","0","0","0","0","0","0","4","0","3","1","0","4","2","0","2","0","4","0","1","2","1","0","4"
"Barisāl","22.70497","90.37013","5","0","0","0","0","0","0","5","3","1","0","1","5","5","0","0","0","5","0","3","2","0","0","5"
"Barking","51.53333","0.08333","1","0","0","0","0","0","0","1","0","0","1","0","1","0","0","1","0","1","0","0","0","1","0","1"
"Barmstedt","53.79209","9.76739","2","0","0","0","0","0","0","2","0","2","0","0","2","2","0","0","0","2","2","0","0","0","0","2"
"Barnard Castle","54.5415","-1.919","4","0","0","0","0","0","0","4","1","1","2","0","4","3","0","1","0","4","0","0","3","0","1","4"
"Barnet","51.65","-0.2","15","0","0","2","2","0","0","19","8","0","4","0","12","3","6","10","0","19","0","10","9","0","0","19"
"Barnoldswick","53.91711","-2.18705","4","0","0","0","1","0","0","5","1","3","1","0","5","1","1","3","0","5","2","1","2","0","0","5"
"Barnsley","53.55","-1.48333","13","1","0","0","0","0","0","14","2","6","3","0","11","4","3","6","1","14","4","6","4","0","0","14"
"Barnsley","-32.93333","151.58333","13","1","0","0","0","0","0","14","2","6","3","0","11","4","3","6","1","14","4","6","4","0","0","14"
"Barnstaple","51.08022","-4.05808","6","0","0","0","1","0","0","7","1","3","3","0","7","4","0","3","0","7","1","0","5","0","1","7"
"Barranquilla","10.96854","-74.78132","4","0","0","0","1","0","0","5","3","1","0","0","4","0","3","2","0","5","1","0","4","0","0","5"
"Barrow in Furness","54.11094","-3.22758","14","0","0","1","0","0","1","16","3","9","3","0","15","7","5","4","0","16","6","2","8","0","0","16"
"Barrow upon Soar","52.75178","-1.14601","0","0","0","0","1","0","0","1","1","0","0","0","1","0","0","1","0","1","0","0","1","0","0","1"
"Barry","39.69421","-91.03902","13","0","0","0","0","0","3","16","4","6","5","1","16","6","2","8","0","16","6","4","6","0","0","16"
"Barry","51.39979","-3.2838","13","0","0","0","0","0","3","16","4","6","5","1","16","6","2","8","0","16","6","4","6","0","0","16"
"Bartley Green","52.43532","-1.99707","0","0","0","0","0","0","1","1","1","0","0","0","1","1","0","0","0","1","0","0","1","0","0","1"
"Bartow","27.89641","-81.84314","0","0","0","0","0","0","1","1","0","1","0","0","1","1","0","0","0","1","1","0","0","0","0","1"
"Bartow","53.81664","13.34582","0","0","0","0","0","0","1","1","0","1","0","0","1","1","0","0","0","1","1","0","0","0","0","1"
"Barueri","-23.51056","-46.87611","1","0","0","0","0","0","0","1","0","1","0","0","1","1","0","0","0","1","0","0","1","0","0","1"
"Baruta","10.43424","-66.87558","1","0","0","0","0","0","0","1","0","1","0","0","1","0","0","1","0","1","1","0","0","0","0","1"
"Baschurch","52.78848","-2.85284","1","0","0","0","0","0","0","1","0","1","0","0","1","0","0","1","0","1","0","0","1","0","0","1"
"Basel","47.55839","7.57327","1","0","0","0","0","0","0","1","0","1","0","0","1","0","0","1","0","1","0","0","0","1","0","1"
"Basildon","51.56844","0.45782","11","0","0","0","1","0","0","12","0","6","4","0","10","5","3","4","0","12","4","2","5","0","1","12"
"Basingstoke","51.26249","-1.08708","51","2","1","3","2","0","3","62","18","10","22","0","50","20","16","30","0","66","7","16","40","2","1","66"
"Basrah","30.50852","47.7804","5","0","0","0","0","0","0","5","1","3","0","0","4","0","2","3","0","5","2","1","2","0","0","5"
"Basse Santa Su","13.30995","-14.21373","1","0","0","0","0","0","0","1","0","1","0","0","1","1","0","0","0","1","0","0","1","0","0","1"
"Basyūn","30.93976","30.81338","1","0","0","0","0","0","0","1","0","0","0","0","0","0","1","0","0","1","0","0","1","0","0","1"
"Batam","1.14937","104.02491","0","0","0","0","0","0","0","0","0","1","0","0","1","0","0","1","0","1","1","0","0","0","0","1"
"Batang","29.83537","106.29271","1","0","0","0","0","0","0","1","0","1","0","0","1","1","0","0","0","1","1","0","0","0","0","1"
"Batang","-6.90778","109.73028","1","0","0","0","0","0","0","1","0","1","0","0","1","1","0","0","0","1","1","0","0","0","0","1"
"Batang","-6.4846","110.7083","1","0","0","0","0","0","0","1","0","1","0","0","1","1","0","0","0","1","1","0","0","0","0","1"
"Batang","-9.5923","118.9871","1","0","0","0","0","0","0","1","0","1","0","0","1","1","0","0","0","1","1","0","0","0","0","1"
"Batavia","40.99418","-92.1674","1","0","0","0","0","0","0","1","0","0","0","0","0","0","1","0","0","1","1","0","0","0","0","1"
"Batavia","41.85003","-88.31257","1","0","0","0","0","0","0","1","0","0","0","0","0","0","1","0","0","1","1","0","0","0","0","1"
"Batavia","39.07701","-84.17688","1","0","0","0","0","0","0","1","0","0","0","0","0","0","1","0","0","1","1","0","0","0","0","1"
"Batavia","42.99812","-78.18752","1","0","0","0","0","0","0","1","0","0","0","0","0","0","1","0","0","1","1","0","0","0","0","1"
"Bath","42.81864","-84.44859","58","0","0","2","4","0","5","69","12","17","17","0","46","25","7","36","0","68","6","9","53","0","1","69"
"Bath","42.33702","-77.31776","58","0","0","2","4","0","5","69","12","17","17","0","46","25","7","36","0","68","6","9","53","0","1","69"
"Bath","44.18342","-76.78273","58","0","0","2","4","0","5","69","12","17","17","0","46","25","7","36","0","68","6","9","53","0","1","69"
"Bath","17.9482","-76.34916","58","0","0","2","4","0","5","69","12","17","17","0","46","25","7","36","0","68","6","9","53","0","1","69"
"Bath","40.72565","-75.39407","58","0","0","2","4","0","5","69","12","17","17","0","46","25","7","36","0","68","6","9","53","0","1","69"
"Bath","44.16701","-71.9662","58","0","0","2","4","0","5","69","12","17","17","0","46","25","7","36","0","68","6","9","53","0","1","69"
"Bath","43.91064","-69.8206","58","0","0","2","4","0","5","69","12","17","17","0","46","25","7","36","0","68","6","9","53","0","1","69"
"Bath","51.3751","-2.36172","58","0","0","2","4","0","5","69","12","17","17","0","46","25","7","36","0","68","6","9","53","0","1","69"
"Bathgate","55.90204","-3.64398","11","0","0","1","0","0","1","13","2","0","10","0","12","3","1","9","0","13","0","6","7","0","0","13"
"Bathinda","30.20747","74.93893","2","0","1","0","0","0","0","3","1","0","1","1","3","1","0","1","1","3","0","0","1","1","1","3"
"Bathurst","47.61814","-65.65112","1","0","0","0","0","0","0","1","0","1","0","0","1","1","0","0","0","1","1","0","0","0","0","1"
"Bathurst","-33.41665","149.5806","1","0","0","0","0","0","0","1","0","1","0","0","1","1","0","0","0","1","1","0","0","0","0","1"
"Bat Khela","34.6178","71.97247","3","0","0","0","0","0","0","3","2","0","1","0","3","0","0","3","0","3","0","0","3","0","0","3"
"Batley","53.70291","-1.6337","2","0","0","0","1","0","0","3","0","0","3","0","3","1","0","2","0","3","0","1","2","0","0","3"
"Batna","35.55597","6.17414","3","0","0","1","1","0","0","5","2","0","3","0","5","2","3","0","0","5","1","3","0","0","1","5"
"Batticaloa","7.7102","81.6924","6","0","0","0","0","0","0","6","2","0","1","0","3","2","2","2","0","6","1","0","4","0","1","6"
"Battle","50.91732","0.48417","6","0","0","1","3","0","0","10","5","2","3","0","10","1","1","8","0","10","4","4","2","0","0","10"
"Batu Berendam","2.2487","102.246","1","0","0","0","0","0","0","1","1","0","0","0","1","1","0","0","0","1","0","0","1","0","0","1"
"Batumi","41.64228","41.63392","1","0","0","0","0","0","0","1","0","0","1","0","1","0","0","1","0","1","0","0","1","0","0","1"
"Bauchi","10.31032","9.84388","3","1","0","0","0","0","0","4","1","3","0","0","4","4","0","0","0","4","1","1","2","0","0","4"
"Bawshar","23.57769","58.39982","1","0","0","0","0","0","0","1","0","0","0","0","0","1","0","0","0","1","0","0","1","0","0","1"
"Bayamon","18.17774","-66.11322","1","0","0","0","0","0","0","1","0","1","0","0","1","0","1","0","0","1","1","0","0","0","0","1"
"Bay Saint Louis","30.30881","-89.33005","1","0","0","0","0","0","0","1","0","1","0","0","1","1","0","0","0","1","1","0","0","0","0","1"
"Beaconsfield","45.43341","-73.86586","5","0","0","0","1","0","1","7","2","0","2","0","4","3","2","6","0","11","0","6","5","0","0","11"
"Beaconsfield","51.61219","-0.64732","5","0","0","0","1","0","1","7","2","0","2","0","4","3","2","6","0","11","0","6","5","0","0","11"
"Beaconsfield","-32.06748","115.76401","5","0","0","0","1","0","1","7","2","0","2","0","4","3","2","6","0","11","0","6","5","0","0","11"
"Beaconsfield","-38.05","145.36667","5","0","0","0","1","0","1","7","2","0","2","0","4","3","2","6","0","11","0","6","5","0","0","11"
"Beaconsfield","-41.20227","146.81723","5","0","0","0","1","0","1","7","2","0","2","0","4","3","2","6","0","11","0","6","5","0","0","11"
"Beaconsfield","-21.09121","149.16544","5","0","0","0","1","0","1","7","2","0","2","0","4","3","2","6","0","11","0","6","5","0","0","11"
"Beaconsfield","-33.91147","151.20038","5","0","0","0","1","0","1","7","2","0","2","0","4","3","2","6","0","11","0","6","5","0","0","11"
"Beaminster","50.809","-2.7391","1","0","0","1","2","0","0","4","1","0","2","0","3","2","0","2","0","4","2","0","2","0","0","4"
"Beau Bassin-Rose Hill","-20.23325","57.46609","4","0","0","0","0","0","0","4","2","0","0","0","2","1","1","2","0","4","0","2","2","0","0","4"
"Beauly","57.48345","-4.46144","1","0","0","0","0","0","0","1","1","0","0","0","1","0","0","1","0","1","0","1","0","0","0","1"
"Bebington","53.35","-3.01667","3","2","0","0","0","0","0","5","3","0","2","0","5","0","0","5","0","5","1","1","3","0","0","5"
"Beccles","52.45936","1.56465","2","0","0","1","2","0","0","5","2","0","3","0","5","2","1","2","0","5","0","2","3","0","0","5"
"Béchar","31.61667","-2.21667","0","0","0","0","1","0","0","1","0","0","1","0","1","1","0","0","0","1","1","0","0","0","0","1"
"Beckenham","51.40878","-0.02526","9","0","0","0","1","0","0","10","3","3","2","0","8","4","1","5","0","10","0","3","7","0","0","10"
"Beckenham","-32.02481","115.95989","9","0","0","0","1","0","0","10","3","3","2","0","8","4","1","5","0","10","0","3","7","0","0","10"
"Beckington","51.26444","-2.28722","3","0","0","0","0","0","0","3","0","2","0","0","2","2","1","0","0","3","0","3","0","0","0","3"
"Bedale","54.28811","-1.59181","2","0","0","0","1","0","0","3","0","2","1","0","3","2","0","1","0","3","1","1","1","0","0","3"
"Beddau","51.55398","-3.35814","3","0","0","0","0","0","0","3","0","0","0","0","0","2","0","1","0","3","0","0","3","0","0","3"
"Bedekovčina","46.04111","15.99639","2","0","0","0","0","0","0","2","1","0","0","0","1","0","0","2","0","2","0","0","2","0","0","2"
"Bedford","32.84402","-97.14307","36","1","0","2","2","0","3","44","7","11","18","2","38","11","4","27","2","44","10","8","25","1","0","44"
"Bedford","40.66693","-94.72136","36","1","0","2","2","0","3","44","7","11","18","2","38","11","4","27","2","44","10","8","25","1","0","44"
"Bedford","38.86116","-86.48721","36","1","0","2","2","0","3","44","7","11","18","2","38","11","4","27","2","44","10","8","25","1","0","44"
"Bedford","38.59256","-85.31773","36","1","0","2","2","0","3","44","7","11","18","2","38","11","4","27","2","44","10","8","25","1","0","44"
"Bedford","41.39311","-81.53651","36","1","0","2","2","0","3","44","7","11","18","2","38","11","4","27","2","44","10","8","25","1","0","44"
"Bedford","37.33431","-79.52309","36","1","0","2","2","0","3","44","7","11","18","2","38","11","4","27","2","44","10","8","25","1","0","44"
"Bedford","40.01869","-78.50391","36","1","0","2","2","0","3","44","7","11","18","2","38","11","4","27","2","44","10","8","25","1","0","44"
"Bedford","41.20426","-73.64374","36","1","0","2","2","0","3","44","7","11","18","2","38","11","4","27","2","44","10","8","25","1","0","44"
"Bedford","45.11678","-72.98244","36","1","0","2","2","0","3","44","7","11","18","2","38","11","4","27","2","44","10","8","25","1","0","44"
"Bedford","42.94647","-71.5159","36","1","0","2","2","0","3","44","7","11","18","2","38","11","4","27","2","44","10","8","25","1","0","44"
"Bedford","42.49065","-71.27617","36","1","0","2","2","0","3","44","7","11","18","2","38","11","4","27","2","44","10","8","25","1","0","44"
"Bedford","52.13459","-0.46632","36","1","0","2","2","0","3","44","7","11","18","2","38","11","4","27","2","44","10","8","25","1","0","44"
"Bedford","-31.91132","115.8892","36","1","0","2","2","0","3","44","7","11","18","2","38","11","4","27","2","44","10","8","25","1","0","44"
"Bedlington","55.13061","-1.59319","8","0","0","0","1","0","1","10","2","3","1","0","6","1","3","6","0","10","5","1","5","0","0","11"
"Bedlinog","51.70432","-3.31306","1","0","0","0","0","0","0","1","0","0","1","0","1","0","0","1","0","1","0","1","0","0","0","1"
"Bedworth","52.4791","-1.46909","3","0","0","1","0","0","0","4","1","2","0","0","3","0","0","4","0","4","2","1","1","0","0","4"
"Beed","18.98921","75.75634","4","0","0","0","0","0","0","4","3","0","0","1","4","1","0","2","1","4","0","0","3","0","0","3"
"Beersheba","31.25181","34.7913","4","0","0","0","0","0","0","4","0","1","0","1","2","2","1","1","0","4","1","0","2","1","0","4"
"Beerwah","-26.85881","152.96144","1","0","0","0","0","0","0","1","0","1","0","0","1","0","1","0","0","1","0","0","1","0","0","1"
"Beeston","53.11667","-2.68333","2","1","0","0","0","0","0","3","2","1","0","0","3","2","1","0","0","3","1","0","2","0","0","3"
"Beeston","52.7","0.81667","2","1","0","0","0","0","0","3","2","1","0","0","3","2","1","0","0","3","1","0","2","0","0","3"
"Beheira","30.51478","30.34355","1","0","0","0","0","0","1","2","0","0","0","1","1","1","0","0","1","2","1","0","0","0","1","2"
"Beijing","39.9075","116.39723","2","0","0","0","0","0","0","2","0","1","0","0","1","1","1","0","0","2","1","0","0","0","1","2"
"Beira","-19.84361","34.83889","3","1","0","1","1","0","0","6","1","1","2","0","4","2","3","1","0","6","1","0","4","1","0","6"
"Beirut","33.89332","35.50157","20","1","0","0","0","0","0","21","6","5","2","2","15","8","6","5","2","21","11","3","5","1","1","21"
"Beït ed Dîne","33.69417","35.58083","1","0","0","0","0","0","0","1","0","1","0","0","1","1","0","0","0","1","0","0","0","1","0","1"
"Beith","55.74923","-4.6368","0","0","0","0","0","0","0","0","0","0","0","0","0","0","0","0","0","0","0","0","1","0","0","1"
"Béja","36.72564","9.18169","1","0","0","0","0","0","0","1","0","0","1","0","1","0","0","1","0","1","0","1","0","0","0","1"
"Bejaïa","36.75587","5.08433","3","2","0","0","0","0","0","5","1","1","1","0","3","0","2","3","0","5","1","2","1","0","1","5"
"Bekasi","-6.2349","106.9896","1","0","0","0","0","0","0","1","1","0","0","0","1","1","0","0","0","1","1","0","0","0","0","1"
"Bekwai","6.45195","-1.57866","0","1","0","0","0","0","0","1","0","1","0","0","1","0","1","0","0","1","0","0","0","0","1","1"
"Belding","43.09781","-85.22891","1","0","0","0","0","0","0","1","0","0","1","0","1","0","0","1","0","1","1","0","0","0","0","1"
"Beledweyne","4.73583","45.20361","1","0","0","0","0","0","0","1","0","1","0","0","1","0","0","0","1","1","0","0","0","0","1","1"
"Belém","-1.45583","-48.50444","2","0","0","0","0","0","0","2","0","1","0","0","1","2","0","0","0","2","1","0","1","0","0","2"
"Belém","-6.69167","-35.53333","2","0","0","0","0","0","0","2","0","1","0","0","1","2","0","0","0","2","1","0","1","0","0","2"
"Belén","20.3675","-100.52278","1","0","0","0","0","0","0","1","0","1","0","0","1","0","1","0","0","1","1","0","0","0","0","1"
"Belén","17.78907","-92.61137","1","0","0","0","0","0","0","1","0","1","0","0","1","0","1","0","0","1","1","0","0","0","0","1"
"Belén","11.50299","-85.88935","1","0","0","0","0","0","0","1","0","1","0","0","1","0","1","0","0","1","1","0","0","0","0","1"
"Belén","10.40789","-85.58836","1","0","0","0","0","0","0","1","0","1","0","0","1","0","1","0","0","1","1","0","0","0","0","1"
"Belén","1.59477","-77.05408","1","0","0","0","0","0","0","1","0","1","0","0","1","0","1","0","0","1","1","0","0","0","0","1"
"Belén","5.98892","-72.91254","1","0","0","0","0","0","0","1","0","1","0","0","1","0","1","0","0","1","1","0","0","0","0","1"
"Belén","-27.65103","-67.02869","1","0","0","0","0","0","0","1","0","1","0","0","1","0","1","0","0","1","1","0","0","0","0","1"
"Belén","-30.78716","-57.77577","1","0","0","0","0","0","0","1","0","1","0","0","1","0","1","0","0","1","1","0","0","0","0","1"
"Belén","-23.46611","-57.26194","1","0","0","0","0","0","0","1","0","1","0","0","1","0","1","0","0","1","1","0","0","0","0","1"
"Belfast","42.34284","-78.1114","53","1","0","2","2","0","5","63","13","17","19","2","51","26","7","29","1","63","17","13","28","1","3","62"
"Belfast","40.78065","-75.27796","53","1","0","2","2","0","5","63","13","17","19","2","51","26","7","29","1","63","17","13","28","1","3","62"
"Belfast","44.42591","-69.00642","53","1","0","2","2","0","5","63","13","17","19","2","51","26","7","29","1","63","17","13","28","1","3","62"
"Belfast","46.08341","-62.88197","53","1","0","2","2","0","5","63","13","17","19","2","51","26","7","29","1","63","17","13","28","1","3","62"
"Belfast","54.59682","-5.92541","53","1","0","2","2","0","5","63","13","17","19","2","51","26","7","29","1","63","17","13","28","1","3","62"
"Belfast","-25.68991","30.03504","53","1","0","2","2","0","5","63","13","17","19","2","51","26","7","29","1","63","17","13","28","1","3","62"
"Belgaum","15.85212","74.50447","3","0","0","0","0","0","0","3","3","0","0","0","3","1","0","2","0","3","0","0","3","0","0","3"
"Belgrade","45.77604","-111.1769","37","1","0","0","1","0","1","40","10","7","0","2","19","7","12","17","4","40","20","5","9","3","3","40"
"Belgrade","45.45302","-95.00446","37","1","0","0","1","0","1","40","10","7","0","2","19","7","12","17","4","40","20","5","9","3","3","40"
"Belgrade","44.44729","-69.83255","37","1","0","0","1","0","1","40","10","7","0","2","19","7","12","17","4","40","20","5","9","3","3","40"
"Belgrade","44.80401","20.46513","37","1","0","0","1","0","1","40","10","7","0","2","19","7","12","17","4","40","20","5","9","3","3","40"
"Belize City","17.49952","-88.19756","1","0","0","0","1","0","0","2","1","1","0","0","2","2","0","0","0","2","0","0","1","0","1","2"
"Bellary","15.14205","76.92398","1","0","0","0","0","0","0","1","0","0","1","0","1","0","0","1","0","1","0","0","1","0","0","1"
"Bella Vista","40.64071","-122.2325","1","0","0","0","0","0","0","1","0","1","0","0","1","1","0","0","0","1","1","0","0","0","0","1"
"Bella Vista","36.4807","-94.27134","1","0","0","0","0","0","0","1","0","1","0","0","1","1","0","0","0","1","1","0","0","0","0","1"
"Bella Vista","15.58359","-92.24683","1","0","0","0","0","0","0","1","0","1","0","0","1","1","0","0","0","1","1","0","0","0","0","1"
"Bella Vista","8.20617","-81.62123","1","0","0","0","0","0","0","1","0","1","0","0","1","1","0","0","0","1","1","0","0","0","0","1"
"Bella Vista","8.54263","-80.40679","1","0","0","0","0","0","0","1","0","1","0","0","1","1","0","0","0","1","1","0","0","0","0","1"
"Bella Vista","7.75","-80.23333","1","0","0","0","0","0","0","1","0","1","0","0","1","1","0","0","0","1","1","0","0","0","0","1"
"Bella Vista","18.45539","-69.9454","1","0","0","0","0","0","0","1","0","1","0","0","1","1","0","0","0","1","1","0","0","0","0","1"
"Bella Vista","-27.03424","-65.30196","1","0","0","0","0","0","0","1","0","1","0","0","1","1","0","0","0","1","1","0","0","0","0","1"
"Bella Vista","-28.50752","-59.04149","1","0","0","0","0","0","0","1","0","1","0","0","1","1","0","0","0","1","1","0","0","0","0","1"
"Bella Vista","-22.13333","-56.51667","1","0","0","0","0","0","0","1","0","1","0","0","1","1","0","0","0","1","1","0","0","0","0","1"
"Bella Vista","-27.05","-55.55","1","0","0","0","0","0","0","1","0","1","0","0","1","1","0","0","0","1","1","0","0","0","0","1"
"Bella Vista","-33.74127","150.95456","1","0","0","0","0","0","0","1","0","1","0","0","1","1","0","0","0","1","1","0","0","0","0","1"
"Bellevue","47.61038","-122.20068","1","0","0","0","0","0","0","1","0","0","1","0","1","0","0","1","0","1","0","0","1","0","0","1"
"Bellevue","43.46352","-114.2606","1","0","0","0","0","0","0","1","0","0","1","0","1","0","0","1","0","1","0","0","1","0","0","1"
"Bellevue","41.13667","-95.89084","1","0","0","0","0","0","0","1","0","0","1","0","1","0","0","1","0","1","0","0","1","0","0","1"
"Bellevue","42.25863","-90.42291","1","0","0","0","0","0","0","1","0","0","1","0","1","0","0","1","0","1","0","0","1","0","0","1"
"Bellevue","40.68448","-89.6801","1","0","0","0","0","0","0","1","0","0","1","0","1","0","0","1","0","1","0","0","1","0","0","1"
"Bellevue","44.44416","-87.9201","1","0","0","0","0","0","0","1","0","0","1","0","1","0","0","1","0","1","0","0","1","0","0","1"
"Bellevue","42.44337","-85.01805","1","0","0","0","0","0","0","1","0","0","1","0","1","0","0","1","0","1","0","0","1","0","0","1"
"Bellevue","39.10645","-84.47883","1","0","0","0","0","0","0","1","0","0","1","0","1","0","0","1","0","1","0","0","1","0","0","1"
"Bellevue","41.27366","-82.84158","1","0","0","0","0","0","0","1","0","0","1","0","1","0","0","1","0","1","0","0","1","0","0","1"
"Bellevue","40.49396","-80.05172","1","0","0","0","0","0","0","1","0","0","1","0","1","0","0","1","0","1","0","0","1","0","0","1"
"Bellevue","46.25739","6.15475","1","0","0","0","0","0","0","1","0","0","1","0","1","0","0","1","0","1","0","0","1","0","0","1"
"Bellevue","-31.90116","116.02762","1","0","0","0","0","0","0","1","0","0","1","0","1","0","0","1","0","1","0","0","1","0","0","1"
"Bellevue Hill","-33.87899","151.25101","1","0","0","0","0","0","0","1","0","0","1","0","1","1","0","0","0","1","0","0","1","0","0","1"
"Bellshill","55.81667","-4.01667","3","0","0","0","0","0","0","3","0","2","1","0","3","0","2","1","0","3","0","1","1","0","1","3"
"Belluno","46.14262","12.2156","1","0","0","0","0","0","0","1","0","1","0","0","1","0","0","1","0","1","0","0","0","0","1","1"
"Belo","6.13333","10.25","1","0","0","0","0","0","0","1","0","0","0","0","0","1","0","0","0","1","0","0","0","0","1","1"
"Belo Horizonte","-19.92083","-43.93778","1","0","0","0","0","0","1","2","1","1","0","0","2","2","0","0","0","2","0","0","2","0","0","2"
"Belper","53.0233","-1.48119","6","0","0","0","1","0","1","8","0","4","0","0","4","4","3","1","0","8","2","1","5","0","0","8"
"Belvaux","49.51014","5.92414","1","0","0","0","0","0","0","1","0","0","1","0","1","1","0","0","0","1","0","0","1","0","0","1"
"Bembridge","50.68634","-1.08275","1","0","0","0","0","0","0","1","1","0","0","0","1","0","0","1","0","1","0","0","1","0","0","1"
"Ben Arous","36.75452","10.22167","4","0","0","0","0","0","0","4","2","1","1","0","4","1","0","3","0","4","2","0","2","0","0","4"
"Benbecula","57.44737","-7.34273","1","0","0","0","0","0","0","1","1","0","0","0","1","1","0","0","0","1","0","1","0","0","0","1"
"Bend","40.25516","-122.20861","1","0","0","0","0","0","0","1","0","0","0","0","0","0","0","1","0","1","0","0","1","0","0","1"
"Bend","44.05817","-121.31531","1","0","0","0","0","0","0","1","0","0","0","0","0","0","0","1","0","1","0","0","1","0","0","1"
"Benevento","41.1307","14.77816","1","0","0","0","0","0","0","1","0","1","0","0","1","0","1","0","0","1","1","0","0","0","0","1"
"Bengaluru","12.97194","77.59369","19","1","0","0","1","0","0","21","15","0","2","2","19","11","2","8","0","21","2","2","15","0","2","21"
"Benghazi","32.11486","20.06859","26","0","0","0","0","0","0","26","11","6","2","2","21","7","7","12","0","26","13","7","7","0","0","27"
"Bengkulu","-3.80044","102.26554","1","0","0","0","0","0","0","1","1","0","0","0","1","0","0","1","0","1","0","0","1","0","0","1"
"Beni Hassane","35.5672","10.80869","1","0","0","0","0","0","0","1","1","0","0","0","1","0","1","0","0","1","0","0","1","0","0","1"
"Beni Khalled","36.65038","10.59004","0","0","0","1","0","0","0","1","1","0","0","0","1","0","0","1","0","1","0","0","1","0","0","1"
"Beni Mellal","32.33725","-6.34983","1","0","0","0","0","0","0","1","0","0","0","0","0","0","1","0","0","1","1","0","0","0","0","1"
"Benin City","6.33815","5.62575","5","0","0","0","0","0","0","5","0","2","1","1","4","4","1","0","0","5","4","0","0","1","0","5"
"Benoni","-26.18848","28.32078","4","0","0","0","1","0","0","5","0","3","0","1","4","2","3","0","0","5","4","0","1","0","0","5"
"Benson","41.78743","-111.93022","1","0","0","0","0","0","0","1","0","0","1","0","1","0","0","1","0","1","0","0","1","0","0","1"
"Benson","31.96786","-110.29452","1","0","0","0","0","0","0","1","0","0","1","0","1","0","0","1","0","1","0","0","1","0","0","1"
"Benson","45.315","-95.6025","1","0","0","0","0","0","0","1","0","0","1","0","1","0","0","1","0","1","0","0","1","0","0","1"
"Benson","35.38211","-78.54862","1","0","0","0","0","0","0","1","0","0","1","0","1","0","0","1","0","1","0","0","1","0","0","1"
"Benson","51.62073","-1.10979","1","0","0","0","0","0","0","1","0","0","1","0","1","0","0","1","0","1","0","0","1","0","0","1"
"Bensonville","6.44716","-10.61283","1","0","0","0","0","0","0","1","0","1","0","0","1","1","0","0","0","1","1","0","0","0","0","1"
"Bent Jbaïl","33.11944","35.43333","1","0","0","0","0","0","0","1","0","1","0","0","1","0","0","1","0","1","1","0","0","0","0","1"
"Bentonville","36.37285","-94.20882","1","0","0","0","0","0","0","1","0","1","0","0","1","1","0","0","0","1","1","0","0","0","0","1"
"Berat","40.70583","19.95222","1","1","0","0","0","0","0","2","0","0","1","0","1","1","1","0","0","2","0","1","0","0","1","2"
"Bergen","43.08534","-77.94223","1","0","0","0","0","0","1","2","1","0","1","0","2","1","1","0","0","2","0","0","2","0","0","2"
"Bergen","52.66917","4.70417","1","0","0","0","0","0","1","2","1","0","1","0","2","1","1","0","0","2","0","0","2","0","0","2"
"Bergen","60.39299","5.32415","1","0","0","0","0","0","1","2","1","0","1","0","2","1","1","0","0","2","0","0","2","0","0","2"
"Bergen","49.78333","7.41667","1","0","0","0","0","0","1","2","1","0","1","0","2","1","1","0","0","2","0","0","2","0","0","2"
"Bergen","52.80837","9.96374","1","0","0","0","0","0","1","2","1","0","1","0","2","1","1","0","0","2","0","0","2","0","0","2"
"Bergen","49.07347","11.114","1","0","0","0","0","0","1","2","1","0","1","0","2","1","1","0","0","2","0","0","2","0","0","2"
"Bergen","50.471","12.27448","1","0","0","0","0","0","1","2","1","0","1","0","2","1","1","0","0","2","0","0","2","0","0","2"
"Bergen","47.80837","12.58982","1","0","0","0","0","0","1","2","1","0","1","0","2","1","1","0","0","2","0","0","2","0","0","2"
"Berkane","34.92","-2.32","1","0","0","0","0","0","0","1","1","0","0","0","1","0","0","1","0","1","0","0","1","0","0","1"
"Berkeley","37.87159","-122.27275","1","0","0","0","0","0","2","3","3","0","0","0","3","1","0","2","0","3","0","0","3","0","0","3"
"Berkeley","38.7545","-90.33123","1","0","0","0","0","0","2","3","3","0","0","0","3","1","0","2","0","3","0","0","3","0","0","3"
"Berkeley","41.88892","-87.9034","1","0","0","0","0","0","2","3","3","0","0","0","3","1","0","2","0","3","0","0","3","0","0","3"
"Berkeley","51.69111","-2.45917","1","0","0","0","0","0","2","3","3","0","0","0","3","1","0","2","0","3","0","0","3","0","0","3"
"Berkeley","-34.48333","150.85","1","0","0","0","0","0","2","3","3","0","0","0","3","1","0","2","0","3","0","0","3","0","0","3"
"Berkeley Heights","40.68343","-74.44265","1","0","0","0","0","0","0","1","0","0","0","0","0","0","0","1","0","1","0","0","1","0","0","1"
"Berkhamsted","51.7604","-0.56528","7","1","0","1","2","0","1","12","3","2","4","1","10","5","2","5","0","12","1","2","9","0","0","12"
"Berlin","43.96804","-88.94345","13","0","0","0","2","0","2","17","2","5","5","0","12","3","4","10","0","17","3","0","13","1","0","17"
"Berlin","31.06824","-83.62378","13","0","0","0","2","0","2","17","2","5","5","0","12","3","4","10","0","17","3","0","13","1","0","17"
"Berlin","40.56117","-81.7943","13","0","0","0","2","0","2","17","2","5","5","0","12","3","4","10","0","17","3","0","13","1","0","17"
"Berlin","39.92064","-78.9578","13","0","0","0","2","0","2","17","2","5","5","0","12","3","4","10","0","17","3","0","13","1","0","17"
"Berlin","38.32262","-75.21769","13","0","0","0","2","0","2","17","2","5","5","0","12","3","4","10","0","17","3","0","13","1","0","17"
"Berlin","39.79123","-74.92905","13","0","0","0","2","0","2","17","2","5","5","0","12","3","4","10","0","17","3","0","13","1","0","17"
"Berlin","42.3812","-71.63701","13","0","0","0","2","0","2","17","2","5","5","0","12","3","4","10","0","17","3","0","13","1","0","17"
"Berlin","44.46867","-71.18508","13","0","0","0","2","0","2","17","2","5","5","0","12","3","4","10","0","17","3","0","13","1","0","17"
"Berlin","52.52437","13.41053","13","0","0","0","2","0","2","17","2","5","5","0","12","3","4","10","0","17","3","0","13","1","0","17"
"Berlin","54.00603","61.19308","13","0","0","0","2","0","2","17","2","5","5","0","12","3","4","10","0","17","3","0","13","1","0","17"
"Berlin Köpenick","52.44254","13.58228","1","0","0","0","0","0","0","1","1","0","0","0","1","0","0","1","0","1","0","0","1","0","0","1"
"Bertrange","49.61111","6.05","1","0","0","0","0","0","0","1","0","1","0","0","1","0","0","1","0","1","1","0","0","0","0","1"
"Bertrange","49.31368","6.19208","1","0","0","0","0","0","0","1","0","1","0","0","1","0","0","1","0","1","1","0","0","0","0","1"
"Berwick","29.69465","-91.21899","1","0","0","0","0","0","0","1","0","0","1","0","1","0","1","0","0","1","0","1","0","0","0","1"
"Berwick","41.05453","-76.23327","1","0","0","0","0","0","0","1","0","0","1","0","1","0","1","0","0","1","0","1","0","0","0","1"
"Berwick","43.26592","-70.8645","1","0","0","0","0","0","0","1","0","0","1","0","1","0","1","0","0","1","0","1","0","0","0","1"
"Berwick","45.05015","-64.73208","1","0","0","0","0","0","0","1","0","0","1","0","1","0","1","0","0","1","0","1","0","0","0","1"
"Berwick","-38.03333","145.35","1","0","0","0","0","0","0","1","0","0","1","0","1","0","1","0","0","1","0","1","0","0","0","1"
"Betchworth","51.23374","-0.26655","1","0","0","0","0","0","0","1","0","0","1","0","1","0","0","1","0","1","0","0","1","0","0","1"
"Bethlehem","33.93206","-83.71378","1","1","0","0","0","0","0","2","1","0","1","0","2","1","0","1","0","2","0","2","0","0","0","2"
"Bethlehem","35.82569","-81.30703","1","1","0","0","0","0","0","2","1","0","1","0","2","1","0","1","0","2","0","2","0","0","0","2"
"Bethlehem","40.04396","-80.69064","1","1","0","0","0","0","0","2","1","0","1","0","2","1","0","1","0","2","0","2","0","0","0","2"
"Bethlehem","39.39203","-80.28064","1","1","0","0","0","0","0","2","1","0","1","0","2","1","0","1","0","2","0","2","0","0","0","2"
"Bethlehem","40.62593","-75.37046","1","1","0","0","0","0","0","2","1","0","1","0","2","1","0","1","0","2","0","2","0","0","0","2"
"Bethlehem","44.28034","-71.68814","1","1","0","0","0","0","0","2","1","0","1","0","2","1","0","1","0","2","0","2","0","0","0","2"
"Bethlehem","-28.23078","28.30707","1","1","0","0","0","0","0","2","1","0","1","0","2","1","0","1","0","2","0","2","0","0","0","2"
"Bethlehem","31.70487","35.20376","1","1","0","0","0","0","0","2","1","0","1","0","2","1","0","1","0","2","0","2","0","0","0","2"
"Bet Shemesh","31.73072","34.99293","1","0","0","0","0","0","0","1","1","0","0","0","1","1","0","0","0","1","0","1","0","0","0","1"
"Betws-y-Coed","53.09382","-3.80668","1","0","0","0","0","0","0","1","0","0","1","0","1","0","1","0","0","1","0","0","1","0","0","1"
"Beverley","53.84587","-0.42332","9","0","0","0","1","0","1","11","2","4","3","0","9","6","1","4","0","11","4","4","3","0","0","11"
"Beverley","-32.10839","116.92736","9","0","0","0","1","0","1","11","2","4","3","0","9","6","1","4","0","11","4","4","3","0","0","11"
"Beverley","-34.89512","138.54633","9","0","0","0","1","0","1","11","2","4","3","0","9","6","1","4","0","11","4","4","3","0","0","11"
"Bewdley","52.3757","-2.31833","1","0","0","0","0","0","0","1","0","1","0","0","1","0","0","1","0","1","0","1","0","0","0","1"
"Bexhill-on-Sea","50.85023","0.47095","109","5","0","8","9","0","8","139","38","44","52","1","135","39","25","75","0","139","25","68","38","2","6","139"
"Bexley","39.96895","-82.93768","6","0","0","0","0","0","1","7","1","2","2","0","5","1","4","2","0","7","3","1","3","0","0","7"
"Bexley","51.44162","0.14866","6","0","0","0","0","0","1","7","1","2","2","0","5","1","4","2","0","7","3","1","3","0","0","7"
"Bexley","-33.95","151.11667","6","0","0","0","0","0","1","7","1","2","2","0","5","1","4","2","0","7","3","1","3","0","0","7"
"Bexleyheath","51.46291","0.13943","13","1","0","1","0","0","1","16","2","5","6","0","13","6","3","6","1","16","1","2","12","1","0","16"
"Bexley North","-33.93848","151.11385","1","0","0","0","0","0","0","1","0","0","0","0","0","0","0","1","0","1","1","0","0","0","0","1"
"Bhadarwāh","32.97941","75.71723","1","0","0","0","0","0","0","1","0","0","1","0","1","1","0","0","0","1","0","0","1","0","0","1"
"Bhadohi","25.39526","82.5703","1","0","0","0","0","0","0","1","0","0","0","0","0","0","0","1","0","1","0","0","1","0","0","1"
"Bhadrakh","21.05447","86.5156","0","1","0","0","0","0","0","1","1","0","0","0","1","0","1","0","0","1","0","0","1","0","0","1"
"Bhadrapur","26.54404","88.09436","0","0","0","0","1","0","0","1","1","0","0","0","1","0","0","1","0","1","0","0","1","0","0","1"
"Bhakkar","31.62685","71.06471","0","1","0","0","0","0","0","1","1","0","0","0","1","0","0","1","0","1","0","0","1","0","0","1"
"Bhaktapur","27.67298","85.43005","13","0","0","0","0","0","0","13","8","1","2","1","12","6","4","4","0","14","0","0","9","1","4","14"
"Bhamo","24.25256","97.23357","3","0","0","0","0","0","0","3","0","2","0","0","2","2","1","0","0","3","1","1","1","0","0","3"
"Bhāndāria","22.48898","90.06273","1","0","0","0","0","0","0","1","1","0","0","0","1","0","0","1","0","1","0","1","0","0","0","1"
"Bharatpur","27.21731","77.49009","8","0","0","0","1","0","0","9","4","1","1","1","7","3","4","2","0","9","0","1","7","0","1","9"
"Bharatpur","27.6768","84.43589","8","0","0","0","1","0","0","9","4","1","1","1","7","3","4","2","0","9","0","1","7","0","1","9"
"Bharūch","21.69482","72.9805","1","0","0","0","0","0","0","1","0","1","0","0","1","0","0","1","0","1","0","0","0","0","1","1"
"Bhattarai Danda","27.88333","83.93333","1","0","0","0","0","0","0","1","0","0","0","1","1","0","0","1","0","1","0","0","1","0","0","1"
"Bhavnagar","21.76287","72.15331","7","0","0","0","0","0","0","7","6","0","1","0","7","0","0","7","0","7","0","0","7","0","0","7"
"Bhilai","21.20919","81.4285","6","0","0","0","0","0","0","6","6","0","0","0","6","2","0","4","0","6","0","2","4","0","0","6"
"Bhimbar","32.97465","74.07846","1","0","0","0","0","0","0","1","1","0","1","0","2","2","0","0","0","2","0","1","1","0","0","2"
"Bhiwandi","19.30023","73.05881","1","0","0","0","0","0","0","1","0","0","0","1","1","0","0","0","1","1","0","1","0","0","0","1"
"Bhopal","23.25469","77.40289","9","0","0","0","0","0","0","9","7","2","1","0","10","4","1","5","0","10","1","0","7","0","2","10"
"Bhubaneshwar","20.27241","85.83385","6","1","0","0","0","0","0","7","4","1","0","0","5","4","0","3","0","7","0","0","7","0","0","7"
"Bhuj","23.25397","69.66928","1","0","0","0","0","0","0","1","0","1","0","0","1","1","0","0","0","1","1","0","0","0","0","1"
"Bhusāval","21.04365","75.78506","1","0","0","0","0","0","0","1","1","0","0","0","1","0","0","1","0","1","0","0","1","0","0","1"
"Bibiani","6.46346","-2.31938","1","0","0","0","0","0","0","1","0","1","0","0","1","1","0","1","0","2","0","0","0","0","0","0"
"Bibra Lake","-32.09764","115.81921","0","1","0","0","0","0","0","1","1","0","0","0","1","0","0","1","0","1","0","0","1","0","0","1"
"Bicaz","47.46667","23.03333","1","0","0","0","0","0","0","1","1","0","0","0","1","1","0","0","0","1","0","0","1","0","0","1"
"Bicaz","46.91667","26.06667","1","0","0","0","0","0","0","1","1","0","0","0","1","1","0","0","0","1","0","0","1","0","0","1"
"Bicester","51.89998","-1.15357","16","1","0","1","1","0","0","19","5","8","3","0","16","9","3","7","0","19","5","5","7","0","2","19"
"Bicton","52.72829","-2.81649","1","0","0","0","0","0","0","1","0","0","0","1","1","0","1","0","0","1","1","0","0","0","0","1"
"Bicton","-32.02778","115.78333","1","0","0","0","0","0","0","1","0","0","0","1","1","0","1","0","0","1","1","0","0","0","0","1"
"Bidbid","23.40787","58.1283","0","0","0","0","1","0","0","1","0","0","0","0","0","0","0","1","0","1","1","0","0","0","0","1"
"Bideford","51.01678","-4.20832","3","0","0","0","0","0","0","3","1","1","1","0","3","1","0","2","0","3","1","0","2","0","0","3"
"Bidhūna","26.80172","79.50829","1","0","0","0","0","0","0","1","0","0","0","0","0","0","1","0","0","1","0","0","1","0","0","1"
"Bielefeld","52.03333","8.53333","2","0","0","0","0","0","0","2","0","2","0","0","2","0","0","2","0","2","0","0","0","0","2","2"
"Bigastro","38.06237","-0.89841","1","0","0","0","0","0","0","1","0","0","0","0","0","0","0","1","0","1","1","0","0","0","0","1"
"Biggar","52.0668","-108.00135","0","1","0","0","0","0","0","1","1","0","0","0","1","1","0","0","0","1","0","0","1","0","0","1"
"Biggar","55.62297","-3.52455","0","1","0","0","0","0","0","1","1","0","0","0","1","1","0","0","0","1","0","0","1","0","0","1"
"Biggleswade","52.08652","-0.26493","6","0","0","0","0","0","0","6","0","3","0","1","4","2","1","3","0","6","3","0","3","0","0","6"
"Bihać","44.81694","15.87083","1","0","0","0","0","0","0","1","0","0","0","0","0","0","0","1","0","1","0","0","1","0","0","1"
"Bijapur","16.82442","75.71537","1","0","0","0","0","0","0","1","0","0","1","0","1","0","0","1","0","1","0","0","0","0","1","1"
"Bijeljina","44.75874","19.21437","1","0","0","0","0","0","0","1","0","1","0","0","1","1","0","0","0","1","0","0","0","0","1","1"
"Bilaspur","31.33027","76.75663","2","0","0","0","0","0","0","2","1","1","0","0","2","0","1","1","0","2","0","0","2","0","0","2"
"Bilbays","30.42039","31.56223","2","0","0","0","0","0","0","2","1","0","0","0","1","0","0","0","2","2","1","1","0","0","0","2"
"Bilgola Plateau","-33.64781","151.31212","1","0","0","0","0","0","0","1","0","0","1","0","1","0","0","1","0","1","0","0","1","0","0","1"
"Billericay","51.62867","0.41963","8","1","0","0","0","0","1","10","3","5","1","0","9","3","0","7","0","10","1","2","6","1","0","10"
"Billingham","54.58881","-1.29034","2","0","0","0","0","0","0","2","1","0","0","0","1","0","0","2","0","2","1","1","0","0","0","2"
"Billingshurst","51.02312","-0.45359","1","0","0","1","0","0","0","2","1","0","1","0","2","2","0","0","0","2","0","0","2","0","0","2"
"Bilovods'k","49.20846","39.58975","1","0","0","0","0","0","0","1","1","0","0","0","1","0","1","0","0","1","0","0","1","0","0","1"
"Bilqās","31.21452","31.35798","1","0","0","0","0","0","0","1","1","0","0","0","1","1","0","0","0","1","0","0","1","0","0","1"
"Bilston","55.8703","-3.17814","2","0","0","0","0","0","0","2","0","1","1","0","2","1","0","1","0","2","0","1","1","0","0","2"
"Bilston","52.56568","-2.07367","2","0","0","0","0","0","0","2","0","1","1","0","2","1","0","1","0","2","0","1","1","0","0","2"
"Binfield","51.43159","-0.7881","1","0","0","0","0","0","0","1","1","0","0","0","1","1","0","0","0","1","0","0","1","0","0","1"
"Bingley","53.84861","-1.83857","1","0","0","0","0","0","0","1","0","0","1","0","1","0","0","1","0","1","0","0","1","0","0","1"
"Binzen","47.63333","7.61667","1","0","0","0","0","0","0","1","0","0","0","0","0","0","0","1","0","1","0","0","1","0","0","1"
"Biratnagar","26.45505","87.27007","12","0","0","0","0","0","0","12","9","2","0","0","11","3","4","5","0","12","1","1","9","0","1","12"
"Birchington-on-Sea","51.37575","1.3048","3","0","0","0","0","0","0","3","0","2","1","0","3","0","2","1","0","3","1","1","1","0","0","3"
"Birgañj","27.01709","84.8808","7","0","0","0","0","0","0","7","6","0","2","0","8","2","2","4","0","8","0","0","7","0","1","8"
"Birine","35.635","3.225","1","0","0","0","0","0","0","1","0","0","0","0","0","0","0","0","0","0","1","0","0","0","0","1"
"Birkenhead","53.39337","-3.01479","8","0","0","1","2","0","1","12","1","6","2","1","10","7","1","4","0","12","5","1","5","0","1","12"
"Birkenhead","-34.83685","138.49788","8","0","0","1","2","0","1","12","1","6","2","1","10","7","1","4","0","12","5","1","5","0","1","12"
"Birkirkara","35.89722","14.46111","2","0","0","0","0","0","0","2","2","0","0","0","2","0","1","1","0","2","0","0","2","0","0","2"
"Birmingham","33.52066","-86.80249","215","12","0","10","33","0","19","289","60","67","82","5","214","115","30","141","3","289","54","65","162","5","4","290"
"Birmingham","42.5467","-83.21132","215","12","0","10","33","0","19","289","60","67","82","5","214","115","30","141","3","289","54","65","162","5","4","290"
"Birmingham","52.48142","-1.89983","215","12","0","10","33","0","19","289","60","67","82","5","214","115","30","141","3","289","54","65","162","5","4","290"
"Birtinya","-26.74322","153.11913","0","0","0","0","1","0","0","1","1","0","0","0","1","0","0","1","0","1","0","0","1","0","0","1"
"Birtley","55.08333","-2.18333","1","0","0","0","0","0","0","1","0","0","0","0","0","0","1","0","0","1","0","1","0","0","0","1"
"Bishkek","42.87","74.59","11","1","0","1","1","0","0","14","9","1","2","1","13","2","4","8","0","14","0","1","13","0","0","14"
"Bishop","37.36354","-118.39511","4","0","0","0","0","0","0","4","1","0","0","0","1","4","0","0","0","4","0","3","1","0","0","4"
"Bishop","27.58614","-97.79916","4","0","0","0","0","0","0","4","1","0","0","0","1","4","0","0","0","4","0","3","1","0","0","4"
"Bishop Auckland","54.65554","-1.67706","4","0","0","0","1","0","2","7","3","1","3","0","7","3","0","4","0","7","1","3","3","0","0","7"
"Bishopbriggs","55.90669","-4.21869","1","0","0","0","0","0","0","1","0","0","1","0","1","0","0","1","0","1","0","0","1","0","0","1"
"Bishops Stortford","51.87113","0.15868","10","0","0","0","3","0","2","15","5","4","4","0","13","5","3","7","0","15","0","4","11","0","0","15"
"Bishopton","55.90969","-4.5056","1","0","0","0","0","0","0","1","0","1","0","0","1","0","1","0","0","1","1","0","0","0","0","1"
"Bishopton","54.58333","-1.43333","1","0","0","0","0","0","0","1","0","1","0","0","1","0","1","0","0","1","1","0","0","0","0","1"
"Bistriţa","47.13316","24.50011","1","0","0","0","0","0","0","1","0","1","0","0","1","0","1","0","0","1","1","0","0","0","0","1"
"Bitola","41.03143","21.33474","3","0","0","0","1","0","0","4","0","2","0","0","2","1","2","1","0","4","3","0","0","0","1","4"
"Bitton","51.42479","-2.45965","1","0","0","0","0","0","0","1","0","1","0","0","1","1","0","0","0","1","0","0","1","0","0","1"
"Biu","10.61285","12.19458","1","0","0","0","0","0","0","1","1","0","0","0","1","0","1","0","0","1","0","0","1","0","0","1"
"Bizerte","37.27442","9.87391","4","0","0","0","0","0","0","4","0","2","1","1","4","1","1","2","0","4","3","0","1","0","0","4"
"Blackburn","55.86667","-3.63333","17","0","0","1","1","0","1","20","5","8","4","1","18","10","2","8","0","20","9","3","6","1","1","20"
"Blackburn","53.75","-2.48333","17","0","0","1","1","0","1","20","5","8","4","1","18","10","2","8","0","20","9","3","6","1","1","20"
"Blackburn","57.20376","-2.28842","17","0","0","1","1","0","1","20","5","8","4","1","18","10","2","8","0","20","9","3","6","1","1","20"
"Blackburn","-37.81901","145.15326","17","0","0","1","1","0","1","20","5","8","4","1","18","10","2","8","0","20","9","3","6","1","1","20"
"Blackpool","53.81667","-3.05","23","4","0","3","1","0","2","33","9","12","9","0","30","12","4","17","0","33","9","11","12","1","0","33"
"Blackridge","55.88523","-3.77479","1","0","0","0","0","0","0","1","0","1","0","0","1","0","1","0","0","1","1","0","0","0","0","1"
"Black River","18.02636","-77.84873","1","0","0","0","0","0","0","1","0","0","0","0","0","1","0","0","0","1","0","0","0","0","1","1"
"Black River","44.01256","-75.79437","1","0","0","0","0","0","0","1","0","0","0","0","0","1","0","0","0","1","0","0","0","0","1","1"
"Black River","-19.22517","146.61787","1","0","0","0","0","0","0","1","0","0","0","0","0","1","0","0","0","1","0","0","0","0","1","1"
"Blackwood","39.80234","-75.06406","13","0","0","0","1","0","0","14","2","8","3","1","14","3","4","7","0","14","4","2","7","0","1","14"
"Blackwood","53.29308","-6.81843","13","0","0","0","1","0","0","14","2","8","3","1","14","3","4","7","0","14","4","2","7","0","1","14"
"Blackwood","55.66667","-3.91667","13","0","0","0","1","0","0","14","2","8","3","1","14","3","4","7","0","14","4","2","7","0","1","14"
"Blackwood","51.66778","-3.2075","13","0","0","0","1","0","0","14","2","8","3","1","14","3","4","7","0","14","4","2","7","0","1","14"
"Blackwood","-35.02139","138.61429","13","0","0","0","1","0","0","14","2","8","3","1","14","3","4","7","0","14","4","2","7","0","1","14"
"Blandford Forum","50.86073","-2.16174","2","0","0","0","1","0","0","3","1","0","1","0","2","0","0","3","0","3","0","2","1","0","0","3"
"Blankenfelde","52.61863","13.39057","1","0","0","0","0","0","0","1","0","0","1","0","1","0","0","1","0","1","0","0","1","0","0","1"
"Blantyre","55.79634","-4.09485","6","0","0","0","0","0","1","7","1","1","1","4","7","4","2","1","0","7","3","0","3","1","0","7"
"Blantyre","-15.78499","35.00854","6","0","0","0","0","0","1","7","1","1","1","4","7","4","2","1","0","7","3","0","3","1","0","7"
"Blaydon-on-Tyne","54.96461","-1.71392","4","0","0","0","1","0","0","5","1","2","2","0","5","1","0","4","0","5","1","1","3","0","0","5"
"Blewbury","51.5688","-1.23261","1","0","0","0","0","0","0","1","0","0","1","0","1","0","0","1","0","1","0","0","1","0","0","1"
"Blida","36.47004","2.8277","3","0","0","0","0","0","0","3","2","0","0","0","2","1","0","2","0","3","0","0","3","0","0","3"
"Blidworth","53.09849","-1.11689","1","0","0","0","0","0","0","1","0","0","1","0","1","1","0","0","0","1","0","1","0","0","0","1"
"Bloemfontein","-29.12107","26.214","1","0","0","0","0","0","0","1","0","0","1","0","1","0","0","1","0","1","0","0","1","0","0","1"
"Bloomfield Hills","42.58364","-83.24549","1","0","0","0","0","0","0","1","0","0","0","0","0","1","0","0","0","1","0","1","0","0","0","1"
"Bludenz","47.15476","9.82255","1","0","0","0","0","0","0","1","0","0","0","1","1","0","0","1","0","1","0","1","0","0","0","1"
"Blue Springs","39.01695","-94.28161","1","0","0","0","0","0","0","1","0","0","0","0","0","0","0","1","0","1","1","0","0","0","0","1"
"Blyth","55.12708","-1.50856","25","1","0","0","5","0","0","31","5","6","7","0","18","8","3","20","0","31","10","7","11","1","2","31"
"Bo","7.96472","-11.73833","4","1","0","0","0","0","0","5","0","5","0","0","5","2","2","0","1","5","0","0","2","0","3","5"
"Bo","20.67264","105.53625","4","1","0","0","0","0","0","5","0","5","0","0","5","2","2","0","1","5","0","0","2","0","3","5"
"Bobo-Dioulasso","11.17715","-4.2979","4","2","0","0","0","0","0","6","1","4","1","0","6","3","2","1","0","6","1","1","2","0","2","6"
"Boca Raton","26.35869","-80.0831","0","0","0","0","0","0","1","1","0","0","0","0","0","1","0","0","0","1","0","0","1","0","0","1"
"Bocholt","51.17337","5.57994","1","0","0","0","0","0","0","1","0","0","1","0","1","0","0","1","0","1","0","0","1","0","0","1"
"Bocholt","51.83879","6.61531","1","0","0","0","0","0","0","1","0","0","1","0","1","0","0","1","0","1","0","0","1","0","0","1"
"Boconó","9.25385","-70.25105","0","0","0","0","0","0","0","0","0","0","0","0","0","0","0","0","0","0","0","0","0","0","0","0"
"Bodhan","18.66208","77.88581","2","0","0","0","0","0","0","2","2","0","0","0","2","0","0","2","0","2","0","0","2","0","0","2"
"Bodmin","50.47151","-4.7243","2","0","0","0","2","0","0","4","4","0","0","0","4","1","0","3","0","4","0","3","1","0","0","4"
"Boghni","36.54222","3.95306","1","0","0","0","0","0","0","1","0","1","0","0","1","0","1","0","0","1","1","0","0","0","0","1"
"Bognor Regis","50.78206","-0.67978","10","0","0","0","1","0","1","12","1","7","3","0","11","2","3","7","0","12","5","1","4","1","1","12"
"Bogor","-6.3314","105.8684","2","0","0","0","0","0","0","2","2","0","0","0","2","1","0","1","0","2","0","0","2","0","0","2"
"Bogor","-6.59444","106.78917","2","0","0","0","0","0","0","2","2","0","0","0","2","1","0","1","0","2","0","0","2","0","0","2"
"Bogotá","4.60971","-74.08175","23","0","0","0","0","0","0","23","11","3","2","0","16","6","7","8","0","21","6","5","10","0","2","23"
"Bogra","24.85098","89.37108","7","1","0","0","0","0","0","8","0","2","2","3","7","3","1","2","2","8","0","1","6","0","1","8"
"Bokspits","-26.9","20.7","1","0","0","0","0","0","0","1","0","1","0","0","1","1","0","0","0","1","0","0","0","0","1","1"
"Bolaang","0.9411","124.1556","1","0","0","0","0","0","0","1","0","0","0","0","0","1","0","0","0","1","1","0","0","0","0","1"
"Bolgatanga","10.78556","-0.85139","1","0","0","0","0","0","0","1","0","0","1","0","1","0","0","1","0","1","0","0","0","0","1","1"
"Bollington","53.29446","-2.10963","2","0","0","0","0","0","0","2","0","0","2","0","2","1","0","1","0","2","0","2","0","0","0","2"
"Bolney","50.99534","-0.20303","1","0","0","0","0","0","0","1","0","0","0","0","0","0","0","1","0","1","0","0","1","0","0","1"
"Bolton","32.34931","-90.4601","28","4","0","1","4","0","2","39","8","9","19","0","36","15","4","20","0","39","5","9","25","0","0","39"
"Bolton","34.32072","-78.40195","28","4","0","1","4","0","2","39","8","9","19","0","36","15","4","20","0","39","5","9","25","0","0","39"
"Bolton","42.43343","-71.60784","28","4","0","1","4","0","2","39","8","9","19","0","36","15","4","20","0","39","5","9","25","0","0","39"
"Bolton","53.58333","-2.43333","28","4","0","1","4","0","2","39","8","9","19","0","36","15","4","20","0","39","5","9","25","0","0","39"
"Bolton le Sands","54.09632","-2.80017","1","0","0","0","0","0","0","1","0","0","0","0","0","0","0","0","0","0","0","1","0","0","0","1"
"Bolu","40.73583","31.60611","1","1","0","0","0","0","0","2","1","0","0","0","1","2","0","0","0","2","2","0","0","0","0","2"
"Bolvadin","38.71111","31.04861","1","0","0","0","0","0","0","1","0","1","0","0","1","0","1","0","0","1","0","0","0","0","1","1"
"Bondi Beach","-33.89079","151.27852","1","0","0","0","0","0","0","1","0","0","1","0","1","0","0","1","0","1","0","0","1","0","0","1"
"Bondojito","20.44395","-99.70022","1","0","0","0","0","0","0","1","1","0","0","0","1","0","1","0","0","1","0","0","1","0","0","1"
"Bonn","50.73438","7.09549","3","0","0","0","0","0","0","3","0","1","1","0","2","2","0","1","0","3","1","1","1","0","0","3"
"Bonny","4.4516","7.17074","1","0","0","0","0","0","0","1","0","1","0","0","1","1","0","0","0","1","0","1","0","0","0","1"
"Bonnybridge","56.00152","-3.8886","2","0","0","0","0","0","0","2","0","0","2","0","2","0","0","2","0","2","0","0","2","0","0","2"
"Boone","42.0597","-93.88023","1","0","0","0","0","0","0","1","1","0","0","0","1","1","0","0","0","1","0","0","1","0","0","1"
"Boone","36.21679","-81.67455","1","0","0","0","0","0","0","1","1","0","0","0","1","1","0","0","0","1","0","0","1","0","0","1"
"Bootle","53.46667","-3.01667","1","0","0","1","0","0","0","2","1","1","0","0","2","1","1","0","0","2","1","0","1","0","0","2"
"Bor","49.71159","12.77516","1","0","0","0","0","0","0","1","0","1","0","0","1","0","0","1","0","1","0","0","1","0","0","1"
"Bor","57.11667","14.16667","1","0","0","0","0","0","0","1","0","1","0","0","1","0","0","1","0","1","0","0","1","0","0","1"
"Bor","44.07488","22.09591","1","0","0","0","0","0","0","1","0","1","0","0","1","0","0","1","0","1","0","0","1","0","0","1"
"Bor","6.20889","31.55861","1","0","0","0","0","0","0","1","0","1","0","0","1","0","0","1","0","1","0","0","1","0","0","1"
"Bor","37.89056","34.55889","1","0","0","0","0","0","0","1","0","1","0","0","1","0","0","1","0","1","0","0","1","0","0","1"
"Bor","56.35808","44.07477","1","0","0","0","0","0","0","1","0","1","0","0","1","0","0","1","0","1","0","0","1","0","0","1"
"Bor","61.60111","90.01806","1","0","0","0","0","0","0","1","0","1","0","0","1","0","0","1","0","1","0","0","1","0","0","1"
"Borås","57.72101","12.9401","1","0","0","0","0","0","0","1","1","0","0","0","1","0","0","1","0","1","0","0","1","0","0","1"
"Bordeaux","44.84044","-0.5805","0","0","0","0","0","0","1","1","0","0","1","0","1","1","0","0","0","1","0","0","1","0","0","1"
"Bordj Bou Arreridj","36.07321","4.76108","4","0","0","0","0","0","0","4","0","2","0","0","2","0","2","1","0","3","0","0","1","0","2","3"
"Bordon","51.11357","-0.86245","4","0","0","0","0","0","0","4","1","0","3","0","4","3","0","1","0","4","0","0","4","0","0","4"
"Borehamwood","51.65468","-0.27762","8","0","0","1","1","0","0","10","2","5","1","0","8","3","1","6","0","10","2","2","6","0","0","10"
"Borgloon","50.80505","5.34366","1","0","0","0","0","0","0","1","0","1","0","0","1","0","0","1","0","1","1","0","0","0","0","1"
"Borough Green","51.29158","0.30478","1","0","0","0","0","0","0","1","0","1","0","0","1","1","0","0","0","1","0","1","0","0","0","1"
"Borough Park","40.63399","-73.99681","1","0","0","0","0","0","0","1","0","0","0","0","0","0","1","0","0","1","1","0","0","0","0","1"
"Bosaso","11.28421","49.18158","4","0","0","0","0","0","0","4","0","2","0","2","4","1","2","0","1","4","2","0","2","0","0","4"
"Bosham","50.83088","-0.85384","1","0","0","0","0","0","0","1","1","0","0","0","1","0","1","0","0","1","0","0","1","0","0","1"
"Boston","30.79186","-83.78989","10","0","0","0","1","0","0","11","1","3","4","1","9","6","2","3","0","11","4","4","2","1","0","11"
"Boston","40.31201","-79.8231","10","0","0","0","1","0","0","11","1","3","4","1","9","6","2","3","0","11","4","4","2","1","0","11"
"Boston","42.62895","-78.73753","10","0","0","0","1","0","0","11","1","3","4","1","9","6","2","3","0","11","4","4","2","1","0","11"
"Boston","37.6093","-75.84271","10","0","0","0","1","0","0","11","1","3","4","1","9","6","2","3","0","11","4","4","2","1","0","11"
"Boston","42.35843","-71.05977","10","0","0","0","1","0","0","11","1","3","4","1","9","6","2","3","0","11","4","4","2","1","0","11"
"Boston","53.03083","-8.93167","10","0","0","0","1","0","0","11","1","3","4","1","9","6","2","3","0","11","4","4","2","1","0","11"
"Boston","52.97633","-0.02664","10","0","0","0","1","0","0","11","1","3","4","1","9","6","2","3","0","11","4","4","2","1","0","11"
"Boston","7.87111","126.36417","10","0","0","0","1","0","0","11","1","3","4","1","9","6","2","3","0","11","4","4","2","1","0","11"
"Bothaville","-27.3887","26.61701","1","0","0","0","0","0","0","1","0","0","1","0","1","1","0","0","0","1","0","0","1","0","0","1"
"Bouaké","7.69385","-5.03031","2","0","0","0","0","0","0","2","0","2","0","0","2","1","1","0","0","2","2","0","0","0","0","2"
"Boufarik","36.57413","2.91214","1","0","0","0","0","0","0","1","1","0","0","0","1","1","0","0","0","1","0","0","1","0","0","1"
"Boughton","53.2","-0.98333","1","0","0","0","0","0","0","1","1","0","0","0","1","0","0","0","1","1","0","1","0","0","0","1"
"Boukhalef","35.7328","-5.89954","0","0","0","0","0","0","0","0","0","0","0","0","0","1","0","0","0","1","0","0","0","0","1","1"
"Boulder","46.23659","-112.12083","1","0","0","0","1","0","0","2","0","0","2","0","2","1","0","1","0","2","0","0","2","0","0","2"
"Boulder","40.01499","-105.27055","1","0","0","0","1","0","0","2","0","0","2","0","2","1","0","1","0","2","0","0","2","0","0","2"
"Boulder","-30.78204","121.4912","1","0","0","0","1","0","0","2","0","0","2","0","2","1","0","1","0","2","0","0","2","0","0","2"
"Boulogne-Billancourt","48.83545","2.24128","0","0","0","1","0","0","0","1","1","0","0","0","1","1","0","0","0","1","0","0","1","0","0","1"
"Boumagueur","35.5052","5.5525","1","0","0","0","0","0","0","1","0","0","0","0","0","1","0","0","0","1","0","0","1","0","0","1"
"Bountiful","40.88939","-111.88077","1","0","0","0","0","0","0","1","0","1","0","0","1","1","0","0","0","1","0","0","1","0","0","1"
"Bourne","41.74122","-70.59892","5","0","0","0","0","0","0","5","0","1","2","0","3","2","0","3","0","5","2","1","2","0","0","5"
"Bourne","52.76667","-0.38333","5","0","0","0","0","0","0","5","0","1","2","0","3","2","0","3","0","5","2","1","2","0","0","5"
"Bourne End","51.57622","-0.71291","2","0","0","0","0","1","0","3","1","0","0","0","1","1","1","1","0","3","0","0","3","0","0","3"
"Bournemouth","50.72048","-1.8795","35","2","0","0","6","0","1","44","8","14","18","1","41","14","8","21","1","44","8","8","24","1","3","44"
"Bourton on the Water","51.88584","-1.75492","0","0","0","0","1","0","0","1","0","0","1","0","1","1","0","0","0","1","0","0","1","0","0","1"
"Bovingdon","51.72312","-0.5367","1","0","0","0","0","0","0","1","0","1","0","0","1","1","0","0","0","1","0","0","1","0","0","1"
"Bowie","33.559","-97.84865","1","0","0","0","0","0","0","1","0","1","0","0","1","0","1","0","0","1","1","0","0","0","0","1"
"Bowie","38.94278","-76.73028","1","0","0","0","0","0","0","1","0","1","0","0","1","0","1","0","0","1","1","0","0","0","0","1"
"Bowling Green","39.34199","-91.19514","1","0","0","0","0","0","0","1","1","0","0","0","1","0","0","1","0","1","0","0","1","0","0","1"
"Bowling Green","36.99032","-86.4436","1","0","0","0","0","0","0","1","1","0","0","0","1","0","0","1","0","1","0","0","1","0","0","1"
"Bowling Green","41.37477","-83.65132","1","0","0","0","0","0","0","1","1","0","0","0","1","0","0","1","0","1","0","0","1","0","0","1"
"Bowling Green","27.63837","-81.82397","1","0","0","0","0","0","0","1","1","0","0","0","1","0","0","1","0","1","0","0","1","0","0","1"
"Bowling Green","39.6237","-78.80446","1","0","0","0","0","0","0","1","1","0","0","0","1","0","0","1","0","1","0","0","1","0","0","1"
"Bowling Green","38.04958","-77.34665","1","0","0","0","0","0","0","1","1","0","0","0","1","0","0","1","0","1","0","0","1","0","0","1"
"Bowmore","55.75583","-6.28426","1","0","0","0","0","0","0","1","0","1","0","0","1","0","0","1","0","1","0","0","0","0","1","1"
"Box","51.41472","-2.24556","1","0","0","0","0","0","0","1","0","0","1","0","1","0","0","1","0","1","0","0","1","0","0","1"
"Boyacá","5.45371","-73.3625","1","0","0","0","0","0","0","1","0","1","0","0","1","0","1","0","0","1","0","0","1","0","0","1"
"Boyle","33.704","-90.72648","1","0","0","0","0","0","0","1","0","0","0","0","0","0","0","1","0","1","0","1","0","0","0","1"
"Boyle","53.96667","-8.3","1","0","0","0","0","0","0","1","0","0","0","0","0","0","0","1","0","1","0","1","0","0","0","1"
"Boynton Beach","26.52535","-80.06643","1","0","0","0","0","0","0","1","1","0","0","0","1","0","0","1","0","1","0","1","0","0","0","1"
"Brackley","52.03333","-1.15","6","0","0","0","1","0","0","7","1","1","3","0","5","1","1","5","0","7","1","2","4","0","0","7"
"Bracknell","51.41363","-0.75054","43","0","0","0","1","0","3","47","8","9","20","0","37","19","3","25","0","47","7","12","27","0","1","47"
"Bradford","35.42314","-91.45596","37","2","0","3","2","0","5","49","15","6","18","0","39","15","8","26","0","49","3","10","35","0","1","49"
"Bradford","41.17726","-89.6576","37","2","0","3","2","0","5","49","15","6","18","0","39","15","8","26","0","49","3","10","35","0","1","49"
"Bradford","36.07645","-88.81006","37","2","0","3","2","0","5","49","15","6","18","0","39","15","8","26","0","49","3","10","35","0","1","49"
"Bradford","40.13227","-84.43078","37","2","0","3","2","0","5","49","15","6","18","0","39","15","8","26","0","49","3","10","35","0","1","49"
"Bradford","41.9559","-78.64392","37","2","0","3","2","0","5","49","15","6","18","0","39","15","8","26","0","49","3","10","35","0","1","49"
"Bradford","43.99257","-72.12898","37","2","0","3","2","0","5","49","15","6","18","0","39","15","8","26","0","49","3","10","35","0","1","49"
"Bradford","41.39899","-71.73701","37","2","0","3","2","0","5","49","15","6","18","0","39","15","8","26","0","49","3","10","35","0","1","49"
"Bradford","45.06673","-68.93781","37","2","0","3","2","0","5","49","15","6","18","0","39","15","8","26","0","49","3","10","35","0","1","49"
"Bradford","53.79391","-1.75206","37","2","0","3","2","0","5","49","15","6","18","0","39","15","8","26","0","49","3","10","35","0","1","49"
"Bradford Abbas","50.92643","-2.58751","2","0","0","0","0","0","0","2","1","0","1","0","2","1","1","0","0","2","0","0","2","0","0","2"
"Bradford-on-Avon","51.34772","-2.25065","3","0","0","0","0","0","0","3","0","1","1","0","2","1","2","0","0","3","0","1","2","0","0","3"
"Braga","41.55032","-8.42005","2","0","0","0","0","0","0","2","0","1","0","1","2","1","0","1","0","2","1","0","1","0","0","2"
"Bragadiru","43.76667","25.51667","1","0","0","0","0","0","0","1","1","0","0","0","1","0","1","0","0","1","0","0","1","0","0","1"
"Bragadiru","44.37111","25.9775","1","0","0","0","0","0","0","1","1","0","0","0","1","0","1","0","0","1","0","0","1","0","0","1"
"Brahmapur","19.31151","84.7929","1","0","0","0","0","0","0","1","0","0","1","0","1","0","0","1","0","1","0","0","0","0","1","1"
"Brăila","45.27152","27.97429","0","1","0","0","0","0","0","1","1","0","0","0","1","0","1","0","0","1","0","0","1","0","0","1"
"Braintree","42.20384","-71.00215","9","1","0","0","1","0","0","11","1","5","3","0","9","5","1","5","0","11","6","1","4","0","0","11"
"Braintree","51.87819","0.55292","9","1","0","0","1","0","0","11","1","5","3","0","9","5","1","5","0","11","6","1","4","0","0","11"
"Bramhall","53.35801","-2.16539","1","0","0","1","1","0","0","3","1","1","1","0","3","2","0","1","0","3","0","1","2","0","0","3"
"Bramhope","53.88489","-1.61641","0","0","0","1","0","0","0","1","0","0","1","0","1","0","0","1","0","1","0","0","1","0","0","1"
"Bramley","53.41667","-1.26667","1","0","0","0","0","0","0","1","0","1","0","0","1","1","0","0","0","1","1","0","0","0","0","1"
"Bramley","51.32677","-1.05938","1","0","0","0","0","0","0","1","0","1","0","0","1","1","0","0","0","1","1","0","0","0","0","1"
"Bramley","51.19451","-0.55927","1","0","0","0","0","0","0","1","0","1","0","0","1","1","0","0","0","1","1","0","0","0","0","1"
"Brampton","43.68341","-79.76633","4","0","0","0","0","0","0","4","1","0","2","0","3","1","1","2","0","4","0","1","3","0","0","4"
"Brampton","54.95","-2.73333","4","0","0","0","0","0","0","4","1","0","2","0","3","1","1","2","0","4","0","1","3","0","0","4"
"Brampton","52.32039","-0.22007","4","0","0","0","0","0","0","4","1","0","2","0","3","1","1","2","0","4","0","1","3","0","0","4"
"Brandon","49.84692","-99.95306","1","0","0","0","0","0","0","1","0","0","1","0","1","0","0","1","0","1","0","1","0","0","0","1"
"Brandon","43.5947","-96.57199","1","0","0","0","0","0","0","1","0","0","1","0","1","0","0","1","0","1","0","1","0","0","0","1"
"Brandon","32.2732","-89.98592","1","0","0","0","0","0","0","1","0","0","1","0","1","0","0","1","0","1","0","1","0","0","0","1"
"Brandon","43.73526","-88.78122","1","0","0","0","0","0","0","1","0","0","1","0","1","0","0","1","0","1","0","1","0","0","0","1"
"Brandon","27.9378","-82.28592","1","0","0","0","0","0","0","1","0","0","1","0","1","0","0","1","0","1","0","1","0","0","0","1"
"Brandon","43.79812","-73.08761","1","0","0","0","0","0","0","1","0","0","1","0","1","0","0","1","0","1","0","1","0","0","0","1"
"Brandon","54.75","-1.61667","1","0","0","0","0","0","0","1","0","0","1","0","1","0","0","1","0","1","0","1","0","0","0","1"
"Brandon","52.38432","-1.3996","1","0","0","0","0","0","0","1","0","0","1","0","1","0","0","1","0","1","0","1","0","0","0","1"
"Brandon","-19.55389","147.35304","1","0","0","0","0","0","0","1","0","0","1","0","1","0","0","1","0","1","0","1","0","0","0","1"
"Brasília","-15.77972","-47.92972","1","0","0","0","0","0","0","1","0","1","0","0","1","0","1","0","0","1","0","0","1","0","0","1"
"Braşov","45.64861","25.60613","1","0","0","0","0","0","0","1","0","1","0","0","1","0","0","1","0","1","0","0","1","0","0","1"
"Brasschaat","51.2912","4.49182","1","0","0","0","0","0","0","1","1","0","0","0","1","0","0","1","0","1","0","0","1","0","0","1"
"Bratislava","48.14816","17.10674","8","1","0","0","0","0","0","9","0","1","4","0","5","1","3","5","0","9","3","1","4","0","1","9"
"Braunston","52.28979","-1.20266","1","0","0","0","0","0","0","1","0","0","1","0","1","0","0","1","0","1","0","0","1","0","0","1"
"Braunton","51.10847","-4.16131","1","0","0","0","0","0","0","1","0","1","0","0","1","0","0","1","0","1","0","0","1","0","0","1"
"Bray","34.63786","-97.81753","3","0","0","0","0","0","0","3","0","2","1","0","3","2","0","1","0","3","0","2","1","0","0","3"
"Bray","53.20278","-6.09833","3","0","0","0","0","0","0","3","0","2","1","0","3","2","0","1","0","3","0","2","1","0","0","3"
"Bray","51.5034","-0.68768","3","0","0","0","0","0","0","3","0","2","1","0","3","2","0","1","0","3","0","2","1","0","0","3"
"Brazzaville","-4.26613","15.28318","1","0","0","0","0","0","0","1","0","0","0","1","1","1","0","0","0","1","0","0","0","1","0","1"
"Brea","33.91668","-117.90006","0","0","0","0","0","0","0","0","0","0","0","0","0","0","0","0","0","0","0","0","0","0","0","0"
"Brechin","56.72993","-2.65729","3","0","0","0","0","0","0","3","1","2","0","0","3","1","0","2","0","3","0","0","2","0","1","3"
"Brecon","51.94612","-3.38887","6","0","0","0","2","0","0","8","1","2","4","0","7","2","1","5","0","8","1","4","3","0","0","8"
"Breda","41.74833","2.55964","2","0","0","0","0","0","0","2","0","0","1","0","1","0","1","1","0","2","0","1","1","0","0","2"
"Breda","51.58656","4.77596","2","0","0","0","0","0","0","2","0","0","1","0","1","0","1","1","0","2","0","1","1","0","0","2"
"Breda","45.7225","12.33083","2","0","0","0","0","0","0","2","0","0","1","0","1","0","1","1","0","2","0","1","1","0","0","2"
"Bredon","52.03008","-2.11671","1","0","0","0","0","0","0","1","0","1","0","0","1","1","0","0","0","1","1","0","0","0","0","1"
"Bremen","15.22","-92.34944","0","0","0","0","1","0","0","1","0","1","0","0","1","0","1","0","0","1","0","0","1","0","0","1"
"Bremen","41.44644","-86.14806","0","0","0","0","1","0","0","1","0","1","0","0","1","0","1","0","0","1","0","0","1","0","0","1"
"Bremen","33.72122","-85.1455","0","0","0","0","1","0","0","1","0","1","0","0","1","0","1","0","0","1","0","0","1","0","0","1"
"Bremen","39.70173","-82.42682","0","0","0","0","1","0","0","1","0","1","0","0","1","0","1","0","0","1","0","0","1","0","0","1"
"Bremen","44.00147","-69.42866","0","0","0","0","1","0","0","1","0","1","0","0","1","0","1","0","0","1","0","0","1","0","0","1"
"Bremen","53.07582","8.80717","0","0","0","0","1","0","0","1","0","1","0","0","1","0","1","0","0","1","0","0","1","0","0","1"
"Brent","35.36787","-94.79356","1","0","0","0","0","0","0","1","0","1","0","0","1","0","0","1","0","1","0","0","0","1","0","1"
"Brent","30.46881","-87.23608","1","0","0","0","0","0","0","1","0","1","0","0","1","0","0","1","0","1","0","0","0","1","0","1"
"Brent","32.93735","-87.16472","1","0","0","0","0","0","0","1","0","1","0","0","1","0","0","1","0","1","0","0","0","1","0","1"
"Brent","51.55306","-0.3023","1","0","0","0","0","0","0","1","0","1","0","0","1","0","0","1","0","1","0","0","0","1","0","1"
"Brent Knoll","51.25219","-2.95744","1","0","0","0","0","0","0","1","0","0","1","0","1","1","0","0","0","1","0","0","1","0","0","1"
"Brentwood","37.93187","-121.69579","12","3","0","2","0","0","2","19","4","3","11","0","18","10","1","8","0","19","1","3","13","2","0","19"
"Brentwood","38.61755","-90.34928","12","3","0","2","0","0","2","19","4","3","11","0","18","10","1","8","0","19","1","3","13","2","0","19"
"Brentwood","36.03312","-86.78278","12","3","0","2","0","0","2","19","4","3","11","0","18","10","1","8","0","19","1","3","13","2","0","19"
"Brentwood","40.37063","-79.97477","12","3","0","2","0","0","2","19","4","3","11","0","18","10","1","8","0","19","1","3","13","2","0","19"
"Brentwood","38.94317","-76.95664","12","3","0","2","0","0","2","19","4","3","11","0","18","10","1","8","0","19","1","3","13","2","0","19"
"Brentwood","40.78121","-73.24623","12","3","0","2","0","0","2","19","4","3","11","0","18","10","1","8","0","19","1","3","13","2","0","19"
"Brentwood","42.9787","-71.07284","12","3","0","2","0","0","2","19","4","3","11","0","18","10","1","8","0","19","1","3","13","2","0","19"
"Brentwood","51.62127","0.30556","12","3","0","2","0","0","2","19","4","3","11","0","18","10","1","8","0","19","1","3","13","2","0","19"
"Brentwood","-32.04347","115.85246","12","3","0","2","0","0","2","19","4","3","11","0","18","10","1","8","0","19","1","3","13","2","0","19"
"Brescia","45.53558","10.21472","0","0","0","0","0","1","0","1","1","0","0","0","1","0","1","0","0","1","0","0","0","1","0","1"
"Bressuire","46.84158","-0.49042","1","0","0","0","0","0","0","1","1","0","0","0","1","0","0","1","0","1","0","0","1","0","0","1"
"Bretigny","47.4","5.1","0","1","0","0","0","0","0","1","1","0","0","0","1","0","1","0","0","1","0","1","0","0","0","1"
"Brewster","48.09598","-119.78062","1","0","0","0","0","0","0","1","0","1","0","0","1","1","0","0","0","1","0","0","1","0","0","1"
"Brewster","41.93889","-99.86485","1","0","0","0","0","0","0","1","0","1","0","0","1","1","0","0","0","1","0","0","1","0","0","1"
"Brewster","40.707","-81.59818","1","0","0","0","0","0","0","1","0","1","0","0","1","1","0","0","0","1","0","0","1","0","0","1"
"Brewster","41.39732","-73.61707","1","0","0","0","0","0","0","1","0","1","0","0","1","1","0","0","0","1","0","0","1","0","0","1"
"Brewster","41.76011","-70.0828","1","0","0","0","0","0","0","1","0","1","0","0","1","1","0","0","0","1","0","0","1","0","0","1"
"Briançon","44.89978","6.64201","1","0","0","0","0","0","0","1","0","1","0","0","1","1","0","0","0","1","0","0","1","0","0","1"
"Briarwood","40.70935","-73.81529","1","0","0","0","0","0","0","1","0","0","1","0","1","0","1","0","0","1","0","1","0","0","0","1"
"Bridgend","51.50583","-3.57722","29","0","0","1","4","0","1","35","6","13","14","0","33","15","4","16","0","35","6","12","16","0","1","35"
"Bridgend","55.96366","-3.53592","29","0","0","1","4","0","1","35","6","13","14","0","33","15","4","16","0","35","6","12","16","0","1","35"
"Bridgend","57.4","-2.81667","29","0","0","1","4","0","1","35","6","13","14","0","33","15","4","16","0","35","6","12","16","0","1","35"
"Bridgetown","39.15311","-84.63717","0","1","0","0","0","0","0","1","1","0","0","0","1","0","0","1","0","1","0","0","0","0","1","1"
"Bridgetown","13.10732","-59.62021","0","1","0","0","0","0","0","1","1","0","0","0","1","0","0","1","0","1","0","0","0","0","1","1"
"Bridgetown","-33.96242","116.13598","0","1","0","0","0","0","0","1","1","0","0","0","1","0","0","1","0","1","0","0","0","0","1","1"
"Bridgnorth","52.53661","-2.42033","1","0","0","0","0","0","0","1","0","0","1","0","1","1","0","0","0","1","0","1","0","0","0","1"
"Bridgwater","51.12837","-3.00356","7","0","0","0","0","0","0","7","0","3","3","0","6","2","0","5","0","7","1","1","4","0","1","7"
"Bridlington","54.08306","-0.19192","6","3","0","0","0","0","0","9","0","4","5","0","9","3","1","5","0","9","1","6","2","0","0","9"
"Bridport","43.98506","-73.31262","6","0","0","0","0","0","0","6","0","0","2","0","2","2","1","3","0","6","1","2","3","0","0","6"
"Bridport","50.7338","-2.75831","6","0","0","0","0","0","0","6","0","0","2","0","2","2","1","3","0","6","1","2","3","0","0","6"
"Bridport","-41.00046","147.39175","6","0","0","0","0","0","0","6","0","0","2","0","2","2","1","3","0","6","1","2","3","0","0","6"
"Brierfield","53.82468","-2.23415","1","0","0","0","0","0","1","2","1","0","1","0","2","1","0","1","0","2","0","1","1","0","0","2"
"Brierley Hill","52.48173","-2.12139","6","0","0","1","0","0","0","7","2","1","4","0","7","1","1","5","0","7","2","1","4","0","0","7"
"Brigg","53.55201","-0.49214","1","0","0","0","0","0","0","1","0","1","0","0","1","0","1","0","0","1","0","0","1","0","0","1"
"Brighouse","53.70322","-1.78428","4","1","0","0","1","0","0","6","3","1","1","0","5","2","1","3","0","6","1","0","5","0","0","6"
"Brightlingsea","51.81164","1.02336","2","0","0","0","0","0","0","2","0","0","1","0","1","1","0","1","0","2","0","1","1","0","0","2"
"Brighton","39.98526","-104.82053","55","1","0","2","1","0","5","64","7","18","13","2","40","24","8","32","0","64","12","9","31","2","9","63"
"Brighton","41.17474","-91.81961","55","1","0","2","1","0","5","64","7","18","13","2","40","24","8","32","0","64","12","9","31","2","9","63"
"Brighton","39.03977","-90.14066","55","1","0","2","1","0","5","64","7","18","13","2","40","24","8","32","0","64","12","9","31","2","9","63"
"Brighton","35.48397","-89.72508","55","1","0","2","1","0","5","64","7","18","13","2","40","24","8","32","0","64","12","9","31","2","9","63"
"Brighton","33.43428","-86.94721","55","1","0","2","1","0","5","64","7","18","13","2","40","24","8","32","0","64","12","9","31","2","9","63"
"Brighton","35.08009","-86.43916","55","1","0","2","1","0","5","64","7","18","13","2","40","24","8","32","0","64","12","9","31","2","9","63"
"Brighton","42.52948","-83.78022","55","1","0","2","1","0","5","64","7","18","13","2","40","24","8","32","0","64","12","9","31","2","9","63"
"Brighton","43.14756","-77.55055","55","1","0","2","1","0","5","64","7","18","13","2","40","24","8","32","0","64","12","9","31","2","9","63"
"Brighton","50.82838","-0.13947","55","1","0","2","1","0","5","64","7","18","13","2","40","24","8","32","0","64","12","9","31","2","9","63"
"Brighton","-35.0182","138.52351","55","1","0","2","1","0","5","64","7","18","13","2","40","24","8","32","0","64","12","9","31","2","9","63"
"Brighton","-37.90561","145.00279","55","1","0","2","1","0","5","64","7","18","13","2","40","24","8","32","0","64","12","9","31","2","9","63"
"Brighton","-42.69814","147.24489","55","1","0","2","1","0","5","64","7","18","13","2","40","24","8","32","0","64","12","9","31","2","9","63"
"Brighton","-27.29582","153.05721","55","1","0","2","1","0","5","64","7","18","13","2","40","24","8","32","0","64","12","9","31","2","9","63"
"Brikama","13.27136","-16.64944","0","1","0","0","0","0","0","1","0","1","0","0","1","0","0","1","0","1","0","0","1","0","0","1"
"Brindisi","40.63215","17.93607","1","0","0","0","0","0","0","1","0","0","1","0","1","0","0","1","0","1","0","0","1","0","0","1"
"Brinkmann","-30.86589","-62.03742","1","0","0","0","0","0","0","1","0","1","0","0","1","0","1","0","0","1","1","0","0","0","0","1"
"Brisbane","37.68077","-122.39997","10","0","0","0","0","0","0","10","1","2","3","0","6","3","5","2","0","10","4","1","5","0","0","10"
"Brisbane","-27.46794","153.02809","10","0","0","0","0","0","0","10","1","2","3","0","6","3","5","2","0","10","4","1","5","0","0","10"
"Brisée Verdière","-20.16389","57.64667","1","0","0","0","1","0","0","2","2","0","0","0","2","2","0","0","0","2","0","0","1","0","0","1"
"Bristol","32.46153","-96.56999","162","7","0","9","20","0","17","215","37","54","86","3","180","75","27","111","1","214","26","34","143","3","8","214"
"Bristol","42.55891","-88.04925","162","7","0","9","20","0","17","215","37","54","86","3","180","75","27","111","1","214","26","34","143","3","8","214"
"Bristol","41.72144","-85.81749","162","7","0","9","20","0","17","215","37","54","86","3","180","75","27","111","1","214","26","34","143","3","8","214"
"Bristol","30.43247","-84.97702","162","7","0","9","20","0","17","215","37","54","86","3","180","75","27","111","1","214","26","34","143","3","8","214"
"Bristol","36.59511","-82.18874","162","7","0","9","20","0","17","215","37","54","86","3","180","75","27","111","1","214","26","34","143","3","8","214"
"Bristol","36.59649","-82.18847","162","7","0","9","20","0","17","215","37","54","86","3","180","75","27","111","1","214","26","34","143","3","8","214"
"Bristol","40.10067","-74.85183","162","7","0","9","20","0","17","215","37","54","86","3","180","75","27","111","1","214","26","34","143","3","8","214"
"Bristol","44.13339","-73.07901","162","7","0","9","20","0","17","215","37","54","86","3","180","75","27","111","1","214","26","34","143","3","8","214"
"Bristol","41.67176","-72.94927","162","7","0","9","20","0","17","215","37","54","86","3","180","75","27","111","1","214","26","34","143","3","8","214"
"Bristol","43.59119","-71.73675","162","7","0","9","20","0","17","215","37","54","86","3","180","75","27","111","1","214","26","34","143","3","8","214"
"Bristol","41.67705","-71.26616","162","7","0","9","20","0","17","215","37","54","86","3","180","75","27","111","1","214","26","34","143","3","8","214"
"Bristol","43.95758","-69.50921","162","7","0","9","20","0","17","215","37","54","86","3","180","75","27","111","1","214","26","34","143","3","8","214"
"Bristol","51.45523","-2.59665","162","7","0","9","20","0","17","215","37","54","86","3","180","75","27","111","1","214","26","34","143","3","8","214"
"Briston","52.85369","1.05899","1","0","0","0","0","0","0","1","1","0","0","0","1","1","0","0","0","1","0","1","0","0","0","1"
"Brixham","50.39431","-3.51585","3","0","0","0","0","0","0","3","0","0","2","0","2","0","0","3","0","3","0","0","3","0","0","3"
"Brno","49.19522","16.60796","1","1","0","0","0","0","0","2","0","2","0","0","2","0","1","1","0","2","1","0","1","0","0","2"
"Broad Haven","51.78025","-5.10258","1","0","0","0","0","0","0","1","0","0","0","0","0","0","1","0","0","1","0","0","1","0","0","1"
"Broadstairs","51.35908","1.43938","4","0","0","0","1","0","0","5","0","2","3","0","5","2","0","3","0","5","0","2","3","0","0","5"
"Broadstone","50.75717","-1.99406","1","0","0","0","0","0","0","1","0","0","1","0","1","0","0","1","0","1","0","1","0","0","0","1"
"Broadway","35.45793","-79.05308","1","0","0","0","0","0","1","2","1","1","0","0","2","1","0","1","0","2","0","1","1","0","0","2"
"Broadway","38.61317","-78.79891","1","0","0","0","0","0","1","2","1","1","0","0","2","1","0","1","0","2","0","1","1","0","0","2"
"Broadway","52.03825","-1.86079","1","0","0","0","0","0","1","2","1","1","0","0","2","1","0","1","0","2","0","1","1","0","0","2"
"Bromborough","53.3485","-2.97935","3","0","0","0","0","0","0","3","0","1","1","0","2","1","0","1","0","2","2","0","1","0","0","3"
"Bromley","38.64062","-84.84828","22","0","0","0","2","0","4","28","5","9","9","0","23","10","3","15","0","28","3","8","16","1","0","28"
"Bromley","39.082","-84.56022","22","0","0","0","2","0","4","28","5","9","9","0","23","10","3","15","0","28","3","8","16","1","0","28"
"Bromley","51.40606","0.01519","22","0","0","0","2","0","4","28","5","9","9","0","23","10","3","15","0","28","3","8","16","1","0","28"
"Bromsgrove","52.33574","-2.05983","8","3","0","0","1","0","1","13","4","3","3","0","10","9","1","3","0","13","2","6","5","0","0","13"
"Brookings","42.05261","-124.28398","1","0","0","0","0","0","0","1","0","0","0","0","0","1","0","0","0","1","0","0","1","0","0","1"
"Brookings","44.31136","-96.79839","1","0","0","0","0","0","0","1","0","0","0","0","0","1","0","0","0","1","0","0","1","0","0","1"
"Brookline","42.73481","-71.65813","1","0","0","0","0","0","0","1","0","0","1","0","1","1","0","0","0","1","0","0","1","0","0","1"
"Brookline","42.33176","-71.12116","1","0","0","0","0","0","0","1","0","0","1","0","1","1","0","0","0","1","0","0","1","0","0","1"
"Brooklyn","41.73361","-92.44546","4","1","0","1","0","0","0","6","3","0","0","0","3","3","0","3","0","6","0","3","3","0","0","6"
"Brooklyn","38.65866","-90.16594","4","1","0","1","0","0","0","6","3","0","0","0","3","3","0","3","0","6","0","3","3","0","0","6"
"Brooklyn","42.85361","-89.3704","4","1","0","1","0","0","0","6","3","0","0","0","3","3","0","3","0","6","0","3","3","0","0","6"
"Brooklyn","39.53921","-86.36916","4","1","0","1","0","0","0","6","3","0","0","0","3","3","0","3","0","6","0","3","3","0","0","6"
"Brooklyn","42.10587","-84.24828","4","1","0","1","0","0","0","6","3","0","0","0","3","3","0","3","0","6","0","3","3","0","0","6"
"Brooklyn","41.43977","-81.73541","4","1","0","1","0","0","0","6","3","0","0","0","3","3","0","3","0","6","0","3","3","0","0","6"
"Brooklyn","40.6501","-73.94958","4","1","0","1","0","0","0","6","3","0","0","0","3","3","0","3","0","6","0","3","3","0","0","6"
"Brooklyn","41.78815","-71.9498","4","1","0","1","0","0","0","6","3","0","0","0","3","3","0","3","0","6","0","3","3","0","0","6"
"Brooklyn","-37.81609","144.8415","4","1","0","1","0","0","0","6","3","0","0","0","3","3","0","3","0","6","0","3","3","0","0","6"
"Brooklyn","-41.07223","145.90731","4","1","0","1","0","0","0","6","3","0","0","0","3","3","0","3","0","6","0","3","3","0","0","6"
"Brooklyn","-33.54903","151.22492","4","1","0","1","0","0","0","6","3","0","0","0","3","3","0","3","0","6","0","3","3","0","0","6"
"Brooklyn","-41.30586","174.76257","4","1","0","1","0","0","0","6","3","0","0","0","3","3","0","3","0","6","0","3","3","0","0","6"
"Brough","53.72861","-0.57215","4","1","0","0","0","0","0","5","1","1","3","0","5","2","0","3","0","5","0","0","5","0","0","5"
"Broughton","53.16303","-2.99309","1","0","0","0","0","0","0","1","0","1","0","0","1","1","0","0","0","1","0","0","1","0","0","1"
"Broughton","52.37331","-0.77493","1","0","0","0","0","0","0","1","0","1","0","0","1","1","0","0","0","1","0","0","1","0","0","1"
"Broughton","52.05038","-0.69351","1","0","0","0","0","0","0","1","0","1","0","0","1","1","0","0","0","1","0","0","1","0","0","1"
"Broughton","53.56667","-0.55","1","0","0","0","0","0","0","1","0","1","0","0","1","1","0","0","0","1","0","0","1","0","0","1"
"Broughton","-20.11667","146.43333","1","0","0","0","0","0","0","1","0","1","0","0","1","1","0","0","0","1","0","0","1","0","0","1"
"Broughton Astley","52.52787","-1.21768","1","0","0","0","0","0","0","1","0","1","0","0","1","1","0","0","0","1","1","0","0","0","0","1"
"Brownsweg","5.00435","-55.15333","1","0","0","0","0","0","0","1","0","1","0","0","1","0","1","0","0","1","0","0","1","0","0","1"
"Broxbourne","51.74712","-0.01923","2","0","0","0","0","0","0","2","0","0","1","0","1","1","0","1","0","2","1","0","1","0","0","2"
"Broxburn","55.93415","-3.47133","0","0","0","0","0","0","1","1","1","0","0","0","1","0","0","1","0","1","0","1","0","0","0","1"
"Bruff","52.47417","-8.54583","1","0","0","0","0","0","0","1","0","1","0","0","1","0","1","0","0","1","1","0","0","0","0","1"
"Brugg","47.48096","8.20869","0","0","0","0","1","0","0","1","0","0","0","0","0","1","0","0","0","1","0","0","1","0","0","1"
"Brunswick","39.42336","-93.13048","1","0","0","0","0","0","0","1","0","1","0","0","1","0","1","0","0","1","0","0","1","0","0","1"
"Brunswick","41.23811","-81.8418","1","0","0","0","0","0","0","1","0","1","0","0","1","0","1","0","0","1","0","0","1","0","0","1"
"Brunswick","31.14995","-81.49149","1","0","0","0","0","0","0","1","0","1","0","0","1","0","1","0","0","1","0","0","1","0","0","1"
"Brunswick","34.28684","-78.70113","1","0","0","0","0","0","0","1","0","1","0","0","1","0","1","0","0","1","0","0","1","0","0","1"
"Brunswick","39.31427","-77.62777","1","0","0","0","0","0","0","1","0","1","0","0","1","0","1","0","0","1","0","0","1","0","0","1"
"Brunswick","43.91452","-69.96533","1","0","0","0","0","0","0","1","0","1","0","0","1","0","1","0","0","1","0","0","1","0","0","1"
"Brunswick","-33.2324","115.86282","1","0","0","0","0","0","0","1","0","1","0","0","1","0","1","0","0","1","0","0","1","0","0","1"
"Brunswick","-37.76667","144.96667","1","0","0","0","0","0","0","1","0","1","0","0","1","0","1","0","0","1","0","0","1","0","0","1"
"Brussels","44.73611","-87.62093","9","0","0","0","1","0","0","10","2","2","2","0","6","1","2","7","0","10","1","1","7","1","0","10"
"Brussels","43.73339","-81.24975","9","0","0","0","1","0","0","10","2","2","2","0","6","1","2","7","0","10","1","1","7","1","0","10"
"Brussels","50.85045","4.34878","9","0","0","0","1","0","0","10","2","2","2","0","6","1","2","7","0","10","1","1","7","1","0","10"
"Bruton","51.1125","-2.45278","1","0","0","0","0","0","0","1","0","1","0","0","1","0","0","1","0","1","0","0","1","0","0","1"
"Brynmawr","51.8","-3.18333","1","0","0","0","0","0","0","1","0","0","1","0","1","0","0","1","0","1","0","0","1","0","0","1"
"Bry-sur-Marne","48.83811","2.52488","0","0","0","1","0","1","0","2","2","0","0","0","2","0","0","2","0","2","0","2","0","0","0","2"
"Bucaramanga","7.12539","-73.1198","2","0","0","0","0","0","0","2","1","0","0","0","1","1","0","1","0","2","1","0","1","0","0","2"
"Bucha","50.88333","11.51667","1","0","0","0","0","0","0","1","0","1","0","0","1","0","1","0","0","1","1","0","0","0","0","1"
"Bucha","50.63333","11.7","1","0","0","0","0","0","0","1","0","1","0","0","1","0","1","0","0","1","1","0","0","0","0","1"
"Bucha","50.54345","30.21201","1","0","0","0","0","0","0","1","0","1","0","0","1","0","1","0","0","1","1","0","0","0","0","1"
"Buchanan","41.82727","-86.36112","1","0","0","0","0","0","0","1","1","0","0","0","1","1","0","0","0","1","0","0","1","0","0","1"
"Buchanan","33.8026","-85.18856","1","0","0","0","0","0","0","1","1","0","0","0","1","1","0","0","0","1","0","0","1","0","0","1"
"Buchanan","37.52736","-79.67976","1","0","0","0","0","0","0","1","1","0","0","0","1","1","0","0","0","1","0","0","1","0","0","1"
"Buchanan","41.26204","-73.93819","1","0","0","0","0","0","0","1","1","0","0","0","1","1","0","0","0","1","0","0","1","0","0","1"
"Buchanan","5.87693","-10.04964","1","0","0","0","0","0","0","1","1","0","0","0","1","1","0","0","0","1","0","0","1","0","0","1"
"Bucharest","44.43225","26.10626","38","1","0","0","1","0","0","40","7","12","2","3","24","20","8","11","1","40","18","3","15","2","2","40"
"Buckhurst Hill","51.62409","0.03262","3","0","0","0","0","0","1","4","1","1","2","0","4","1","0","3","0","4","0","0","4","0","0","4"
"Buckingham","26.67507","-81.73203","10","1","0","2","0","0","1","14","5","4","3","1","13","6","2","6","0","14","2","2","8","0","2","14"
"Buckingham","37.55015","-78.55556","10","1","0","2","0","0","1","14","5","4","3","1","13","6","2","6","0","14","2","2","8","0","2","14"
"Buckingham","45.58563","-75.4208","10","1","0","2","0","0","1","14","5","4","3","1","13","6","2","6","0","14","2","2","8","0","2","14"
"Buckingham","51.99968","-0.98779","10","1","0","2","0","0","1","14","5","4","3","1","13","6","2","6","0","14","2","2","8","0","2","14"
"Buckley","47.16316","-122.02678","2","0","0","0","2","0","0","4","1","1","1","0","3","1","0","3","0","4","1","3","0","0","0","4"
"Buckley","40.59698","-88.0381","2","0","0","0","2","0","0","4","1","1","1","0","3","1","0","3","0","4","1","3","0","0","0","4"
"Buckley","44.50445","-85.67701","2","0","0","0","2","0","0","4","1","1","1","0","3","1","0","3","0","4","1","3","0","0","0","4"
"Buckley","53.16667","-3.08333","2","0","0","0","2","0","0","4","1","1","1","0","3","1","0","3","0","4","1","3","0","0","0","4"
"Bucureşci","46.13333","22.9","1","0","0","0","0","0","0","1","0","0","0","0","0","0","0","1","0","1","0","0","1","0","0","1"
"Bucuresti","44.42802","26.09665","25","1","0","0","1","0","1","28","3","8","4","0","15","9","5","14","0","28","8","3","15","1","1","28"
"Budakovo","42.355","20.925","1","0","0","0","0","0","0","1","0","0","0","0","0","0","1","0","0","1","0","0","1","0","0","1"
"Budaörs","47.46181","18.95845","1","0","0","0","0","0","0","1","0","1","0","0","1","1","0","0","0","1","1","0","0","0","0","1"
"Budapest","47.49835","19.04045","9","0","0","0","0","0","1","10","2","1","2","0","5","4","2","4","0","10","3","0","6","1","0","10"
"Budapest II. kerület","47.51984","19.02218","2","0","0","0","1","0","0","3","2","0","0","0","2","0","1","2","0","3","1","1","1","0","0","3"
"Budapest XI. kerület","47.47603","19.03605","2","0","0","0","0","0","0","2","0","0","1","0","1","2","0","0","0","2","1","0","1","0","0","2"
"Bude","31.46295","-90.8501","1","0","0","1","1","0","0","3","2","1","0","0","3","0","1","2","0","3","0","1","2","0","0","3"
"Bude","50.82435","-4.5413","1","0","0","1","1","0","0","3","2","1","0","0","3","0","1","2","0","3","0","1","2","0","0","3"
"Budleigh Salterton","50.62983","-3.32181","1","0","0","0","0","0","0","1","0","0","0","0","0","1","0","0","0","1","1","0","0","0","0","1"
"Buea","4.15342","9.24231","3","0","0","0","0","0","0","3","0","0","1","1","2","2","1","0","0","3","0","1","1","0","0","2"
"Bu‘eina","32.80636","35.36486","2","0","0","0","0","0","0","2","1","0","0","0","1","1","0","1","0","2","1","0","1","0","0","2"
"Buena Park","33.86751","-117.99812","1","0","0","0","0","0","0","1","0","0","0","0","0","0","0","1","0","1","1","0","0","0","0","1"
"Buenos Aires","32.42278","-116.94111","18","3","0","0","0","0","0","21","7","7","0","0","14","3","4","14","0","21","7","3","7","4","0","21"
"Buenos Aires","20.58145","-104.03105","18","3","0","0","0","0","0","21","7","7","0","0","14","3","4","14","0","21","7","3","7","4","0","21"
"Buenos Aires","18.02444","-102.28583","18","3","0","0","0","0","0","21","7","7","0","0","14","3","4","14","0","21","7","3","7","4","0","21"
"Buenos Aires","19.07499","-102.17999","18","3","0","0","0","0","0","21","7","7","0","0","14","3","4","14","0","21","7","3","7","4","0","21"
"Buenos Aires","20.38341","-102.17599","18","3","0","0","0","0","0","21","7","7","0","0","14","3","4","14","0","21","7","3","7","4","0","21"
"Buenos Aires","19.61745","-99.6679","18","3","0","0","0","0","0","21","7","7","0","0","14","3","4","14","0","21","7","3","7","4","0","21"
"Buenos Aires","20.02139","-98.29222","18","3","0","0","0","0","0","21","7","7","0","0","14","3","4","14","0","21","7","3","7","4","0","21"
"Buenos Aires","20.15333","-97.74833","18","3","0","0","0","0","0","21","7","7","0","0","14","3","4","14","0","21","7","3","7","4","0","21"
"Buenos Aires","20.95806","-97.5","18","3","0","0","0","0","0","21","7","7","0","0","14","3","4","14","0","21","7","3","7","4","0","21"
"Buenos Aires","18.94156","-96.76692","18","3","0","0","0","0","0","21","7","7","0","0","14","3","4","14","0","21","7","3","7","4","0","21"
"Buenos Aires","18.25787","-96.61505","18","3","0","0","0","0","0","21","7","7","0","0","14","3","4","14","0","21","7","3","7","4","0","21"
"Buenos Aires","18.46463","-95.24879","18","3","0","0","0","0","0","21","7","7","0","0","14","3","4","14","0","21","7","3","7","4","0","21"
"Buenos Aires","15.58595","-92.49913","18","3","0","0","0","0","0","21","7","7","0","0","14","3","4","14","0","21","7","3","7","4","0","21"
"Buenos Aires","14.8898","-92.48121","18","3","0","0","0","0","0","21","7","7","0","0","14","3","4","14","0","21","7","3","7","4","0","21"
"Buenos Aires","15.03333","-88.96667","18","3","0","0","0","0","0","21","7","7","0","0","14","3","4","14","0","21","7","3","7","4","0","21"
"Buenos Aires","15.48333","-88.18333","18","3","0","0","0","0","0","21","7","7","0","0","14","3","4","14","0","21","7","3","7","4","0","21"
"Buenos Aires","15.46667","-86.4","18","3","0","0","0","0","0","21","7","7","0","0","14","3","4","14","0","21","7","3","7","4","0","21"
"Buenos Aires","11.46916","-85.81661","18","3","0","0","0","0","0","21","7","7","0","0","14","3","4","14","0","21","7","3","7","4","0","21"
"Buenos Aires","9.17189","-83.33417","18","3","0","0","0","0","0","21","7","7","0","0","14","3","4","14","0","21","7","3","7","4","0","21"
"Buenos Aires","8.41384","-81.4844","18","3","0","0","0","0","0","21","7","7","0","0","14","3","4","14","0","21","7","3","7","4","0","21"
"Buenos Aires","-5.26083","-79.96417","18","3","0","0","0","0","0","21","7","7","0","0","14","3","4","14","0","21","7","3","7","4","0","21"
"Buenos Aires","8.63146","-79.94775","18","3","0","0","0","0","0","21","7","7","0","0","14","3","4","14","0","21","7","3","7","4","0","21"
"Buenos Aires","-8.13861","-79.04028","18","3","0","0","0","0","0","21","7","7","0","0","14","3","4","14","0","21","7","3","7","4","0","21"
"Buenos Aires","-9.12417","-78.4975","18","3","0","0","0","0","0","21","7","7","0","0","14","3","4","14","0","21","7","3","7","4","0","21"
"Buenos Aires","3.01397","-76.64612","18","3","0","0","0","0","0","21","7","7","0","0","14","3","4","14","0","21","7","3","7","4","0","21"
"Buenos Aires","-6.79111","-76.32639","18","3","0","0","0","0","0","21","7","7","0","0","14","3","4","14","0","21","7","3","7","4","0","21"
"Buenos Aires","-34.61315","-58.37723","18","3","0","0","0","0","0","21","7","7","0","0","14","3","4","14","0","21","7","3","7","4","0","21"
"Buffalo","44.34831","-106.69894","2","0","0","0","0","0","0","2","1","0","0","0","1","1","0","1","0","2","0","0","2","0","0","2"
"Buffalo","45.58416","-103.54603","2","0","0","0","0","0","0","2","1","0","0","0","1","1","0","1","0","2","0","0","2","0","0","2"
"Buffalo","36.83559","-99.6304","2","0","0","0","0","0","0","2","1","0","0","0","1","1","0","1","0","2","0","0","2","0","0","2"
"Buffalo","31.46379","-96.05802","2","0","0","0","0","0","0","2","1","0","0","0","1","1","0","1","0","2","0","0","2","0","0","2"
"Buffalo","45.17191","-93.87469","2","0","0","0","0","0","0","2","1","0","0","0","1","1","0","1","0","2","0","0","2","0","0","2"
"Buffalo","37.64393","-93.09241","2","0","0","0","0","0","0","2","1","0","0","0","1","1","0","1","0","2","0","0","2","0","0","2"
"Buffalo","41.45642","-90.72347","2","0","0","0","0","0","0","2","1","0","0","0","1","1","0","1","0","2","0","0","2","0","0","2"
"Buffalo","40.88254","-86.74529","2","0","0","0","0","0","0","2","1","0","0","0","1","1","0","1","0","2","0","0","2","0","0","2"
"Buffalo","38.61759","-81.9818","2","0","0","0","0","0","0","2","1","0","0","0","1","1","0","1","0","2","0","0","2","0","0","2"
"Buffalo","34.72569","-81.68343","2","0","0","0","0","0","0","2","1","0","0","0","1","1","0","1","0","2","0","0","2","0","0","2"
"Buffalo","42.88645","-78.87837","2","0","0","0","0","0","0","2","1","0","0","0","1","1","0","1","0","2","0","0","2","0","0","2"
"Buford","34.12066","-84.00435","1","0","0","0","0","0","0","1","0","1","0","0","1","1","0","0","0","1","1","0","0","0","0","1"
"Bugene","-1.59111","31.14028","1","1","0","0","0","0","0","2","0","1","1","0","2","0","0","2","0","2","0","1","0","0","0","1"
"Buikwe","0.3375","33.01056","1","0","0","0","0","0","0","1","0","0","0","0","0","1","0","0","0","1","0","0","0","0","1","1"
"Builth Wells","52.1494","-3.40469","2","0","0","0","2","0","0","4","0","0","4","0","4","0","0","4","0","4","0","1","3","0","0","4"
"Buin","-33.73257","-70.74281","1","0","0","0","0","0","0","1","0","0","0","0","0","0","1","0","0","1","1","0","0","0","0","1"
"Buin","-6.74864","155.69147","1","0","0","0","0","0","0","1","0","0","0","0","0","0","1","0","0","1","1","0","0","0","0","1"
"Bujumbura","-3.38193","29.36142","5","0","0","0","0","0","0","5","0","2","0","3","5","2","1","1","1","5","0","0","1","2","2","5"
"Bukavu","-2.49077","28.84281","1","0","0","0","0","0","0","1","0","1","0","0","1","0","1","0","0","1","1","0","0","0","0","1"
"Bukit Mertajam","5.36301","100.4667","1","0","0","0","0","0","0","1","0","0","1","0","1","0","0","1","0","1","0","0","1","0","0","1"
"Bukoba","-1.33167","31.81222","1","0","0","0","0","0","0","1","0","0","0","0","0","1","0","0","0","1","0","0","1","0","0","1"
"Bulacan","14.79278","120.87889","2","0","0","0","0","0","0","2","1","1","0","0","2","0","1","1","0","2","1","1","0","0","0","2"
"Bulacan","6.5675","125.42111","2","0","0","0","0","0","0","2","1","1","0","0","2","0","1","1","0","2","1","1","0","0","0","2"
"Bülach / Seematt","47.51716","8.54651","0","0","0","1","0","0","0","1","1","0","0","0","1","0","0","1","0","1","0","0","1","0","0","1"
"Bulawayo","-20.15","28.58333","4","0","0","0","0","0","0","4","0","2","1","0","3","2","2","0","0","4","1","0","2","0","1","4"
"Bulkington","51.32361","-2.08361","1","0","0","0","0","0","0","1","0","0","1","0","1","0","0","1","0","1","0","0","1","0","0","1"
"Bunclody","52.6553","-6.65359","1","0","0","0","0","0","0","1","0","0","0","0","0","1","0","0","0","1","0","0","1","0","0","1"
"Bungay","52.45434","1.43818","2","0","0","0","0","0","0","2","0","0","1","0","1","1","0","1","0","2","0","0","2","0","0","2"
"Bungoma","0.5635","34.56055","3","0","0","0","0","0","0","3","2","1","0","0","3","3","0","0","0","3","0","0","2","0","1","3"
"Bungoma","0.58333","34.58333","3","0","0","0","0","0","0","3","2","1","0","0","3","3","0","0","0","3","0","0","2","0","1","3"
"Bunia","1.55941","30.25224","2","0","0","0","0","0","0","2","1","1","0","0","2","1","1","0","0","2","0","0","1","0","1","2"
"Buntingford","51.94612","-0.01841","1","0","0","0","0","0","0","1","0","0","0","0","0","0","1","0","0","1","0","1","0","0","0","1"
"Buol","1.1584","121.4361","1","0","0","0","0","0","0","1","0","0","0","0","0","0","0","1","0","1","0","0","0","0","1","1"
"Buôn Ma Thuột","12.66747","108.03775","2","0","0","0","0","0","0","2","0","1","0","0","1","1","0","1","0","2","1","0","1","0","0","2"
"Buqan","42.55806","20.45278","1","0","0","0","0","0","0","1","1","0","0","0","1","0","0","1","0","1","0","0","1","0","0","1"
"Burao","9.52213","45.53363","4","0","0","0","0","0","0","4","1","0","0","2","3","3","0","0","1","4","2","0","1","0","1","4"
"Buraydah","26.32599","43.97497","5","0","0","0","0","0","0","5","0","3","0","0","3","0","3","2","0","5","4","0","0","0","1","5"
"Bures Saint Mary","51.9724","0.77488","2","0","0","1","0","0","0","3","0","0","1","0","1","1","0","2","0","3","0","1","2","0","0","3"
"Būrewāla","30.16667","72.65","1","0","0","0","0","0","0","1","1","0","0","0","1","0","0","1","0","1","0","0","1","0","0","1"
"Burford","43.10292","-80.42869","1","0","0","0","0","0","0","1","0","0","1","0","1","0","0","1","0","1","0","0","1","0","0","1"
"Burford","51.80915","-1.63628","1","0","0","0","0","0","0","1","0","0","1","0","1","0","0","1","0","1","0","0","1","0","0","1"
"Burgas","42.50606","27.46781","2","0","0","0","0","0","0","2","0","2","0","0","2","0","2","0","0","2","1","0","0","0","1","2"
"Burgess Hill","50.95843","-0.13287","8","0","0","0","2","0","2","12","2","2","6","0","10","5","3","4","0","12","0","4","7","0","1","12"
"Burghead","57.70113","-3.48992","1","0","0","0","0","0","0","1","0","1","0","0","1","0","0","1","0","1","0","1","0","0","0","1"
"Buriton","50.97505","-0.94851","1","0","0","0","0","0","0","1","1","0","0","0","1","0","1","0","0","1","0","0","1","0","0","1"
"Burke","43.1825","-99.29205","1","0","0","0","0","0","0","1","0","0","0","0","0","1","0","0","0","1","0","0","1","0","0","1"
"Burke","31.23185","-94.76854","1","0","0","0","0","0","0","1","0","0","0","0","0","1","0","0","0","1","0","0","1","0","0","1"
"Burke","38.79345","-77.27165","1","0","0","0","0","0","0","1","0","0","0","0","0","1","0","0","0","1","0","0","1","0","0","1"
"Burley in Wharfedale","53.9102","-1.75798","1","0","0","0","0","0","0","1","0","0","0","0","0","0","0","1","0","1","0","1","0","0","0","1"
"Burlington","48.47566","-122.32544","3","0","0","0","0","0","0","3","0","1","2","0","3","2","0","1","0","3","1","0","2","0","0","3"
"Burlington","39.30611","-102.26936","3","0","0","0","0","0","0","3","0","1","2","0","3","2","0","1","0","3","1","0","2","0","0","3"
"Burlington","48.27529","-101.42878","3","0","0","0","0","0","0","3","0","1","2","0","3","2","0","1","0","3","1","0","2","0","0","3"
"Burlington","38.19447","-95.74276","3","0","0","0","0","0","0","3","0","1","2","0","3","2","0","1","0","3","1","0","2","0","0","3"
"Burlington","40.80754","-91.11292","3","0","0","0","0","0","0","3","0","1","2","0","3","2","0","1","0","3","1","0","2","0","0","3"
"Burlington","42.0528","-88.54814","3","0","0","0","0","0","0","3","0","1","2","0","3","2","0","1","0","3","1","0","2","0","0","3"
"Burlington","42.67807","-88.2762","3","0","0","0","0","0","0","3","0","1","2","0","3","2","0","1","0","3","1","0","2","0","0","3"
"Burlington","40.48031","-86.39472","3","0","0","0","0","0","0","3","0","1","2","0","3","2","0","1","0","3","1","0","2","0","0","3"
"Burlington","39.02756","-84.72411","3","0","0","0","0","0","0","3","0","1","2","0","3","2","0","1","0","3","1","0","2","0","0","3"
"Burlington","41.57227","-84.308","3","0","0","0","0","0","0","3","0","1","2","0","3","2","0","1","0","3","1","0","2","0","0","3"
"Burlington","38.4073","-82.53571","3","0","0","0","0","0","0","3","0","1","2","0","3","2","0","1","0","3","1","0","2","0","0","3"
"Burlington","43.38621","-79.83713","3","0","0","0","0","0","0","3","0","1","2","0","3","2","0","1","0","3","1","0","2","0","0","3"
"Burlington","36.09569","-79.4378","3","0","0","0","0","0","0","3","0","1","2","0","3","2","0","1","0","3","1","0","2","0","0","3"
"Burlington","40.07122","-74.86489","3","0","0","0","0","0","0","3","0","1","2","0","3","2","0","1","0","3","1","0","2","0","0","3"
"Burlington","44.47588","-73.21207","3","0","0","0","0","0","0","3","0","1","2","0","3","2","0","1","0","3","1","0","2","0","0","3"
"Burlington","42.50482","-71.19561","3","0","0","0","0","0","0","3","0","1","2","0","3","2","0","1","0","3","1","0","2","0","0","3"
"Burnaby","49.26636","-122.95263","1","0","0","1","1","0","0","3","1","1","0","0","2","1","1","1","0","3","0","1","2","0","0","3"
"Burnham-on-Crouch","51.63272","0.81488","1","0","0","0","1","0","0","2","0","1","1","0","2","1","0","1","0","2","0","0","2","0","0","2"
"Burnham-on-Sea","51.23862","-2.9978","1","0","0","0","0","0","0","1","0","0","1","0","1","0","0","1","0","1","0","0","1","0","0","1"
"Burnley","53.8","-2.23333","21","0","0","0","4","0","2","27","3","11","11","0","25","9","5","13","0","27","6","10","10","0","1","27"
"Burnley","-37.82959","145.01732","21","0","0","0","4","0","2","27","3","11","11","0","25","9","5","13","0","27","6","10","10","0","1","27"
"Burntisland","56.05865","-3.23664","4","0","0","0","0","0","0","4","1","0","3","0","4","2","0","2","0","4","0","3","1","0","0","4"
"Burntwood","52.68075","-1.92759","6","1","0","0","0","0","0","7","1","3","2","0","6","4","2","1","0","7","5","0","2","0","0","7"
"Burry Port","51.68435","-4.24687","3","0","0","1","1","0","0","5","2","2","1","0","5","1","2","2","0","5","2","1","2","0","0","5"
"Bursa","40.19559","29.06013","2","0","0","1","0","0","0","3","0","0","1","0","1","1","2","0","0","3","2","1","0","0","0","3"
"Burscough","53.5964","-2.83972","0","1","0","0","1","0","0","2","0","0","1","0","1","1","1","0","0","2","0","1","1","0","0","2"
"Bursledon","50.88658","-1.31596","1","0","0","0","0","0","0","1","0","0","1","0","1","1","0","0","0","1","0","0","1","0","0","1"
"Burton","42.99947","-83.61634","7","0","0","1","2","0","1","11","4","2","3","0","9","4","1","6","0","11","2","4","5","0","0","11"
"Burton","41.47061","-81.1451","7","0","0","1","2","0","1","11","4","2","3","0","9","4","1","6","0","11","2","4","5","0","0","11"
"Burton","32.43575","-80.724","7","0","0","1","2","0","1","11","4","2","3","0","9","4","1","6","0","11","2","4","5","0","0","11"
"Burton","51.71556","-4.92222","7","0","0","1","2","0","1","11","4","2","3","0","9","4","1","6","0","11","2","4","5","0","0","11"
"Burton","53.25954","-3.02549","7","0","0","1","2","0","1","11","4","2","3","0","9","4","1","6","0","11","2","4","5","0","0","11"
"Burton","53.26667","-0.56667","7","0","0","1","2","0","1","11","4","2","3","0","9","4","1","6","0","11","2","4","5","0","0","11"
"Burton","-34.73339","138.60247","7","0","0","1","2","0","1","11","4","2","3","0","9","4","1","6","0","11","2","4","5","0","0","11"
"Burton Latimer","52.36368","-0.67853","1","0","0","0","0","0","0","1","0","0","1","0","1","0","1","0","0","1","0","0","1","0","0","1"
"Burton Leonard","54.0691","-1.50116","0","0","0","0","1","0","0","1","0","0","1","0","1","0","0","1","0","1","0","1","0","0","0","1"
"Burton upon Trent","52.80728","-1.64263","8","1","0","2","1","0","0","12","3","1","4","0","8","2","3","7","0","12","3","2","7","0","0","12"
"Burwell","41.78167","-99.13315","2","0","0","0","0","0","0","2","0","1","1","0","2","0","1","1","0","2","0","1","1","0","0","2"
"Burwell","53.29305","0.03463","2","0","0","0","0","0","0","2","0","1","1","0","2","0","1","1","0","2","0","1","1","0","0","2"
"Burwell","52.27632","0.32732","2","0","0","0","0","0","0","2","0","1","1","0","2","0","1","1","0","2","0","1","1","0","0","2"
"Bury","53.6","-2.3","12","0","0","0","2","0","1","15","1","3","5","0","9","7","0","8","0","15","5","1","9","0","0","15"
"Bury","49.31307","2.34401","12","0","0","0","2","0","1","15","1","3","5","0","9","7","0","8","0","15","5","1","9","0","0","15"
"Bury St Edmunds","52.2463","0.71111","16","0","0","0","1","0","0","17","1","5","9","0","15","4","3","10","0","17","3","4","10","0","0","17"
"Bushat","42.11944","19.89972","1","0","0","0","0","0","0","1","1","0","0","0","1","1","0","0","0","1","0","0","1","0","0","1"
"Bushenyi","-0.53695","30.18579","1","0","0","0","0","0","0","1","0","0","1","0","1","1","0","0","0","1","0","0","1","0","0","1"
"Bushey","51.64316","-0.36053","8","0","0","0","0","0","1","9","3","0","1","0","4","4","1","4","0","9","1","2","6","0","0","9"
"Busia","0.46588","34.09221","2","0","0","0","0","0","0","2","0","0","0","0","0","1","0","1","0","2","1","0","0","0","1","2"
"Busia","0.46005","34.11169","2","0","0","0","0","0","0","2","0","0","0","0","0","1","0","1","0","2","1","0","0","0","1","2"
"Busto Arsizio","45.61128","8.84914","0","0","0","0","1","0","0","1","0","0","0","0","0","1","0","0","0","1","0","0","0","1","0","1"
"Butajīra","8.11667","38.36667","1","0","0","0","0","0","0","1","1","0","0","0","1","1","0","0","0","1","0","1","0","0","0","1"
"Butaleja","0.91194","33.95111","1","0","0","0","0","0","0","1","0","0","0","0","0","0","1","0","0","1","0","0","1","0","0","1"
"Butare","-2.59667","29.73944","2","0","0","0","0","0","0","2","1","0","0","1","2","0","0","0","1","1","0","0","1","0","0","1"
"Butembo","0.14164","29.29117","1","0","0","0","0","0","0","1","0","0","1","0","1","0","1","0","0","1","0","0","1","0","0","1"
"Butere","0.20694","34.49006","1","0","0","0","0","0","0","1","0","1","0","0","1","0","1","0","0","1","0","0","0","0","1","1"
"Butha-Buthe","-28.76659","28.24937","1","0","0","0","0","0","0","1","0","0","0","0","0","1","0","0","0","1","1","0","0","0","0","1"
"Butterworth","-32.33083","28.14981","1","0","0","0","0","0","0","1","1","0","0","0","1","0","0","0","1","1","0","0","1","0","0","1"
"Butterworth","5.3991","100.36382","1","0","0","0","0","0","0","1","1","0","0","0","1","0","0","0","1","1","0","0","1","0","0","1"
"Butuan","8.94917","125.54361","1","0","0","0","0","0","0","1","0","0","0","0","0","0","0","1","0","1","0","0","1","0","0","1"
"Butwāl","27.70055","83.44836","22","1","0","0","0","0","0","23","14","2","1","1","18","5","5","12","1","23","1","3","18","0","0","22"
"Buxton","35.26768","-75.54237","7","0","0","1","1","0","1","10","1","1","6","0","8","3","0","6","1","10","0","2","7","0","1","10"
"Buxton","43.63786","-70.51894","7","0","0","1","1","0","1","10","1","1","6","0","8","3","0","6","1","10","0","2","7","0","1","10"
"Buxton","53.25741","-1.90982","7","0","0","1","1","0","1","10","1","1","6","0","8","3","0","6","1","10","0","2","7","0","1","10"
"Buxton","52.75255","1.29982","7","0","0","1","1","0","1","10","1","1","6","0","8","3","0","6","1","10","0","2","7","0","1","10"
"Buxton","-34.26017","150.53288","7","0","0","1","1","0","1","10","1","1","6","0","8","3","0","6","1","10","0","2","7","0","1","10"
"Bweyogerere","0.35773","32.66332","1","0","0","0","0","0","0","1","0","1","0","0","1","0","1","0","0","1","0","0","1","0","0","1"
"Bydgoszcz","53.1235","18.00762","1","0","0","0","0","0","0","1","1","0","0","0","1","0","0","1","0","1","1","0","0","0","0","1"
"Byfleet","51.34018","-0.47254","2","0","0","0","1","0","0","3","0","1","2","0","3","0","1","1","1","3","1","1","1","0","0","3"
"Byumba","-1.5763","30.0675","0","1","0","0","0","0","0","1","1","0","0","0","1","0","0","1","0","1","0","0","1","0","0","1"
"Cabanatuan City","15.48586","120.96648","1","0","0","0","0","0","0","1","1","0","0","0","1","0","1","0","0","1","0","0","1","0","0","1"
"Cabra Número Uno","9.10863","-79.33694","1","0","0","0","0","0","0","1","0","0","0","1","1","0","0","0","1","1","0","1","0","0","0","1"
"Cabrobó","-8.51417","-39.31","1","0","0","0","0","0","0","1","1","0","0","0","1","0","0","1","0","1","0","0","1","0","0","1"
"Cachan","48.79632","2.33661","0","1","0","0","0","0","0","1","1","0","0","0","1","0","1","0","0","1","0","0","1","0","0","1"
"Caddington","51.86621","-0.45679","2","0","0","0","0","0","0","2","0","0","2","0","2","0","0","2","0","2","0","1","1","0","0","2"
"Caerleon","51.60952","-2.95378","0","0","0","1","0","0","0","1","1","0","0","0","1","0","0","1","0","1","0","1","0","0","0","1"
"Caernarfon","53.14126","-4.27016","6","1","0","0","2","0","0","9","1","4","2","1","8","2","4","3","0","9","2","3","3","0","1","9"
"Caerphilly","51.57452","-3.218","30","0","0","0","2","0","1","33","5","18","9","0","32","17","3","13","0","33","13","3","17","0","0","33"
"Caersws","52.51634","-3.42948","1","0","0","0","0","0","0","1","0","0","1","0","1","0","0","1","0","1","0","1","0","0","0","1"
"Cagliari","39.23054","9.11917","1","0","0","0","0","0","0","1","0","1","0","0","1","0","1","0","0","1","1","0","0","0","0","1"
"Cahir","52.37694","-7.92167","1","0","0","0","0","0","0","1","0","1","0","0","1","1","0","0","0","1","0","0","1","0","0","1"
"Cahul","45.90425","28.19929","1","0","0","0","0","0","0","1","0","0","0","1","1","1","0","0","0","1","0","0","1","0","0","1"
"Čair","42.01528","21.44111","1","0","0","0","0","0","0","1","0","0","1","0","1","0","0","1","0","1","0","0","0","0","1","1"
"Cairo","41.00112","-98.60757","100","7","0","1","13","0","5","126","33","34","17","9","93","50","33","39","4","126","45","13","51","11","7","127"
"Cairo","37.00533","-89.17646","100","7","0","1","13","0","5","126","33","34","17","9","93","50","33","39","4","126","45","13","51","11","7","127"
"Cairo","30.87751","-84.20214","100","7","0","1","13","0","5","126","33","34","17","9","93","50","33","39","4","126","45","13","51","11","7","127"
"Cairo","40.832","-84.08606","100","7","0","1","13","0","5","126","33","34","17","9","93","50","33","39","4","126","45","13","51","11","7","127"
"Cairo","42.29897","-73.99847","100","7","0","1","13","0","5","126","33","34","17","9","93","50","33","39","4","126","45","13","51","11","7","127"
"Cairo","30.06263","31.24967","100","7","0","1","13","0","5","126","33","34","17","9","93","50","33","39","4","126","45","13","51","11","7","127"
"Calabar","4.95893","8.32695","4","0","0","0","0","0","0","4","0","0","3","1","4","0","0","4","0","4","0","1","2","1","0","4"
"Calabozo","8.92416","-67.42929","1","0","0","0","0","0","0","1","0","0","0","0","0","1","0","0","0","1","1","0","0","0","0","1"
"Calais","45.18376","-67.27662","1","0","0","0","0","0","0","1","0","0","0","0","0","0","0","1","0","1","0","0","1","0","0","1"
"Calais","50.95194","1.85635","1","0","0","0","0","0","0","1","0","0","0","0","0","0","0","1","0","1","0","0","1","0","0","1"
"Calamba","14.21167","121.16528","3","0","0","0","0","0","0","3","1","1","1","0","3","2","0","1","0","3","0","2","1","0","0","3"
"Calamba","10.1755","123.2826","3","0","0","0","0","0","0","3","1","1","1","0","3","2","0","1","0","3","0","2","1","0","0","3"
"Calamba","8.5587","123.6425","3","0","0","0","0","0","0","3","1","1","1","0","3","2","0","1","0","3","0","2","1","0","0","3"
"Calamba","9.10361","125.59417","3","0","0","0","0","0","0","3","1","1","1","0","3","2","0","1","0","3","0","2","1","0","0","3"
"Călan","45.73333","22.98333","0","1","0","0","0","0","0","1","0","0","1","0","1","0","0","1","0","1","0","0","1","0","0","1"
"Caldercruix","55.88886","-3.88664","2","0","0","0","0","0","0","2","0","1","1","0","2","1","0","1","0","2","0","0","2","0","0","2"
"Caldicot","51.58661","-2.75736","5","0","0","0","0","0","1","6","0","3","3","0","6","0","1","5","0","6","1","3","2","0","0","6"
"Calgary","51.05011","-114.08529","23","2","0","0","0","0","0","25","4","8","10","1","23","11","3","9","2","25","4","7","13","1","0","25"
"Cali","3.43722","-76.5225","6","0","0","0","0","0","0","6","3","3","0","0","6","4","0","2","0","6","3","0","2","1","0","6"
"Callington","50.50147","-4.31314","0","1","0","0","0","0","0","1","0","1","0","0","1","1","0","0","0","1","0","1","0","0","0","1"
"Callington","-35.11977","139.0414","0","1","0","0","0","0","0","1","0","1","0","0","1","1","0","0","0","1","0","1","0","0","0","1"
"Calne","51.43879","-2.00571","4","0","0","0","0","0","0","4","0","3","0","0","3","2","0","2","0","4","1","0","3","0","0","4"
"Calp","38.6447","0.0445","0","0","0","0","1","0","0","1","0","0","0","0","0","1","0","0","0","1","0","0","1","0","0","1"
"Camberley","51.33705","-0.74261","18","0","0","1","3","0","0","22","7","5","9","0","21","5","3","14","0","22","4","8","9","0","1","22"
"Camborne","50.21306","-5.29731","2","0","0","0","0","0","0","2","0","0","1","0","1","0","0","2","0","2","1","1","0","0","0","2"
"Cambourne","52.22115","-0.07025","1","0","0","0","0","0","0","1","0","1","0","0","1","1","0","0","0","1","1","0","0","0","0","1"
"Cambridge","40.28195","-100.16569","66","2","0","4","4","0","8","84","15","17","33","2","67","27","15","42","1","85","6","14","59","1","4","84"
"Cambridge","41.89832","-93.5291","66","2","0","4","4","0","8","84","15","17","33","2","67","27","15","42","1","85","6","14","59","1","4","84"
"Cambridge","45.57274","-93.22439","66","2","0","4","4","0","8","84","15","17","33","2","67","27","15","42","1","85","6","14","59","1","4","84"
"Cambridge","41.30365","-90.1929","66","2","0","4","4","0","8","84","15","17","33","2","67","27","15","42","1","85","6","14","59","1","4","84"
"Cambridge","43.00361","-89.0165","66","2","0","4","4","0","8","84","15","17","33","2","67","27","15","42","1","85","6","14","59","1","4","84"
"Cambridge","40.03118","-81.58846","66","2","0","4","4","0","8","84","15","17","33","2","67","27","15","42","1","85","6","14","59","1","4","84"
"Cambridge","43.3601","-80.31269","66","2","0","4","4","0","8","84","15","17","33","2","67","27","15","42","1","85","6","14","59","1","4","84"
"Cambridge","18.31326","-77.90252","66","2","0","4","4","0","8","84","15","17","33","2","67","27","15","42","1","85","6","14","59","1","4","84"
"Cambridge","38.56317","-76.07883","66","2","0","4","4","0","8","84","15","17","33","2","67","27","15","42","1","85","6","14","59","1","4","84"
"Cambridge","43.02813","-73.38122","66","2","0","4","4","0","8","84","15","17","33","2","67","27","15","42","1","85","6","14","59","1","4","84"
"Cambridge","42.3751","-71.10561","66","2","0","4","4","0","8","84","15","17","33","2","67","27","15","42","1","85","6","14","59","1","4","84"
"Cambridge","45.02422","-69.47394","66","2","0","4","4","0","8","84","15","17","33","2","67","27","15","42","1","85","6","14","59","1","4","84"
"Cambridge","52.2","0.11667","66","2","0","4","4","0","8","84","15","17","33","2","67","27","15","42","1","85","6","14","59","1","4","84"
"Cambridge","-42.83333","147.45","66","2","0","4","4","0","8","84","15","17","33","2","67","27","15","42","1","85","6","14","59","1","4","84"
"Cambridge","-37.87822","175.4402","66","2","0","4","4","0","8","84","15","17","33","2","67","27","15","42","1","85","6","14","59","1","4","84"
"Cambrils","41.06997","1.05949","1","0","0","0","0","0","0","1","0","0","0","0","0","0","0","1","0","1","1","0","0","0","0","1"
"Cambuslang","55.80966","-4.16096","2","0","0","0","0","0","0","2","1","1","0","0","2","0","1","1","0","2","1","1","0","0","0","2"
"Camden Town","51.54057","-0.14334","3","0","0","0","0","0","0","3","1","0","0","0","1","1","0","2","0","3","0","1","2","0","0","3"
"Camelford","50.62185","-4.67963","2","0","0","0","0","0","0","2","0","1","1","0","2","1","0","1","0","2","0","2","0","0","0","2"
"Camooweal","-19.92154","138.12013","1","0","0","0","0","0","0","1","0","0","0","0","0","1","0","0","0","1","0","0","0","0","1","1"
"Campbell River","50.01634","-125.24459","1","0","0","0","0","0","0","1","0","1","0","0","1","0","0","1","0","1","1","0","0","0","0","1"
"Câmpeni","46.36667","23.05","1","0","0","0","0","0","0","1","1","0","0","0","1","0","0","1","0","1","0","0","1","0","0","1"
"Câmpeni","44.36764","24.01504","1","0","0","0","0","0","0","1","1","0","0","0","1","0","0","1","0","1","0","0","1","0","0","1"
"Câmpeni","46.60061","26.62738","1","0","0","0","0","0","0","1","1","0","0","0","1","0","0","1","0","1","0","0","1","0","0","1"
"Câmpeni","47.50625","26.99522","1","0","0","0","0","0","0","1","1","0","0","0","1","0","0","1","0","1","0","0","1","0","0","1"
"Câmpina","45.12619","25.73496","1","0","0","0","0","0","0","1","0","0","0","0","0","1","0","0","0","1","1","0","0","0","0","1"
"Campinas","-27.59444","-48.60694","2","0","0","0","0","0","0","2","1","0","1","0","2","0","1","1","0","2","0","1","1","0","0","2"
"Campinas","-22.90556","-47.06083","2","0","0","0","0","0","0","2","1","0","1","0","2","0","1","1","0","2","0","1","1","0","0","2"
"Campobasso","41.55947","14.66737","1","0","0","0","0","0","0","1","0","1","0","0","1","0","0","1","0","1","1","0","0","0","0","1"
"Campo Limpo Paulista","-23.20639","-46.78444","1","0","0","0","0","0","0","1","1","0","0","0","1","1","0","0","0","1","1","0","0","0","0","1"
"Camporeale","37.88612","13.10107","1","0","0","0","0","0","0","1","0","1","0","0","1","0","0","1","0","1","1","0","0","0","0","1"
"Campos dos Goytacazes","-21.75227","-41.33044","1","0","0","0","0","0","0","1","0","0","0","0","0","0","1","0","0","1","1","0","0","0","0","1"
"Çanakkale","40.15552","26.41271","1","0","0","0","0","0","0","1","0","0","1","0","1","0","0","1","0","1","0","0","1","0","0","1"
"Canberra","-35.28346","149.12807","2","0","0","0","0","0","0","2","0","0","0","1","1","1","1","0","0","2","2","0","0","0","0","2"
"Canewdon","51.61759","0.74458","1","0","0","0","0","0","0","1","0","1","0","0","1","1","0","0","0","1","0","0","1","0","0","1"
"Canmore","51.08335","-115.35206","1","0","0","0","0","0","0","1","1","0","0","0","1","1","0","0","0","1","0","0","1","0","0","1"
"Cannock","52.69045","-2.03085","10","4","0","0","0","0","2","16","6","5","3","1","15","4","3","9","0","16","4","5","7","0","0","16"
"Canterbury","43.33702","-71.56535","13","2","1","0","2","0","2","20","4","3","10","0","17","3","4","12","1","20","2","4","14","0","0","20"
"Canterbury","51.27904","1.07992","13","2","1","0","2","0","2","20","4","3","10","0","17","3","4","12","1","20","2","4","14","0","0","20"
"Canterbury","-37.8247","145.08476","13","2","1","0","2","0","2","20","4","3","10","0","17","3","4","12","1","20","2","4","14","0","0","20"
"Canterbury","-33.91192","151.11862","13","2","1","0","2","0","2","20","4","3","10","0","17","3","4","12","1","20","2","4","14","0","0","20"
"Cần Thơ","10.03711","105.78825","3","0","0","0","0","0","0","3","0","1","1","0","2","3","0","0","0","3","1","0","2","0","0","3"
"Canton","36.05365","-98.58842","1","0","0","0","0","0","1","2","1","0","1","0","2","0","1","1","0","2","1","0","1","0","0","2"
"Canton","38.38612","-97.42809","1","0","0","0","0","0","1","2","1","0","1","0","2","0","1","1","0","2","1","0","1","0","0","2"
"Canton","43.30081","-96.59282","1","0","0","0","0","0","1","2","1","0","1","0","2","0","1","1","0","2","1","0","1","0","0","2"
"Canton","32.55652","-95.8633","1","0","0","0","0","0","1","2","1","0","1","0","2","0","1","1","0","2","1","0","1","0","0","2"
"Canton","40.1295","-91.51852","1","0","0","0","0","0","1","2","1","0","1","0","2","0","1","1","0","2","1","0","1","0","0","2"
"Canton","32.61264","-90.03675","1","0","0","0","0","0","1","2","1","0","1","0","2","0","1","1","0","2","1","0","1","0","0","2"
"Canton","40.55809","-90.03512","1","0","0","0","0","0","1","2","1","0","1","0","2","0","1","1","0","2","1","0","1","0","0","2"
"Canton","34.23676","-84.49076","1","0","0","0","0","0","1","2","1","0","1","0","2","0","1","1","0","2","1","0","1","0","0","2"
"Canton","42.30865","-83.48216","1","0","0","0","0","0","1","2","1","0","1","0","2","0","1","1","0","2","1","0","1","0","0","2"
"Canton","35.53288","-82.83736","1","0","0","0","0","0","1","2","1","0","1","0","2","0","1","1","0","2","1","0","1","0","0","2"
"Canton","40.79895","-81.37845","1","0","0","0","0","0","1","2","1","0","1","0","2","0","1","1","0","2","1","0","1","0","0","2"
"Canton","41.65646","-76.85329","1","0","0","0","0","0","1","2","1","0","1","0","2","0","1","1","0","2","1","0","1","0","0","2"
"Canton","44.59562","-75.16909","1","0","0","0","0","0","1","2","1","0","1","0","2","0","1","1","0","2","1","0","1","0","0","2"
"Canton","42.15843","-71.14477","1","0","0","0","0","0","1","2","1","0","1","0","2","0","1","1","0","2","1","0","1","0","0","2"
"Canton","44.4408","-70.31649","1","0","0","0","0","0","1","2","1","0","1","0","2","0","1","1","0","2","1","0","1","0","0","2"
"Canvey Island","51.52199","0.5809","1","0","0","2","0","0","0","3","2","0","0","0","2","1","0","2","0","3","1","0","2","0","0","3"
"Capaccio","40.42435","15.07981","1","0","0","0","0","0","0","1","0","1","0","0","1","0","0","1","0","1","0","0","1","0","0","1"
"Cape Coast","5.10535","-1.2466","2","0","0","0","0","0","0","2","0","2","0","0","2","2","0","0","0","2","2","0","0","0","0","2"
"Cape Town","-33.92584","18.42322","19","0","0","0","4","0","1","24","3","11","4","0","18","12","6","3","3","24","12","2","9","0","1","24"
"Caracas","10.48801","-66.87919","6","3","0","0","0","0","0","9","5","1","2","0","8","3","2","4","0","9","2","1","6","0","0","9"
"Caravaca","38.10558","-1.86343","1","0","0","0","0","0","0","1","0","1","0","0","1","0","1","0","0","1","1","0","0","0","0","1"
"Cardenden","56.1431","-3.25687","1","0","0","0","0","0","0","1","0","0","1","0","1","0","0","1","0","1","0","0","1","0","0","1"
"Cardiff","51.48","-3.18","197","6","1","8","14","0","17","243","49","79","101","2","231","76","28","137","1","242","54","54","127","0","6","241"
"Cardiff","-32.94201","151.6544","197","6","1","8","14","0","17","243","49","79","101","2","231","76","28","137","1","242","54","54","127","0","6","241"
"Cardigan","52.08373","-4.66228","4","0","0","0","1","0","0","5","1","2","2","0","5","1","1","3","0","5","2","2","1","0","0","5"
"Cardigan","-37.53333","143.75","4","0","0","0","1","0","0","5","1","2","2","0","5","1","1","3","0","5","2","2","1","0","0","5"
"Carlingford","54.04","-6.18833","2","0","0","0","0","0","0","2","0","0","2","0","2","0","0","2","0","2","0","2","0","0","0","2"
"Carlingford","-33.78269","151.04888","2","0","0","0","0","0","0","2","0","0","2","0","2","0","0","2","0","2","0","2","0","0","0","2"
"Carlisle","35.50065","-95.02634","24","0","0","0","4","0","1","29","5","18","4","0","27","12","5","12","0","29","13","3","12","1","0","29"
"Carlisle","41.50082","-93.49105","24","0","0","0","4","0","1","29","5","18","4","0","27","12","5","12","0","29","13","3","12","1","0","29"
"Carlisle","34.78315","-91.74652","24","0","0","0","4","0","1","29","5","18","4","0","27","12","5","12","0","29","13","3","12","1","0","29"
"Carlisle","38.96838","-87.40557","24","0","0","0","4","0","1","29","5","18","4","0","27","12","5","12","0","29","13","3","12","1","0","29"
"Carlisle","39.582","-84.32022","24","0","0","0","4","0","1","29","5","18","4","0","27","12","5","12","0","29","13","3","12","1","0","29"
"Carlisle","38.31202","-84.02743","24","0","0","0","4","0","1","29","5","18","4","0","27","12","5","12","0","29","13","3","12","1","0","29"
"Carlisle","40.20148","-77.18887","24","0","0","0","4","0","1","29","5","18","4","0","27","12","5","12","0","29","13","3","12","1","0","29"
"Carlisle","42.52926","-71.3495","24","0","0","0","4","0","1","29","5","18","4","0","27","12","5","12","0","29","13","3","12","1","0","29"
"Carlisle","17.13226","-61.80356","24","0","0","0","4","0","1","29","5","18","4","0","27","12","5","12","0","29","13","3","12","1","0","29"
"Carlisle","54.8951","-2.9382","24","0","0","0","4","0","1","29","5","18","4","0","27","12","5","12","0","29","13","3","12","1","0","29"
"Carlisle","-31.97945","115.91808","24","0","0","0","4","0","1","29","5","18","4","0","27","12","5","12","0","29","13","3","12","1","0","29"
"Carlow","52.84083","-6.92611","1","0","0","0","0","0","0","1","0","0","1","0","1","0","0","1","0","1","1","0","0","0","0","1"
"Carlow","53.75861","10.93789","1","0","0","0","0","0","0","1","0","0","1","0","1","0","0","1","0","1","1","0","0","0","0","1"
"Carlsbad","33.15809","-117.35059","2","0","0","0","0","0","0","2","0","0","0","0","0","1","0","1","0","2","0","1","1","0","0","2"
"Carlsbad","32.42067","-104.22884","2","0","0","0","0","0","0","2","0","0","0","0","0","1","0","1","0","2","0","1","1","0","0","2"
"Carlsbad","31.60543","-100.64343","2","0","0","0","0","0","0","2","0","0","0","0","0","1","0","1","0","2","0","1","1","0","0","2"
"Carlton","45.29428","-123.17649","1","0","0","0","0","0","0","1","0","0","1","0","1","0","1","0","0","1","0","1","0","0","0","1"
"Carlton","46.67576","-114.07872","1","0","0","0","0","0","0","1","0","0","1","0","1","0","1","0","0","1","0","1","0","0","0","1"
"Carlton","46.66383","-92.42491","1","0","0","0","0","0","0","1","0","0","1","0","1","0","1","0","0","1","0","1","0","0","0","1"
"Carlton","54.59004","-1.39117","1","0","0","0","0","0","0","1","0","0","1","0","1","0","1","0","0","1","0","1","0","0","0","1"
"Carlton","52.18801","-0.60704","1","0","0","0","0","0","0","1","0","0","1","0","1","0","1","0","0","1","0","1","0","0","0","1"
"Carlton","-37.8","144.96667","1","0","0","0","0","0","0","1","0","0","1","0","1","0","1","0","0","1","0","1","0","0","0","1"
"Carlton","-42.86196","147.65523","1","0","0","0","0","0","0","1","0","0","1","0","1","0","1","0","0","1","0","1","0","0","0","1"
"Carlton","-33.97107","151.12136","1","0","0","0","0","0","0","1","0","0","1","0","1","0","1","0","0","1","0","1","0","0","0","1"
"Carmarthen","51.85552","-4.30535","18","1","0","2","1","0","0","22","4","5","8","0","17","8","5","9","0","22","7","10","5","0","0","22"
"Carmel","39.97837","-86.11804","1","0","0","0","0","0","0","1","0","1","0","0","1","1","0","0","0","1","1","0","0","0","0","1"
"Carmel","41.43009","-73.68013","1","0","0","0","0","0","0","1","0","1","0","0","1","1","0","0","0","1","1","0","0","0","0","1"
"Carmel","44.79757","-69.05115","1","0","0","0","0","0","0","1","0","1","0","0","1","1","0","0","0","1","1","0","0","0","0","1"
"Carmel","-32.01667","116.1","1","0","0","0","0","0","0","1","0","1","0","0","1","1","0","0","0","1","1","0","0","0","0","1"
"Carnegie","35.10367","-98.60367","1","0","0","0","0","0","0","1","0","0","1","0","1","1","0","0","0","1","0","0","1","0","0","1"
"Carnegie","40.40868","-80.08339","1","0","0","0","0","0","0","1","0","0","1","0","1","1","0","0","0","1","0","0","1","0","0","1"
"Carnegie","-37.89359","145.05534","1","0","0","0","0","0","0","1","0","0","1","0","1","1","0","0","0","1","0","0","1","0","0","1"
"Carnforth","54.13163","-2.76914","2","0","0","0","0","0","0","2","0","0","2","0","2","2","0","0","0","2","1","1","0","0","0","2"
"Carnoustie","56.50263","-2.7053","0","0","0","0","1","0","0","1","0","0","1","0","1","0","0","1","0","1","0","1","0","0","0","1"
"Carnwath","55.70036","-3.62579","1","0","0","0","0","0","0","1","0","0","0","0","0","1","0","0","0","1","0","0","1","0","0","1"
"Caronno Pertusella","45.59777","9.04634","1","0","0","0","0","0","0","1","0","1","0","0","1","0","0","1","0","1","1","0","0","0","0","1"
"Carrollton","32.95373","-96.89028","1","0","0","0","0","0","0","1","0","0","1","0","1","0","1","0","0","1","0","0","1","0","0","1"
"Carrollton","39.35835","-93.49577","1","0","0","0","0","0","0","1","0","0","1","0","1","0","1","0","0","1","0","0","1","0","0","1"
"Carrollton","39.30227","-90.40706","1","0","0","0","0","0","0","1","0","0","1","0","1","0","1","0","0","1","0","0","1","0","0","1"
"Carrollton","33.50818","-89.92036","1","0","0","0","0","0","0","1","0","0","1","0","1","0","1","0","0","1","0","0","1","0","0","1"
"Carrollton","33.26169","-88.09503","1","0","0","0","0","0","0","1","0","0","1","0","1","0","1","0","0","1","0","0","1","0","0","1"
"Carrollton","38.6809","-85.1794","1","0","0","0","0","0","0","1","0","0","1","0","1","0","1","0","0","1","0","0","1","0","0","1"
"Carrollton","33.58011","-85.07661","1","0","0","0","0","0","0","1","0","0","1","0","1","0","1","0","0","1","0","0","1","0","0","1"
"Carrollton","43.45864","-83.93025","1","0","0","0","0","0","0","1","0","0","1","0","1","0","1","0","0","1","0","0","1","0","0","1"
"Carrollton","40.57284","-81.08565","1","0","0","0","0","0","0","1","0","0","1","0","1","0","1","0","0","1","0","0","1","0","0","1"
"Carrollton","36.94682","-76.56051","1","0","0","0","0","0","0","1","0","0","1","0","1","0","1","0","0","1","0","0","1","0","0","1"
"Carshalton","51.36829","-0.16755","9","0","0","0","0","0","0","9","1","3","4","0","8","4","2","3","0","9","1","3","5","0","0","9"
"Cartagena","10.39972","-75.51444","1","0","0","0","0","0","0","1","0","0","1","0","1","0","0","1","0","1","0","0","1","0","0","1"
"Cartagena","-33.55384","-71.60761","1","0","0","0","0","0","0","1","0","0","1","0","1","0","0","1","0","1","0","0","1","0","0","1"
"Cartagena","37.60512","-0.98623","1","0","0","0","0","0","0","1","0","0","1","0","1","0","0","1","0","1","0","0","1","0","0","1"
"Cartagena","9.8203","122.4004","1","0","0","0","0","0","0","1","0","0","1","0","1","0","0","1","0","1","0","0","1","0","0","1"
"Carterton","51.75905","-1.59435","3","0","0","0","0","0","2","5","1","3","1","0","5","1","1","3","0","5","2","0","2","0","1","5"
"Carthage","32.15738","-94.33742","2","0","0","0","0","0","0","2","0","2","0","0","2","0","1","1","0","2","2","0","0","0","0","2"
"Carthage","37.17645","-94.31022","2","0","0","0","0","0","0","2","0","2","0","0","2","0","1","1","0","2","2","0","0","0","0","2"
"Carthage","40.41643","-91.13625","2","0","0","0","0","0","0","2","0","2","0","0","2","0","1","1","0","2","2","0","0","0","0","2"
"Carthage","32.73264","-89.53618","2","0","0","0","0","0","0","2","0","2","0","0","2","0","1","1","0","2","2","0","0","0","0","2"
"Carthage","41.91892","-89.31371","2","0","0","0","0","0","0","2","0","2","0","0","2","0","1","1","0","2","2","0","0","0","0","2"
"Carthage","36.25228","-85.95165","2","0","0","0","0","0","0","2","0","2","0","0","2","0","1","1","0","2","2","0","0","0","0","2"
"Carthage","39.73838","-85.57192","2","0","0","0","0","0","0","2","0","2","0","0","2","0","1","1","0","2","2","0","0","0","0","2"
"Carthage","35.34599","-79.41697","2","0","0","0","0","0","0","2","0","2","0","0","2","0","1","1","0","2","2","0","0","0","0","2"
"Carthage","43.97812","-75.60936","2","0","0","0","0","0","0","2","0","2","0","0","2","0","1","1","0","2","2","0","0","0","0","2"
"Carthage","44.62423","-70.47312","2","0","0","0","0","0","0","2","0","2","0","0","2","0","1","1","0","2","2","0","0","0","0","2"
"Carthage","36.86108","10.33161","2","0","0","0","0","0","0","2","0","2","0","0","2","0","1","1","0","2","2","0","0","0","0","2"
"Casablanca","33.58831","-7.61138","12","3","0","1","0","0","0","16","9","4","1","1","15","6","4","6","0","16","2","3","8","1","3","17"
"Cascais","38.69681","-9.42147","3","0","0","0","0","0","0","3","0","0","3","0","3","1","1","1","0","3","2","0","1","0","0","3"
"Cassino","41.48581","13.82835","1","0","0","0","0","0","0","1","0","1","0","0","1","0","1","0","0","1","0","0","0","0","1","1"
"Castaic","34.48888","-118.62287","1","0","0","0","0","0","0","1","0","1","0","0","1","0","1","0","0","1","0","0","1","0","0","1"
"Castelnaudary","43.31829","1.95449","1","0","0","0","0","0","0","1","0","1","0","0","1","1","0","0","0","1","1","0","0","0","0","1"
"Castel San Pietro Terme","44.39854","11.58546","1","0","0","0","0","0","0","1","1","0","0","0","1","0","0","1","0","1","0","0","1","0","0","1"
"Castlebar","53.85","-9.3","1","0","0","0","1","0","0","2","1","0","1","0","2","1","0","1","0","2","0","1","1","0","0","2"
"Castle Cary","51.09","-2.51417","1","0","0","0","0","0","1","2","0","0","2","0","2","0","0","2","0","2","0","1","1","0","0","2"
"Castlederg","54.70699","-7.59336","1","0","0","0","0","0","0","1","0","1","0","0","1","0","1","0","0","1","1","0","0","0","0","1"
"Castle Donington","52.84291","-1.34188","1","0","0","0","0","0","0","1","0","1","0","0","1","0","0","1","0","1","1","0","0","0","0","1"
"Castle Douglas","54.94095","-3.92784","1","0","0","0","0","0","0","1","0","1","0","0","1","1","0","0","0","1","0","1","0","0","0","1"
"Castleford","53.72587","-1.36256","5","0","0","0","0","0","0","5","1","2","3","0","6","3","0","3","0","6","2","1","3","0","0","6"
"Castle Rock","46.27511","-122.90761","1","0","0","0","0","0","0","1","0","1","0","0","1","1","0","0","0","1","0","0","1","0","0","1"
"Castle Rock","39.37221","-104.85609","1","0","0","0","0","0","0","1","0","1","0","0","1","1","0","0","0","1","0","0","1","0","0","1"
"Castrop-Rauxel","51.55657","7.31155","1","0","0","0","0","0","0","1","0","0","0","0","0","0","1","0","0","1","0","0","1","0","0","1"
"Catanzaro","38.88247","16.60086","1","0","0","0","0","0","0","1","0","0","0","0","0","1","0","0","0","1","0","0","0","0","1","1"
"Caterham","51.2823","-0.07889","7","1","0","1","2","0","0","11","2","4","4","0","10","3","1","6","1","11","2","3","6","0","0","11"
"Catford","51.44491","-0.02043","1","0","0","0","0","0","0","1","0","0","0","0","0","0","1","0","0","1","0","0","0","0","1","1"
"Catterick","54.37542","-1.63328","2","0","0","0","1","0","0","3","0","3","0","0","3","2","0","1","0","3","2","0","0","0","1","3"
"Cầu Giấy","21.03228","105.80073","1","0","0","0","0","0","0","1","1","0","0","0","1","0","0","1","0","1","0","0","1","0","0","1"
"Caulfield","-37.88251","145.02288","2","0","0","0","0","0","0","2","0","1","1","0","2","0","1","1","0","2","1","0","1","0","0","2"
"Caulfield North","-37.8739","145.02485","2","0","0","0","1","0","0","3","0","1","2","0","3","2","0","1","0","3","1","1","1","0","0","3"
"Cavan","53.99083","-7.36056","1","0","0","0","0","0","0","1","0","1","0","0","1","1","0","0","0","1","0","0","1","0","0","1"
"Cavan","48.67242","-3.34606","1","0","0","0","0","0","0","1","0","1","0","0","1","1","0","0","0","1","0","0","1","0","0","1"
"Cavite","15.67785","120.76978","1","0","0","0","0","0","0","1","0","0","0","0","0","0","1","0","0","1","1","0","0","0","0","1"
"Cawood","36.78398","-83.22823","1","0","0","0","0","0","0","1","0","1","0","0","1","0","0","1","0","1","0","0","1","0","0","1"
"Cawood","53.83303","-1.12962","1","0","0","0","0","0","0","1","0","1","0","0","1","0","0","1","0","1","0","0","1","0","0","1"
"Cebu City","10.31672","123.89071","5","0","0","0","0","0","0","5","2","0","0","2","4","3","0","1","1","5","1","2","2","0","0","5"
"Cecil","44.80999","-88.45232","1","0","0","0","0","0","0","1","1","0","0","0","1","0","0","1","0","1","0","0","1","0","0","1"
"Cedar Park","30.5052","-97.82029","2","0","0","0","0","0","0","2","0","0","1","0","1","0","1","1","0","2","0","0","2","0","0","2"
"Celje","46.23092","15.26044","1","0","0","0","0","0","0","1","0","1","0","0","1","0","0","1","0","1","0","0","1","0","0","1"
"Centennial","39.57916","-104.87692","1","0","0","0","0","0","0","1","0","1","0","0","1","0","0","1","0","1","1","0","0","0","0","1"
"Central","37.41665","-113.62441","0","1","0","0","0","0","0","1","0","1","0","0","1","1","0","0","0","1","0","0","1","0","0","1"
"Central","32.86757","-109.79286","0","1","0","0","0","0","0","1","0","1","0","0","1","1","0","0","0","1","0","0","1","0","0","1"
"Central","30.55435","-91.03677","0","1","0","0","0","0","0","1","0","1","0","0","1","1","0","0","0","1","0","0","1","0","0","1"
"Central","35.80369","-89.5373","0","1","0","0","0","0","0","1","0","1","0","0","1","1","0","0","0","1","0","0","1","0","0","1"
"Central","34.72427","-82.78125","0","1","0","0","0","0","0","1","0","1","0","0","1","1","0","0","0","1","0","0","1","0","0","1"
"Central","36.32622","-82.28958","0","1","0","0","0","0","0","1","0","1","0","0","1","1","0","0","0","1","0","0","1","0","0","1"
"Central","22.28299","114.15846","0","1","0","0","0","0","0","1","0","1","0","0","1","1","0","0","0","1","0","0","1","0","0","1"
"Central Falls","41.89066","-71.39228","1","0","0","0","0","0","0","1","1","0","0","0","1","1","0","0","0","1","1","0","0","0","0","1"
"Centre de Flacq","-20.18972","57.71444","3","0","0","0","0","0","0","3","1","0","2","0","3","0","0","3","0","3","0","2","1","0","0","3"
"Centurion","-25.85891","28.18577","0","0","0","0","1","0","0","1","1","0","0","0","1","0","1","0","0","1","0","1","0","0","0","1"
"Cernusco sul Naviglio","45.52526","9.33297","1","0","0","0","1","0","0","2","1","1","0","0","2","0","0","2","0","2","0","1","1","0","0","2"
"Cesena","44.1391","12.24315","2","0","0","0","0","0","0","2","1","0","0","0","1","1","0","1","0","2","1","0","1","0","0","2"
"Cesenatico","44.19987","12.3991","1","0","0","0","0","0","0","1","0","0","0","0","0","0","1","0","0","1","1","0","0","0","0","1"
"Cēsis","57.31188","25.27456","1","0","0","0","0","0","0","1","0","0","0","1","1","0","0","0","1","1","0","0","0","0","0","0"
"Chadiza","-14.06779","32.43917","1","0","0","0","0","0","0","1","0","1","0","0","1","0","0","0","1","1","0","0","1","0","0","1"
"Chafford Hundred","51.4892","0.2944","1","0","0","0","0","0","0","1","0","1","0","0","1","0","1","0","0","1","0","0","1","0","0","1"
"Chak Azam Sahu","30.75202","73.02834","1","0","0","0","0","0","0","1","0","1","0","0","1","1","0","0","0","1","0","0","1","0","0","1"
"Chakwal","32.93286","72.85394","1","0","0","0","0","0","0","1","1","0","0","0","1","1","0","0","0","1","0","0","1","0","0","1"
"Chalatenango","14.03333","-88.93333","1","0","0","0","0","0","0","1","1","0","0","0","1","0","1","0","0","1","0","0","0","1","0","1"
"Chalfont Saint Peter","51.60885","-0.55618","4","0","0","0","1","0","0","5","0","2","1","1","4","1","0","4","0","5","1","2","2","0","0","5"
"Chalfont St Giles","51.63184","-0.57026","4","0","0","0","2","0","0","6","2","0","1","0","3","2","0","4","0","6","0","2","4","0","0","6"
"Chalgrove","51.66476","-1.0764","0","0","0","0","1","0","0","1","0","1","0","0","1","0","0","1","0","1","1","0","0","0","0","1"
"Chama","36.90307","-106.57948","8","0","0","0","0","0","0","8","1","6","1","0","8","2","1","0","5","8","6","0","2","0","0","8"
"Chama","-11.21303","33.1521","8","0","0","0","0","0","0","8","1","6","1","0","8","2","1","0","5","8","6","0","2","0","0","8"
"Chaman","30.91769","66.45259","5","1","0","0","0","0","0","6","1","5","0","0","6","1","5","0","0","6","0","1","5","0","0","6"
"Champaign","40.11642","-88.24338","1","0","0","2","0","0","0","3","0","1","2","0","3","2","0","1","0","3","0","0","3","0","0","3"
"Chandigarh","30.73629","76.7884","2","1","0","0","0","0","0","3","2","0","0","1","3","0","1","2","0","3","0","0","2","0","1","3"
"Chandler","33.30616","-111.84125","0","0","0","0","1","0","0","1","0","1","0","0","1","0","1","0","0","1","1","0","0","0","0","1"
"Chandler","35.70173","-96.88086","0","0","0","0","1","0","0","1","0","1","0","0","1","0","1","0","0","1","1","0","0","0","0","1"
"Chandler","32.30793","-95.47996","0","0","0","0","1","0","0","1","0","1","0","0","1","0","1","0","0","1","1","0","0","0","0","1"
"Chandler","38.04171","-87.36806","0","0","0","0","1","0","0","1","0","1","0","0","1","0","1","0","0","1","1","0","0","0","0","1"
"Chandler","48.34935","-64.67926","0","0","0","0","1","0","0","1","0","1","0","0","1","0","1","0","0","1","1","0","0","0","0","1"
"Chandler","-27.51398","153.14907","0","0","0","0","1","0","0","1","0","1","0","0","1","0","1","0","0","1","1","0","0","0","0","1"
"Chang-hua","24.07327","120.56276","1","0","0","0","0","0","0","1","0","0","0","1","1","1","0","0","0","1","1","0","0","0","0","1"
"Changuinola","9.43","-82.52","1","0","0","0","0","0","0","1","0","0","0","0","0","0","0","1","0","1","1","0","0","0","0","1"
"Chaniá","35.51124","24.02921","3","0","0","0","0","0","0","3","2","1","0","0","3","1","1","1","0","3","3","0","0","0","0","3"
"Chapel en le Frith","53.32407","-1.91291","3","0","0","0","0","0","0","3","2","0","1","0","3","1","0","2","0","3","0","2","1","0","0","3"
"Chapel Hill","35.62646","-86.69333","1","0","0","0","0","0","1","2","0","0","0","0","0","0","2","0","0","2","1","1","0","0","0","2"
"Chapel Hill","35.9132","-79.05584","1","0","0","0","0","0","1","2","0","0","0","0","0","0","2","0","0","2","1","1","0","0","0","2"
"Chapel Hill","-27.50264","152.95012","1","0","0","0","0","0","1","2","0","0","0","0","0","0","2","0","0","2","1","1","0","0","0","2"
"Chapmanslade","51.22917","-2.24889","1","0","0","0","0","0","0","1","0","1","0","0","1","0","0","1","0","1","1","0","0","0","0","1"
"Chard","50.8727","-2.96597","5","0","0","1","0","0","0","6","2","1","1","0","4","3","1","2","0","6","0","3","2","0","1","6"
"Charfield","51.62722","-2.40667","1","0","0","0","0","0","0","1","0","0","1","0","1","0","0","1","0","1","0","1","0","0","0","1"
"Charikar","35.01361","69.17139","1","0","0","0","0","0","0","1","0","0","1","0","1","0","1","0","0","1","0","0","1","0","0","1"
"Charing","51.21073","0.79466","1","0","0","0","0","0","0","1","0","0","0","0","0","0","0","1","0","1","0","1","0","0","0","1"
"Charleston","35.29704","-94.03632","1","0","0","0","0","0","0","1","0","0","0","0","0","0","0","1","0","1","0","0","1","0","0","1"
"Charleston","34.00678","-90.05676","1","0","0","0","0","0","0","1","0","0","0","0","0","0","0","1","0","1","0","0","1","0","0","1"
"Charleston","36.92089","-89.35063","1","0","0","0","0","0","0","1","0","0","0","0","0","0","0","1","0","1","0","0","1","0","0","1"
"Charleston","39.49615","-88.17615","1","0","0","0","0","0","0","1","0","0","0","0","0","0","0","1","0","1","0","0","1","0","0","1"
"Charleston","35.2873","-84.75827","1","0","0","0","0","0","0","1","0","0","0","0","0","0","0","1","0","1","0","0","1","0","0","1"
"Charleston","38.34982","-81.63262","1","0","0","0","0","0","0","1","0","0","0","0","0","0","0","1","0","1","0","0","1","0","0","1"
"Charleston","32.77657","-79.93092","1","0","0","0","0","0","0","1","0","0","0","0","0","0","0","1","0","1","0","0","1","0","0","1"
"Charleston","40.53677","-74.23737","1","0","0","0","0","0","0","1","0","0","0","0","0","0","0","1","0","1","0","0","1","0","0","1"
"Charleston","45.08506","-69.04059","1","0","0","0","0","0","0","1","0","0","0","0","0","0","0","1","0","1","0","0","1","0","0","1"
"Charleston","-34.91667","138.9","1","0","0","0","0","0","0","1","0","0","0","0","0","0","0","1","0","1","0","0","1","0","0","1"
"Charlotte","28.86192","-98.70641","2","0","0","0","0","0","0","2","0","1","0","0","1","1","1","0","0","2","1","0","1","0","0","2"
"Charlotte","36.17728","-87.33973","2","0","0","0","0","0","0","2","0","1","0","0","1","1","1","0","0","2","1","0","1","0","0","2"
"Charlotte","42.56365","-84.83582","2","0","0","0","0","0","0","2","0","1","0","0","1","1","1","0","0","2","1","0","1","0","0","2"
"Charlotte","35.22709","-80.84313","2","0","0","0","0","0","0","2","0","1","0","0","1","1","1","0","0","2","1","0","1","0","0","2"
"Charlotte","44.30977","-73.26096","2","0","0","0","0","0","0","2","0","1","0","0","1","1","1","0","0","2","1","0","1","0","0","2"
"Charlton","42.13565","-71.97007","1","0","0","0","1","0","0","2","1","1","0","0","2","1","0","1","0","2","0","0","2","0","0","2"
"Charlton","51.59917","-2.05639","1","0","0","0","1","0","0","2","1","1","0","0","2","1","0","1","0","2","0","0","2","0","0","2"
"Charlton","-36.26437","143.34901","1","0","0","0","1","0","0","2","1","1","0","0","2","1","0","1","0","2","0","0","2","0","0","2"
"Charlwood","51.15644","-0.22586","1","0","0","0","0","0","0","1","0","0","1","0","1","0","0","1","0","1","0","0","1","0","0","1"
"Charsadda","34.14822","71.7406","5","1","0","0","0","0","0","6","3","1","2","1","7","1","0","6","0","7","0","1","5","0","1","7"
"Chatham","32.30626","-92.45042","8","0","0","0","1","0","5","14","6","1","4","0","11","6","0","8","0","14","3","9","2","0","0","14"
"Chatham","39.67616","-89.70454","8","0","0","0","1","0","5","14","6","1","4","0","11","6","0","8","0","14","3","9","2","0","0","14"
"Chatham","41.74115","-87.61255","8","0","0","0","1","0","5","14","6","1","4","0","11","6","0","8","0","14","3","9","2","0","0","14"
"Chatham","42.41224","-82.18494","8","0","0","0","1","0","5","14","6","1","4","0","11","6","0","8","0","14","3","9","2","0","0","14"
"Chatham","36.82569","-79.39808","8","0","0","0","1","0","5","14","6","1","4","0","11","6","0","8","0","14","3","9","2","0","0","14"
"Chatham","40.74093","-74.38376","8","0","0","0","1","0","5","14","6","1","4","0","11","6","0","8","0","14","3","9","2","0","0","14"
"Chatham","42.36425","-73.59484","8","0","0","0","1","0","5","14","6","1","4","0","11","6","0","8","0","14","3","9","2","0","0","14"
"Chatham","41.68206","-69.95974","8","0","0","0","1","0","5","14","6","1","4","0","11","6","0","8","0","14","3","9","2","0","0","14"
"Chatham","51.37891","0.52786","8","0","0","0","1","0","5","14","6","1","4","0","11","6","0","8","0","14","3","9","2","0","0","14"
"Chattanooga","35.04563","-85.30968","1","0","0","0","0","0","0","1","0","1","0","0","1","0","1","0","0","1","0","0","1","0","0","1"
"Chatteris","52.45624","0.05236","2","0","0","0","0","0","0","2","0","1","1","0","2","0","0","2","0","2","0","0","2","0","0","2"
"Cheadle","52.98333","-1.98333","4","0","0","0","1","0","0","5","1","2","2","0","5","3","0","2","0","5","1","1","3","0","0","5"
"Cheam","51.36179","-0.21977","1","0","0","1","0","0","1","3","1","0","0","0","1","1","0","2","0","3","1","0","2","0","0","3"
"Cheboksary","56.13222","47.25194","1","0","0","0","0","0","0","1","0","0","0","0","0","0","1","0","0","1","0","0","1","0","0","1"
"Cheddar","51.27537","-2.77662","1","0","0","0","0","0","0","1","0","0","1","0","1","0","0","1","0","1","0","1","0","0","0","1"
"Chelmsford","42.59981","-71.36728","41","3","0","1","11","0","4","60","9","23","20","2","54","21","10","30","0","61","16","10","32","3","0","61"
"Chelmsford","51.73575","0.46958","41","3","0","1","11","0","4","60","9","23","20","2","54","21","10","30","0","61","16","10","32","3","0","61"
"Cheltenham","51.90006","-2.07972","24","4","0","1","1","0","0","30","7","10","9","0","26","14","2","14","0","30","4","7","17","0","2","30"
"Cheltenham","-34.86788","138.52336","24","4","0","1","1","0","0","30","7","10","9","0","26","14","2","14","0","30","4","7","17","0","2","30"
"Cheltenham","-37.96944","145.04806","24","4","0","1","1","0","0","30","7","10","9","0","26","14","2","14","0","30","4","7","17","0","2","30"
"Chenab Nagar","31.75511","72.91403","1","0","0","0","0","0","0","1","1","0","0","0","1","1","0","0","0","1","0","0","1","0","0","1"
"Chennai","13.08784","80.27847","25","1","0","0","2","0","0","28","21","2","2","1","26","8","6","14","0","28","3","3","21","0","1","28"
"Chepstow","51.64087","-2.67683","4","2","0","0","0","0","1","7","2","2","2","0","6","3","0","4","0","7","0","2","5","0","0","7"
"Cherkasy","49.42854","32.06207","1","0","0","1","0","0","0","2","1","1","0","0","2","1","0","1","0","2","0","0","2","0","0","2"
"Chernivtsi","48.29149","25.94034","4","0","0","0","0","0","0","4","1","1","1","0","3","0","1","2","1","4","2","0","2","0","0","4"
"Chernivtsi","48.54225","28.11473","4","0","0","0","0","0","0","4","1","1","1","0","3","0","1","2","1","4","2","0","2","0","0","4"
"Cherry Hills Village","39.64165","-104.95943","1","0","0","0","0","0","0","1","0","0","0","0","0","1","0","0","0","1","0","0","1","0","0","1"
"Chertsey","46.07109","-73.89095","1","1","0","0","0","0","0","2","1","0","1","0","2","0","1","1","0","2","0","0","2","0","0","2"
"Chertsey","51.38812","-0.50782","1","1","0","0","0","0","0","2","1","0","1","0","2","0","1","1","0","2","0","0","2","0","0","2"
"Chesapeake","38.42786","-82.4571","2","0","0","0","0","0","0","2","0","1","0","0","1","2","0","0","0","2","2","0","0","0","0","2"
"Chesapeake","38.22344","-81.53623","2","0","0","0","0","0","0","2","0","1","0","0","1","2","0","0","0","2","2","0","0","0","0","2"
"Chesapeake","36.81904","-76.27494","2","0","0","0","0","0","0","2","0","1","0","0","1","2","0","0","0","2","2","0","0","0","0","2"
"Chesham","51.7","-0.6","5","0","0","0","1","0","2","8","1","4","2","0","7","2","2","4","0","8","4","1","3","0","0","8"
"Cheshunt","51.7002","-0.03026","6","0","0","0","0","0","0","6","0","4","1","0","5","3","1","2","0","6","1","1","2","2","0","6"
"Chessington","51.3624","-0.30427","3","0","0","0","0","0","0","3","0","1","1","0","2","0","2","1","0","3","0","1","1","1","0","3"
"Chester","40.30627","-121.23191","40","0","0","0","2","0","1","43","2","17","21","2","42","15","8","20","0","43","8","13","19","0","3","43"
"Chester","48.51054","-110.96747","40","0","0","0","2","0","1","43","2","17","21","2","42","15","8","20","0","43","8","13","19","0","3","43"
"Chester","37.91366","-89.82205","40","0","0","0","2","0","1","43","2","17","21","2","42","15","8","20","0","43","8","13","19","0","3","43"
"Chester","32.39378","-83.15293","40","0","0","0","2","0","1","43","2","17","21","2","42","15","8","20","0","43","8","13","19","0","3","43"
"Chester","34.70486","-81.21426","40","0","0","0","2","0","1","43","2","17","21","2","42","15","8","20","0","43","8","13","19","0","3","43"
"Chester","40.61312","-80.56285","40","0","0","0","2","0","1","43","2","17","21","2","42","15","8","20","0","43","8","13","19","0","3","43"
"Chester","37.35682","-77.44165","40","0","0","0","2","0","1","43","2","17","21","2","42","15","8","20","0","43","8","13","19","0","3","43"
"Chester","38.97539","-76.2894","40","0","0","0","2","0","1","43","2","17","21","2","42","15","8","20","0","43","8","13","19","0","3","43"
"Chester","39.84967","-75.35707","40","0","0","0","2","0","1","43","2","17","21","2","42","15","8","20","0","43","8","13","19","0","3","43"
"Chester","40.78427","-74.69683","40","0","0","0","2","0","1","43","2","17","21","2","42","15","8","20","0","43","8","13","19","0","3","43"
"Chester","41.36259","-74.27126","40","0","0","0","2","0","1","43","2","17","21","2","42","15","8","20","0","43","8","13","19","0","3","43"
"Chester","42.27926","-72.97871","40","0","0","0","2","0","1","43","2","17","21","2","42","15","8","20","0","43","8","13","19","0","3","43"
"Chester","43.26285","-72.59509","40","0","0","0","2","0","1","43","2","17","21","2","42","15","8","20","0","43","8","13","19","0","3","43"
"Chester","42.95675","-71.25728","40","0","0","0","2","0","1","43","2","17","21","2","42","15","8","20","0","43","8","13","19","0","3","43"
"Chester","45.40867","-68.49975","40","0","0","0","2","0","1","43","2","17","21","2","42","15","8","20","0","43","8","13","19","0","3","43"
"Chester","44.54225","-64.23891","40","0","0","0","2","0","1","43","2","17","21","2","42","15","8","20","0","43","8","13","19","0","3","43"
"Chester","53.1905","-2.89189","40","0","0","0","2","0","1","43","2","17","21","2","42","15","8","20","0","43","8","13","19","0","3","43"
"Chesterfield","38.66311","-90.57707","20","0","0","0","3","0","0","23","4","8","7","0","19","5","4","14","0","23","5","4","14","0","0","23"
"Chesterfield","40.11254","-85.59692","20","0","0","0","3","0","0","23","4","8","7","0","19","5","4","14","0","23","5","4","14","0","0","23"
"Chesterfield","34.73599","-80.08812","20","0","0","0","3","0","0","23","4","8","7","0","19","5","4","14","0","23","5","4","14","0","0","23"
"Chesterfield","37.37709","-77.50582","20","0","0","0","3","0","0","23","4","8","7","0","19","5","4","14","0","23","5","4","14","0","0","23"
"Chesterfield","42.39175","-72.83982","20","0","0","0","3","0","0","23","4","8","7","0","19","5","4","14","0","23","5","4","14","0","0","23"
"Chesterfield","42.8873","-72.47037","20","0","0","0","3","0","0","23","4","8","7","0","19","5","4","14","0","23","5","4","14","0","0","23"
"Chesterfield","53.25","-1.41667","20","0","0","0","3","0","0","23","4","8","7","0","19","5","4","14","0","23","5","4","14","0","0","23"
"Chester-le-Street","54.85862","-1.57408","4","0","0","0","2","0","0","6","2","0","2","0","4","2","0","4","0","6","0","2","4","0","0","6"
"Chestermere","51.03341","-113.81867","1","0","0","0","0","0","0","1","0","0","1","0","1","0","1","0","0","1","0","0","1","0","0","1"
"Chevreuse","48.70662","2.03329","1","0","0","0","0","0","0","1","0","0","0","0","0","0","0","1","0","1","0","0","1","0","0","1"
"Chhindwāra","22.05697","78.93958","1","0","0","0","0","0","0","1","0","0","1","0","1","0","0","1","0","1","0","0","1","0","0","1"
"Chibuto","-24.68667","33.53056","1","0","0","0","0","0","0","1","0","1","0","0","1","1","0","0","0","1","0","1","0","0","0","1"
"Chicago","41.85003","-87.65005","15","0","0","0","0","0","0","15","4","2","4","0","10","6","4","5","0","15","1","2","9","1","2","15"
"Chicago Lawn","41.77503","-87.69644","1","0","0","0","0","0","0","1","1","0","0","0","1","0","0","1","0","1","0","0","1","0","0","1"
"Chichawatni","30.5301","72.69155","2","0","0","0","0","0","0","2","0","0","1","0","1","0","2","0","0","2","0","0","0","0","2","2"
"Chichester","43.24925","-71.39979","33","2","0","1","4","0","2","42","6","14","13","1","34","19","7","16","0","42","7","11","23","1","0","42"
"Chichester","50.83673","-0.78003","33","2","0","1","4","0","2","42","6","14","13","1","34","19","7","16","0","42","7","11","23","1","0","42"
"Chico","47.61148","-122.71042","1","0","0","0","0","0","0","1","0","0","1","0","1","0","1","0","0","1","0","0","1","0","0","1"
"Chico","39.72849","-121.83748","1","0","0","0","0","0","0","1","0","0","1","0","1","0","1","0","0","1","0","0","1","0","0","1"
"Chico","33.29595","-97.79892","1","0","0","0","0","0","0","1","0","0","1","0","1","0","1","0","0","1","0","0","1","0","0","1"
"Chiddingfold","51.11866","-0.62262","7","0","0","0","0","0","0","7","1","0","0","0","1","1","1","5","0","7","0","2","5","0","0","7"
"Chigwell","51.61999","0.07596","2","0","0","0","0","0","0","2","0","0","1","0","1","0","0","2","0","2","0","0","1","1","0","2"
"Chigwell","-42.80912","147.2448","2","0","0","0","0","0","0","2","0","0","1","0","1","0","0","2","0","2","0","0","1","1","0","2"
"Chihuahua","28.63528","-106.08889","3","0","0","0","0","0","0","3","1","1","1","0","3","1","1","1","0","3","1","0","2","0","0","3"
"Chihuahua","16.02966","-91.97331","3","0","0","0","0","0","0","3","1","1","1","0","3","1","1","1","0","3","1","0","2","0","0","3"
"Chikhli","20.75751","73.06268","2","0","0","0","0","0","0","2","0","0","0","1","1","1","0","1","0","2","1","0","1","0","0","2"
"Chikhli","20.35046","76.25774","2","0","0","0","0","0","0","2","0","0","0","1","1","1","0","1","0","2","1","0","1","0","0","2"
"Chikwawa","-16.03352","34.80091","2","0","0","0","0","0","0","2","0","1","0","1","2","1","0","1","0","2","2","0","0","0","0","2"
"Chilaw","7.57583","79.79528","5","0","0","0","0","0","0","5","2","1","2","0","5","1","1","2","1","5","1","0","4","0","0","5"
"Chilches","39.78238","-0.18742","1","0","0","0","0","0","0","1","1","0","0","0","1","0","0","0","1","1","0","1","0","0","0","1"
"Chililabombwe","-12.36475","27.82286","3","0","0","0","0","0","0","3","0","1","1","1","3","2","1","0","0","3","1","0","0","1","1","3"
"Chingola","-12.52897","27.88382","3","0","0","0","0","0","0","3","0","3","0","0","3","3","0","0","0","3","2","0","1","0","0","3"
"Chiniot","31.72091","72.97836","1","0","0","0","0","0","0","1","0","0","1","0","1","0","0","1","0","1","0","0","0","1","0","1"
"Chinley","53.34025","-1.939","1","0","0","0","0","0","0","1","0","1","0","0","1","0","0","1","0","1","0","0","1","0","0","1"
"Chinnor","51.70177","-0.91161","1","0","0","0","0","0","0","1","0","1","0","0","1","1","0","0","0","1","1","0","0","0","0","1"
"Chipata","-13.63333","32.65","2","0","0","0","0","0","0","2","0","1","0","1","2","1","0","1","0","2","1","0","0","0","1","2"
"Chiplūn","17.53339","73.50935","1","0","0","0","0","0","0","1","1","0","0","0","1","1","0","0","0","1","0","0","1","0","0","1"
"Chippenham","51.46","-2.12472","15","1","0","1","0","0","1","18","3","6","7","0","16","3","2","13","0","18","1","7","9","0","1","18"
"Chippenham","52.30184","0.43636","15","1","0","1","0","0","1","18","3","6","7","0","16","3","2","13","0","18","1","7","9","0","1","18"
"Chipping Norton","51.94109","-1.5453","2","0","0","0","0","0","2","4","0","0","2","0","2","0","1","3","0","4","1","0","3","0","0","4"
"Chipping Norton","-33.91801","150.95927","2","0","0","0","0","0","2","4","0","0","2","0","2","0","1","3","0","4","1","0","3","0","0","4"
"Chirgaon","25.57198","78.81432","1","0","0","0","0","0","0","1","0","0","0","0","0","0","0","1","0","1","1","0","0","0","0","1"
"Chisinau","47.00556","28.8575","13","3","0","0","0","0","0","16","5","3","2","0","10","1","6","9","0","16","7","1","6","0","2","16"
"Chislehurst","51.41709","0.06858","1","0","0","0","0","0","0","1","0","0","1","0","1","0","0","1","0","1","0","0","1","0","0","1"
"Chitre","28.42673","83.69076","0","0","0","1","0","0","0","1","0","0","0","0","0","0","0","1","0","1","0","0","0","0","0","0"
"Chitré","7.96082","-80.42944","1","0","0","0","0","0","0","1","1","0","0","0","1","0","0","1","0","1","0","0","1","0","0","1"
"Chittagong","22.3384","91.83168","49","2","0","0","3","1","1","56","29","8","9","3","49","20","8","25","2","55","5","7","32","4","8","56"
"Chittaurgarh","24.88963","74.62403","1","0","0","0","0","0","0","1","1","0","0","0","1","0","1","0","0","1","0","0","1","0","0","1"
"Chittoor","13.21055","79.0956","1","0","0","0","0","0","0","1","1","0","0","0","1","0","0","1","0","1","0","0","1","0","0","1"
"Chlef","36.16525","1.33452","2","0","0","0","0","0","0","2","1","1","0","0","2","0","1","1","0","2","1","1","0","0","0","2"
"Choa Saidan Shah","32.71962","72.98625","1","0","0","0","0","0","0","1","1","0","0","0","1","1","0","0","0","1","0","0","1","0","0","1"
"Chobham","51.34836","-0.60639","1","0","0","0","0","0","0","1","0","0","1","0","1","0","0","0","1","1","0","1","0","0","0","1"
"Cholsey","51.5728","-1.15356","1","0","0","0","0","0","0","1","0","1","0","0","1","1","0","0","0","1","0","0","1","0","0","1"
"Choma","-16.80889","26.9875","3","0","0","0","1","0","0","4","0","3","0","1","4","1","1","1","1","4","1","1","0","1","1","4"
"Chongwe","-15.32916","28.68204","1","0","0","0","0","0","0","1","0","1","0","0","1","0","0","1","0","1","1","0","0","0","0","1"
"Choppington","55.15004","-1.60332","1","0","0","0","0","0","0","1","0","0","0","0","0","1","0","0","0","1","1","0","0","0","0","1"
"Chorley","53.65","-2.61667","20","0","0","0","3","0","0","23","4","9","7","0","20","16","3","4","0","23","3","5","15","0","0","23"
"Chorleywood","51.65472","-0.51404","1","0","0","0","0","0","0","1","0","0","0","0","0","0","0","1","0","1","0","0","1","0","0","1"
"Christchurch","50.73583","-1.78129","22","0","0","0","1","0","1","24","5","5","10","0","20","7","2","15","0","24","4","8","9","1","1","23"
"Christchurch","-43.53333","172.63333","22","0","0","0","1","0","1","24","5","5","10","0","20","7","2","15","0","24","4","8","9","1","1","23"
"Chudleigh","50.60496","-3.60031","1","0","0","0","0","0","0","1","0","0","1","0","1","0","0","1","0","1","0","0","1","0","0","1"
"Chuka","-0.33316","37.64587","1","0","0","0","0","0","0","1","0","0","0","0","0","0","0","0","0","0","0","0","1","0","0","1"
"Chula Vista","32.64005","-117.0842","2","0","0","0","0","0","0","2","0","0","0","0","0","1","1","0","0","2","1","0","1","0","0","2"
"Chula Vista","27.04083","-103.36611","2","0","0","0","0","0","0","2","0","0","0","0","0","1","1","0","0","2","1","0","1","0","0","2"
"Chunian","30.96621","73.97908","0","1","0","0","0","0","0","1","0","0","1","0","1","1","0","0","0","1","0","0","1","0","0","1"
"Church Stretton","52.53778","-2.80149","1","0","0","0","0","0","0","1","0","0","1","0","1","0","1","0","0","1","0","0","1","0","0","1"
"Cicero","41.84559","-87.75394","1","0","0","0","0","0","0","1","0","1","0","0","1","0","0","0","0","0","1","0","0","0","0","1"
"Cicero","40.12393","-86.01332","1","0","0","0","0","0","0","1","0","1","0","0","1","0","0","0","0","0","1","0","0","0","0","1"
"Cincinnati","39.12711","-84.51439","0","0","0","1","0","0","0","1","1","0","0","0","1","0","1","0","0","1","0","0","1","0","0","1"
"Cirencester","51.71927","-1.97145","8","0","0","0","0","0","0","8","1","5","0","0","6","5","1","2","0","8","2","3","3","0","0","8"
"Citrus Heights","38.70712","-121.28106","1","0","0","0","0","0","0","1","0","0","0","0","0","1","0","0","0","1","0","0","1","0","0","1"
"Ciudad Obregón","27.48642","-109.94083","2","0","0","0","0","0","0","2","0","0","0","0","0","2","0","0","0","2","2","0","0","0","0","2"
"Ciudad Victoria","23.74174","-99.14599","2","0","0","0","1","0","0","3","1","0","0","0","1","3","0","0","0","3","0","0","3","0","0","3"
"Cividale del Friuli","46.09019","13.42861","2","0","0","0","0","0","0","2","1","0","0","0","1","0","0","2","0","2","0","2","0","0","0","2"
"Clackmannan","56.10743","-3.75098","1","0","0","0","0","0","0","1","0","0","1","0","1","0","0","1","0","1","0","1","0","0","0","1"
"Clacton-on-Sea","51.78967","1.15597","2","0","0","0","0","0","0","2","0","1","0","0","1","0","0","2","0","2","1","0","1","0","0","2"
"Clanfield","51.71623","-1.58888","1","1","0","0","0","0","0","2","1","0","1","0","2","0","0","2","0","2","0","0","2","0","0","2"
"Clanwilliam","-32.18173","18.89217","1","0","0","0","0","0","0","1","1","0","0","0","1","0","0","1","0","1","0","0","1","0","0","1"
"Clapham","52.16085","-0.49529","2","0","0","0","0","0","0","2","0","0","2","0","2","2","0","0","0","2","0","0","2","0","0","2"
"Clapham","-34.98989","138.60158","2","0","0","0","0","0","0","2","0","0","2","0","2","2","0","0","0","2","0","0","2","0","0","2"
"Clara","53.3425","-7.61389","1","0","0","0","0","0","0","1","1","0","0","0","1","0","0","1","0","1","0","0","1","0","0","1"
"Claremorris","53.71667","-9","1","0","0","0","0","0","0","1","0","1","0","0","1","0","0","1","0","1","0","1","0","0","0","1"
"Claverdon","52.27919","-1.71267","1","0","0","0","0","0","0","1","0","0","0","0","0","0","0","1","0","1","0","0","1","0","0","1"
"Clayton South","-37.93333","145.11667","1","0","0","0","0","0","0","1","0","1","0","0","1","0","1","0","0","1","0","0","1","0","0","1"
"Cleator Moor","54.52143","-3.5159","0","0","0","0","0","0","1","1","0","0","0","0","0","0","0","1","0","1","0","0","1","0","0","1"
"Cleckheaton","53.72405","-1.71294","4","1","0","0","0","0","0","5","1","0","4","0","5","3","0","2","0","5","1","1","3","0","0","5"
"Cleethorpes","53.56047","-0.03225","2","0","0","0","0","0","1","3","0","2","1","0","3","0","0","3","0","3","0","2","1","0","0","3"
"Clermont","43.00359","-91.65237","2","0","0","0","0","0","0","2","0","0","1","0","1","1","0","1","0","2","0","0","2","0","0","2"
"Clermont","39.80977","-86.32249","2","0","0","0","0","0","0","2","0","0","1","0","1","1","0","1","0","2","0","0","2","0","0","2"
"Clermont","34.47788","-83.77351","2","0","0","0","0","0","0","2","0","0","1","0","1","1","0","1","0","2","0","0","2","0","0","2"
"Clermont","28.54944","-81.77285","2","0","0","0","0","0","0","2","0","0","1","0","1","1","0","1","0","2","0","0","2","0","0","2"
"Clermont","43.65174","-0.91734","2","0","0","0","0","0","0","2","0","0","1","0","1","1","0","1","0","2","0","0","2","0","0","2"
"Clermont","49.37897","2.41258","2","0","0","0","0","0","0","2","0","0","1","0","1","1","0","1","0","2","0","0","2","0","0","2"
"Clermont","-22.82407","147.63635","2","0","0","0","0","0","0","2","0","0","1","0","1","1","0","1","0","2","0","0","2","0","0","2"
"Clevedon","51.44227","-2.85786","1","1","0","0","2","0","0","4","1","1","2","0","4","2","0","2","0","4","1","1","1","0","1","4"
"Cleveleys","53.8775","-3.03987","1","0","0","0","0","0","0","1","0","1","0","0","1","1","0","0","0","1","1","0","0","0","0","1"
"Cliffside Park","40.82149","-73.98764","2","0","0","0","0","0","0","2","1","0","1","0","2","1","0","1","0","2","0","0","2","0","0","2"
"Clifton Beach","-16.76313","145.67167","1","0","0","0","0","0","0","1","0","0","0","0","0","0","1","0","0","1","1","0","0","0","0","1"
"Clifton Beach","-42.98531","147.52107","1","0","0","0","0","0","0","1","0","0","0","0","0","0","1","0","0","1","1","0","0","0","0","1"
"Clifton Hill","-37.79798","144.99533","0","0","0","0","1","0","0","1","1","0","0","0","1","0","0","1","0","1","0","0","0","1","0","1"
"Clitheroe","53.86667","-2.4","7","0","0","0","1","0","1","9","1","3","4","1","9","3","1","3","1","8","2","3","3","0","0","8"
"Cluj-Napoca","46.76667","23.6","17","0","0","0","0","0","0","17","2","3","5","0","10","6","3","8","0","17","3","2","8","0","4","17"
"Clunderwen","51.84056","-4.73167","2","0","0","0","0","0","0","2","1","0","0","0","1","0","0","2","0","2","0","1","1","0","0","2"
"Clutton","51.32944","-2.54306","1","0","0","0","0","0","0","1","1","0","0","0","1","0","0","1","0","1","1","0","0","0","0","1"
"Clydebank","55.90137","-4.4057","1","0","0","0","0","0","0","1","0","0","1","0","1","0","0","1","0","1","0","0","1","0","0","1"
"Clyde North","-38.11667","145.33333","0","0","0","0","1","0","0","1","0","1","0","0","1","1","0","0","0","1","0","0","1","0","0","1"
"Coalville","40.91773","-111.39936","3","0","0","0","0","0","0","3","0","0","3","0","3","1","0","2","0","3","0","0","3","0","0","3"
"Coalville","42.44525","-94.12579","3","0","0","0","0","0","0","3","0","0","3","0","3","1","0","2","0","3","0","0","3","0","0","3"
"Coalville","52.72247","-1.3702","3","0","0","0","0","0","0","3","0","0","3","0","3","1","0","2","0","3","0","0","3","0","0","3"
"Coatbridge","55.86216","-4.02469","2","1","0","0","1","0","0","4","0","1","2","0","3","1","1","2","0","4","1","2","1","0","0","4"
"Cobham","51.32997","-0.4113","4","0","0","0","0","0","1","5","2","0","2","0","4","2","0","3","0","5","0","3","2","0","0","5"
"Cobija","-11.02671","-68.76918","1","0","0","0","0","0","0","1","0","0","0","0","0","0","0","1","0","1","0","0","0","0","1","1"
"Cochabamba","-6.48333","-78.9","3","0","0","0","0","0","0","3","3","0","0","0","3","0","0","3","0","3","0","0","3","0","0","3"
"Cochabamba","-9.49361","-77.85944","3","0","0","0","0","0","0","3","3","0","0","0","3","0","0","3","0","3","0","0","3","0","0","3"
"Cochabamba","-9.09536","-76.83688","3","0","0","0","0","0","0","3","3","0","0","0","3","0","0","3","0","3","0","0","3","0","0","3"
"Cochabamba","-17.3895","-66.1568","3","0","0","0","0","0","0","3","3","0","0","0","3","0","0","3","0","3","0","0","3","0","0","3"
"Cochin","9.93988","76.26022","1","0","0","0","0","0","0","1","0","0","1","0","1","0","0","1","0","1","0","0","1","0","0","1"
"Cochrane","51.18341","-114.46871","1","0","0","0","0","0","0","1","0","0","0","0","0","0","1","0","0","1","1","0","0","0","0","1"
"Cochrane","-47.2557","-72.5695","1","0","0","0","0","0","0","1","0","0","0","0","0","0","1","0","0","1","1","0","0","0","0","1"
"Cockatoo","-37.93677","145.49376","1","0","0","0","0","0","0","1","1","0","0","0","1","0","0","1","0","1","0","1","0","0","0","1"
"Cockermouth","54.66209","-3.36086","3","0","0","0","0","0","0","3","0","1","2","0","3","1","0","2","0","3","1","1","1","0","0","3"
"Cocoa","28.38612","-80.742","1","0","0","0","0","0","0","1","0","1","0","0","1","0","1","0","0","1","1","0","0","0","0","1"
"Codlea","45.7","25.45","1","0","0","0","0","0","0","1","0","0","1","0","1","0","0","1","0","1","0","0","1","0","0","1"
"Coedpoeth","53.05391","-3.06234","1","0","0","0","0","0","0","1","0","0","1","0","1","0","0","1","0","1","0","1","0","0","0","1"
"Coelbren","51.79181","-3.67014","1","0","0","0","0","0","0","1","0","0","1","0","1","0","0","1","0","1","0","0","1","0","0","1"
"Coffs Harbour","-30.29626","153.11351","1","0","0","0","0","0","0","1","0","0","0","0","0","1","0","0","0","1","1","0","0","0","0","1"
"Coggeshall","51.87077","0.68536","3","0","0","0","0","0","0","3","0","1","1","0","2","2","0","1","0","3","1","0","2","0","0","3"
"Coimbatore","11.00555","76.96612","2","0","0","0","0","0","0","2","3","0","0","0","3","0","0","3","0","3","0","0","3","0","0","3"
"Coimbra","40.20564","-8.41955","2","0","0","0","0","0","0","2","0","0","0","0","0","0","1","1","0","2","1","0","1","0","0","2"
"Colac","-38.339","143.58489","1","0","0","0","0","0","0","1","0","0","1","0","1","0","0","1","0","1","0","1","0","0","0","1"
"Colbert","33.85316","-96.50249","1","0","0","0","0","0","0","1","0","1","0","0","1","0","0","1","0","1","0","1","0","0","0","1"
"Colbert","34.03789","-83.21265","1","0","0","0","0","0","0","1","0","1","0","0","1","0","0","1","0","1","0","1","0","0","0","1"
"Colchester","40.42643","-90.79263","37","1","0","2","2","0","0","42","9","16","8","1","34","16","7","19","0","42","15","10","14","1","2","42"
"Colchester","44.54394","-73.14791","37","1","0","2","2","0","0","42","9","16","8","1","34","16","7","19","0","42","15","10","14","1","2","42"
"Colchester","41.57565","-72.33203","37","1","0","2","2","0","0","42","9","16","8","1","34","16","7","19","0","42","15","10","14","1","2","42"
"Colchester","51.88921","0.90421","37","1","0","2","2","0","0","42","9","16","8","1","34","16","7","19","0","42","15","10","14","1","2","42"
"Cold Norton","51.67209","0.66997","1","0","0","0","0","0","1","2","0","1","1","0","2","1","0","1","0","2","0","0","2","0","0","2"
"Coleford","51.79535","-2.61354","3","0","0","0","0","0","0","3","0","1","1","0","2","2","0","1","0","3","1","1","1","0","0","3"
"Coleraine","47.28883","-93.42771","4","0","0","0","0","0","0","4","0","4","0","0","4","1","1","2","0","4","2","1","0","0","1","4"
"Coleraine","55.13333","-6.66667","4","0","0","0","0","0","0","4","0","4","0","0","4","1","1","2","0","4","2","1","0","0","1","4"
"Coleraine","-37.59827","141.69124","4","0","0","0","0","0","0","4","0","4","0","0","4","1","1","2","0","4","2","1","0","0","1","4"
"College Station","30.62798","-96.33441","1","0","0","0","0","0","0","1","0","0","0","0","0","0","1","0","0","1","0","0","1","0","0","1"
"College Station","34.70815","-92.22126","1","0","0","0","0","0","0","1","0","0","0","0","0","0","1","0","0","1","0","0","1","0","0","1"
"Colleyville","32.88096","-97.15501","2","0","0","0","0","0","0","2","0","0","0","0","0","1","0","1","0","2","1","1","0","0","0","2"
"Colne","53.85713","-2.16851","3","0","0","0","0","0","0","3","1","1","1","0","3","1","1","1","0","3","1","1","1","0","0","3"
"Colombo","-25.29167","-49.22417","11","0","0","0","0","0","0","11","8","2","0","0","10","3","2","6","0","11","5","0","6","0","0","11"
"Colombo","6.93548","79.84868","11","0","0","0","0","0","0","11","8","2","0","0","10","3","2","6","0","11","5","0","6","0","0","11"
"Coloncito","8.56292","-79.89944","1","0","0","0","0","0","0","1","0","0","0","0","0","1","0","0","0","1","0","0","0","0","0","0"
"Coloncito","8.32611","-72.08742","1","0","0","0","0","0","0","1","0","0","0","0","0","1","0","0","0","1","0","0","0","0","0","0"
"Colorado Springs","38.83388","-104.82136","2","0","0","0","0","0","0","2","0","0","0","1","1","2","0","0","0","2","1","0","1","0","0","2"
"Columbia","38.03631","-120.40131","1","0","0","0","0","0","0","1","0","0","1","0","1","1","0","0","0","1","0","0","1","0","0","1"
"Columbia","38.95171","-92.33407","1","0","0","0","0","0","0","1","0","0","1","0","1","1","0","0","0","1","0","0","1","0","0","1"
"Columbia","32.10516","-92.07791","1","0","0","0","0","0","0","1","0","0","1","0","1","1","0","0","0","1","0","0","1","0","0","1"
"Columbia","38.44366","-90.20122","1","0","0","0","0","0","0","1","0","0","1","0","1","1","0","0","0","1","0","0","1","0","0","1"
"Columbia","31.25184","-89.83758","1","0","0","0","0","0","0","1","0","0","1","0","1","1","0","0","0","1","0","0","1","0","0","1"
"Columbia","35.61507","-87.03528","1","0","0","0","0","0","0","1","0","0","1","0","1","1","0","0","0","1","0","0","1","0","0","1"
"Columbia","37.10284","-85.30635","1","0","0","0","0","0","0","1","0","0","1","0","1","1","0","0","0","1","0","0","1","0","0","1"
"Columbia","31.29271","-85.11267","1","0","0","0","0","0","0","1","0","0","1","0","1","1","0","0","0","1","0","0","1","0","0","1"
"Columbia","34.00071","-81.03481","1","0","0","0","0","0","0","1","0","0","1","0","1","1","0","0","0","1","0","0","1","0","0","1"
"Columbia","39.24038","-76.83942","1","0","0","0","0","0","0","1","0","0","1","0","1","1","0","0","0","1","0","0","1","0","0","1"
"Columbia","40.03371","-76.50441","1","0","0","0","0","0","0","1","0","0","1","0","1","1","0","0","0","1","0","0","1","0","0","1"
"Columbia","35.91766","-76.25215","1","0","0","0","0","0","0","1","0","0","1","0","1","1","0","0","0","1","0","0","1","0","0","1"
"Columbia","44.85199","-71.55175","1","0","0","0","0","0","0","1","0","0","1","0","1","1","0","0","0","1","0","0","1","0","0","1"
"Columbus","45.63661","-109.25211","3","0","0","0","0","0","0","3","0","1","1","1","3","1","0","2","0","3","1","0","2","0","0","3"
"Columbus","31.8276","-107.64002","3","0","0","0","0","0","0","3","0","1","1","1","3","1","0","2","0","3","1","0","2","0","0","3"
"Columbus","41.42973","-97.36838","3","0","0","0","0","0","0","3","0","1","1","1","3","1","0","2","0","3","1","0","2","0","0","3"
"Columbus","29.70662","-96.53969","3","0","0","0","0","0","0","3","0","1","1","1","3","1","0","2","0","3","1","0","2","0","0","3"
"Columbus","37.16923","-94.84412","3","0","0","0","0","0","0","3","0","1","1","1","3","1","0","2","0","3","1","0","2","0","0","3"
"Columbus","45.26522","-93.05015","3","0","0","0","0","0","0","3","0","1","1","1","3","1","0","2","0","3","1","0","2","0","0","3"
"Columbus","43.33805","-89.01539","3","0","0","0","0","0","0","3","0","1","1","1","3","1","0","2","0","3","1","0","2","0","0","3"
"Columbus","33.49567","-88.42726","3","0","0","0","0","0","0","3","0","1","1","1","3","1","0","2","0","3","1","0","2","0","0","3"
"Columbus","39.20144","-85.92138","3","0","0","0","0","0","0","3","0","1","1","1","3","1","0","2","0","3","1","0","2","0","0","3"
"Columbus","32.46098","-84.98771","3","0","0","0","0","0","0","3","0","1","1","1","3","1","0","2","0","3","1","0","2","0","0","3"
"Columbus","39.96118","-82.99879","3","0","0","0","0","0","0","3","0","1","1","1","3","1","0","2","0","3","1","0","2","0","0","3"
"Columbus","35.25317","-82.19706","3","0","0","0","0","0","0","3","0","1","1","1","3","1","0","2","0","3","1","0","2","0","0","3"
"Columbus","41.94089","-79.58172","3","0","0","0","0","0","0","3","0","1","1","1","3","1","0","2","0","3","1","0","2","0","0","3"
"Columbus","42.68396","-75.37267","3","0","0","0","0","0","0","3","0","1","1","1","3","1","0","2","0","3","1","0","2","0","0","3"
"Colwyn Bay","53.29483","-3.72674","6","0","0","0","1","0","0","7","1","3","2","0","6","0","2","5","0","7","4","1","2","0","0","7"
"Colyton","50.74006","-3.07021","1","0","0","0","0","0","0","1","0","0","1","0","1","0","0","1","0","1","0","1","0","0","0","1"
"Colyton","-33.78283","150.79679","1","0","0","0","0","0","0","1","0","0","1","0","1","0","0","1","0","1","0","1","0","0","0","1"
"Comber","54.54937","-5.74379","3","0","0","0","0","0","0","3","0","1","2","0","3","0","0","3","0","3","0","2","1","0","0","3"
"Comberton","52.18709","0.01905","0","1","0","0","0","0","0","1","0","0","1","0","1","0","0","1","0","1","0","0","1","0","0","1"
"Comilla","23.46186","91.18503","10","0","1","0","0","1","1","13","4","5","0","3","12","4","4","3","2","13","2","1","7","2","1","13"
"Commercy","48.76128","5.59067","1","0","0","0","0","0","0","1","1","0","0","0","1","0","0","1","0","1","0","0","1","0","0","1"
"Comodoro Rivadavia","-45.86413","-67.49656","2","0","0","0","0","0","0","2","1","1","0","0","2","0","1","1","0","2","0","1","0","0","1","2"
"Conakry","9.53795","-13.67729","3","0","0","0","0","0","0","3","0","3","0","0","3","1","2","0","0","3","2","0","0","0","1","3"
"Concepción","16.80908","-92.96526","2","0","0","0","0","0","0","2","2","0","0","0","2","0","0","2","0","2","0","1","1","0","0","2"
"Concepción","14.78417","-91.14754","2","0","0","0","0","0","0","2","2","0","0","0","2","0","0","2","0","2","0","1","1","0","0","2"
"Concepción","9.93333","-84","2","0","0","0","0","0","0","2","2","0","0","0","2","0","0","2","0","2","0","1","1","0","0","2"
"Concepción","-11.91762","-75.31401","2","0","0","0","0","0","0","2","2","0","0","0","2","0","0","2","0","2","0","1","1","0","0","2"
"Concepción","6.39408","-75.2583","2","0","0","0","0","0","0","2","2","0","0","0","2","0","0","2","0","2","0","1","1","0","0","2"
"Concepción","-36.82699","-73.04977","2","0","0","0","0","0","0","2","2","0","0","0","2","0","0","2","0","2","0","1","1","0","0","2"
"Concepción","6.76619","-72.694","2","0","0","0","0","0","0","2","2","0","0","0","2","0","0","2","0","2","0","1","1","0","0","2"
"Concepción","10.8","-71.76667","2","0","0","0","0","0","0","2","2","0","0","0","2","0","0","2","0","2","0","1","1","0","0","2"
"Concepción","10.4119","-71.68919","2","0","0","0","0","0","0","2","2","0","0","0","2","0","0","2","0","2","0","1","1","0","0","2"
"Concepción","-27.34127","-65.59636","2","0","0","0","0","0","0","2","2","0","0","0","2","0","0","2","0","2","0","1","1","0","0","2"
"Concepción","-16.43333","-60.9","2","0","0","0","0","0","0","2","2","0","0","0","2","0","0","2","0","2","0","1","1","0","0","2"
"Concepción","-28.39175","-57.88777","2","0","0","0","0","0","0","2","2","0","0","0","2","0","0","2","0","2","0","1","1","0","0","2"
"Concepción","-23.39985","-57.43236","2","0","0","0","0","0","0","2","2","0","0","0","2","0","0","2","0","2","0","1","1","0","0","2"
"Concepción de La Vega","19.22207","-70.52956","1","0","0","0","0","0","0","1","0","0","1","0","1","1","0","0","0","1","0","0","1","0","0","1"
"Concord","37.97798","-122.03107","0","0","0","0","1","0","0","1","0","1","0","0","1","0","0","0","1","1","1","0","0","0","0","1"
"Concord","38.5245","-90.35734","0","0","0","0","1","0","0","1","0","1","0","0","1","0","0","0","1","1","1","0","0","0","0","1"
"Concord","43.06945","-88.59871","0","0","0","0","1","0","0","1","0","1","0","0","1","0","0","0","1","1","1","0","0","0","0","1"
"Concord","33.46761","-87.03111","0","0","0","0","1","0","0","1","0","1","0","0","1","0","0","0","1","1","1","0","0","0","0","1"
"Concord","42.17782","-84.64302","0","0","0","0","1","0","0","1","0","1","0","0","1","0","0","0","1","1","1","0","0","0","0","1"
"Concord","35.40888","-80.58158","0","0","0","0","1","0","0","1","0","1","0","0","1","0","0","0","1","1","1","0","0","0","0","1"
"Concord","43.80011","-79.48291","0","0","0","0","1","0","0","1","0","1","0","0","1","0","0","0","1","1","1","0","0","0","0","1"
"Concord","37.34264","-78.97502","0","0","0","0","1","0","0","1","0","1","0","0","1","0","0","0","1","1","1","0","0","0","0","1"
"Concord","40.60816","-74.08431","0","0","0","0","1","0","0","1","0","1","0","0","1","0","0","0","1","1","1","0","0","0","0","1"
"Concord","43.20814","-71.53757","0","0","0","0","1","0","0","1","0","1","0","0","1","0","0","0","1","1","1","0","0","0","0","1"
"Concord","42.46037","-71.34895","0","0","0","0","1","0","0","1","0","1","0","0","1","0","0","0","1","1","1","0","0","0","0","1"
"Concord","-33.84722","151.10381","0","0","0","0","1","0","0","1","0","1","0","0","1","0","0","0","1","1","1","0","0","0","0","1"
"Congleton","53.16314","-2.21253","3","0","0","0","0","0","0","3","0","1","2","0","3","2","0","1","0","3","0","0","3","0","0","3"
"Congomah","-20.14889","57.59083","2","0","0","0","0","0","0","2","0","1","0","0","1","0","2","0","0","2","2","0","0","0","0","2"
"Congresbury","51.37135","-2.81018","1","0","0","0","0","0","0","1","1","0","0","0","1","0","0","1","0","1","0","0","1","0","0","1"
"Coningsby","53.10598","-0.17595","1","0","0","0","0","0","0","1","0","0","1","0","1","0","0","1","0","1","0","1","0","0","0","1"
"Conroe","30.31188","-95.45605","1","0","0","0","0","0","0","1","0","1","0","0","1","0","1","0","0","1","1","0","0","0","0","1"
"Consett","54.85404","-1.8316","3","0","0","0","1","0","0","4","0","1","2","0","3","1","0","3","0","4","1","1","2","0","0","4"
"Constanţa","44.18073","28.63432","4","1","0","0","0","0","1","6","2","1","0","0","3","2","2","2","0","6","3","0","3","0","0","6"
"Constantia","43.24785","-76.0002","1","0","0","0","0","0","0","1","0","1","0","0","1","1","0","0","0","1","1","0","0","0","0","1"
"Constantia","-34.03139","18.41833","1","0","0","0","0","0","0","1","0","1","0","0","1","1","0","0","0","1","1","0","0","0","0","1"
"Constantine","41.84116","-85.6686","8","0","0","0","1","0","0","9","3","0","5","0","8","1","2","6","0","9","1","6","1","0","1","9"
"Constantine","50.1189","-5.17595","8","0","0","0","1","0","0","9","3","0","5","0","8","1","2","6","0","9","1","6","1","0","1","9"
"Constantine","36.365","6.61472","8","0","0","0","1","0","0","9","3","0","5","0","8","1","2","6","0","9","1","6","1","0","1","9"
"Conway","37.50199","-92.82101","0","0","0","1","0","0","0","1","0","0","0","0","0","1","0","0","0","1","1","0","0","0","0","1"
"Conway","35.0887","-92.4421","0","0","0","1","0","0","0","1","0","0","0","0","0","1","0","0","0","1","1","0","0","0","0","1"
"Conway","28.50278","-81.33062","0","0","0","1","0","0","0","1","0","0","0","0","0","1","0","0","0","1","1","0","0","0","0","1"
"Conway","40.65979","-80.23923","0","0","0","1","0","0","0","1","0","0","0","0","0","1","0","0","0","1","1","0","0","0","0","1"
"Conway","33.836","-79.04781","0","0","0","1","0","0","0","1","0","0","0","0","0","1","0","0","0","1","1","0","0","0","0","1"
"Conway","36.4371","-77.22886","0","0","0","1","0","0","0","1","0","0","0","0","0","1","0","0","0","1","1","0","0","0","0","1"
"Conway","42.50981","-72.69953","0","0","0","1","0","0","0","1","0","0","0","0","0","1","0","0","0","1","1","0","0","0","0","1"
"Conway","43.97924","-71.12035","0","0","0","1","0","0","0","1","0","0","0","0","0","1","0","0","0","1","1","0","0","0","0","1"
"Conwy","53.28077","-3.83039","4","0","0","0","1","0","0","5","2","1","2","0","5","4","0","1","0","5","0","3","2","0","0","5"
"Cookham","51.55936","-0.7081","1","0","0","0","0","0","0","1","1","0","0","0","1","0","0","1","0","1","0","0","1","0","0","1"
"Cookstown","44.18341","-79.69964","6","0","0","0","0","0","1","7","3","2","1","0","6","2","2","3","0","7","1","1","5","0","0","7"
"Cookstown","54.64305","-6.74595","6","0","0","0","0","0","1","7","3","2","1","0","6","2","2","3","0","7","1","1","5","0","0","7"
"Copenhagen","43.8934","-75.67353","5","0","0","2","0","0","1","8","2","1","2","0","5","5","1","2","0","8","1","1","6","0","0","8"
"Copenhagen","55.67594","12.56553","5","0","0","2","0","0","1","8","2","1","2","0","5","5","1","2","0","8","1","1","6","0","0","8"
"Copiapó","-27.36679","-70.3314","0","1","0","0","0","0","0","1","0","0","0","0","0","1","0","0","0","1","0","0","1","0","0","1"
"Copthorne","51.13929","-0.11742","1","0","0","0","0","0","0","1","0","0","0","0","0","1","0","0","0","1","1","0","0","0","0","1"
"Coral Springs","26.27119","-80.2706","1","0","0","0","0","0","0","1","0","0","1","0","1","0","0","1","0","1","0","0","1","0","0","1"
"Corby","52.49637","-0.68939","4","0","0","0","0","0","1","5","1","3","1","0","5","3","0","2","0","5","1","1","3","0","0","5"
"Córdoba","18.8842","-96.92559","3","0","0","0","0","0","0","3","0","0","2","1","3","3","0","0","0","3","1","0","0","2","0","3"
"Córdoba","0.85362","-77.51817","3","0","0","0","0","0","0","3","0","0","2","1","3","3","0","0","0","3","1","0","0","2","0","3"
"Córdoba","4.39158","-75.68723","3","0","0","0","0","0","0","3","0","0","2","1","3","3","0","0","0","3","1","0","0","2","0","3"
"Córdoba","9.58612","-74.82705","3","0","0","0","0","0","0","3","0","0","2","1","3","3","0","0","0","3","1","0","0","2","0","3"
"Córdoba","-31.4135","-64.18105","3","0","0","0","0","0","0","3","0","0","2","1","3","3","0","0","0","3","1","0","0","2","0","3"
"Córdoba","37.89155","-4.77275","3","0","0","0","0","0","0","3","0","0","2","1","3","3","0","0","0","3","1","0","0","2","0","3"
"Corfe Castle","50.63947","-2.05672","1","0","0","0","0","0","0","1","0","1","0","0","1","0","0","1","0","1","0","1","0","0","0","1"
"Cork","51.89797","-8.47061","1","0","0","0","1","0","0","2","1","0","0","0","1","5","0","0","0","5","3","1","1","0","0","5"
"Cornwall","40.2737","-76.40607","1","0","0","0","0","0","0","1","0","0","1","0","1","0","0","1","0","1","0","1","0","0","0","1"
"Cornwall","45.01809","-74.72815","1","0","0","0","0","0","0","1","0","0","1","0","1","0","0","1","0","1","0","1","0","0","0","1"
"Cornwall","41.44482","-74.0157","1","0","0","0","0","0","0","1","0","0","1","0","1","0","0","1","0","1","0","1","0","0","0","1"
"Cornwall","46.22652","-63.21809","1","0","0","0","0","0","0","1","0","0","1","0","1","0","0","1","0","1","0","1","0","0","0","1"
"Coro","11.4045","-69.67344","1","0","0","0","0","0","0","1","0","1","0","0","1","1","0","0","0","1","1","0","0","0","0","1"
"Corona","33.87529","-117.56644","1","0","0","0","0","0","0","1","0","1","0","0","1","1","0","0","0","1","1","0","0","0","0","1"
"Corona","40.74705","-73.86014","1","0","0","0","0","0","0","1","0","1","0","0","1","1","0","0","0","1","1","0","0","0","0","1"
"Corozal","21.54627","-98.55444","1","0","0","0","0","0","0","1","0","1","0","0","1","0","1","0","0","1","1","0","0","0","0","1"
"Corozal","18.39375","-88.38849","1","0","0","0","0","0","0","1","0","1","0","0","1","0","1","0","0","1","1","0","0","0","0","1"
"Corozal","15.8","-86.71667","1","0","0","0","0","0","0","1","0","1","0","0","1","0","1","0","0","1","1","0","0","0","0","1"
"Corozal","8.07712","-81.4399","1","0","0","0","0","0","0","1","0","1","0","0","1","0","1","0","0","1","1","0","0","0","0","1"
"Corozal","8.20108","-77.59637","1","0","0","0","0","0","0","1","0","1","0","0","1","0","1","0","0","1","1","0","0","0","0","1"
"Corozal","9.31847","-75.2933","1","0","0","0","0","0","0","1","0","1","0","0","1","0","1","0","0","1","1","0","0","0","0","1"
"Corozal","18.34106","-66.31684","1","0","0","0","0","0","0","1","0","1","0","0","1","0","1","0","0","1","1","0","0","0","0","1"
"Corral de Bustos","-33.28205","-62.18463","1","0","0","0","0","0","0","1","0","1","0","0","1","0","0","1","0","1","1","0","0","0","0","1"
"Corsham","51.43433","-2.18437","7","0","0","0","1","0","2","10","0","4","6","0","10","4","1","5","0","10","0","2","8","0","0","10"
"Cosenza","39.2989","16.25307","1","0","0","0","0","0","0","1","1","0","0","0","1","0","0","1","0","1","0","0","1","0","0","1"
"Cosgrove","52.07518","-0.84801","1","0","0","0","0","0","0","1","0","1","0","0","1","1","0","0","0","1","0","0","0","0","1","1"
"Cosheston","51.69653","-4.88882","1","0","0","0","0","0","0","1","0","0","0","0","0","1","0","0","0","1","0","0","1","0","0","1"
"Cosoleacaque","17.99913","-94.6359","1","0","0","0","0","0","0","1","0","0","1","0","1","0","0","1","0","1","0","1","0","0","0","1"
"Cotonou","6.36536","2.41833","2","0","0","0","0","0","0","2","1","1","0","0","2","1","1","0","0","2","0","0","1","0","1","2"
"Cottage","-20.05972","57.62917","1","0","0","0","0","0","0","1","0","1","0","0","1","0","1","0","0","1","0","0","0","0","1","1"
"Cottingham","52.50243","-0.7554","1","0","0","0","0","0","2","3","0","1","1","0","2","1","0","2","0","3","1","1","1","0","0","3"
"Cottingham","53.78057","-0.41542","1","0","0","0","0","0","2","3","0","1","1","0","2","1","0","2","0","3","1","1","1","0","0","3"
"Coulsdon","51.32002","-0.14088","8","0","0","0","2","0","0","10","1","5","3","0","9","5","1","4","0","10","2","2","5","1","0","10"
"Courchevel","45.41538","6.63643","1","0","0","0","0","0","0","1","0","0","0","0","0","0","0","1","0","1","0","0","1","0","0","1"
"Cove","45.29653","-117.80799","0","0","0","0","0","0","1","1","0","0","0","0","0","1","0","0","0","1","0","1","0","0","0","1"
"Cove","29.82744","-94.80242","0","0","0","0","0","0","1","1","0","0","0","0","0","1","0","0","0","1","0","1","0","0","0","1"
"Cove","57.1","-2.08333","0","0","0","0","0","0","1","1","0","0","0","0","0","1","0","0","0","1","0","1","0","0","0","1"
"Coven","52.65587","-2.1353","1","0","0","0","0","0","0","1","0","0","0","0","0","1","0","0","0","1","1","0","0","0","0","1"
"Coventry","41.7001","-71.68284","62","3","0","1","9","0","5","80","17","19","30","1","67","20","12","47","1","80","17","28","34","0","1","80"
"Coventry","52.40656","-1.51217","62","3","0","1","9","0","5","80","17","19","30","1","67","20","12","47","1","80","17","28","34","0","1","80"
"Covington","47.35818","-122.12216","1","0","0","0","0","0","0","1","0","0","0","0","0","0","1","0","0","1","0","0","1","0","0","1"
"Covington","36.30754","-97.58644","1","0","0","0","0","0","0","1","0","0","0","0","0","0","1","0","0","1","0","0","1","0","0","1"
"Covington","30.47549","-90.10042","1","0","0","0","0","0","0","1","0","0","0","0","0","0","1","0","0","1","0","0","1","0","0","1"
"Covington","35.56425","-89.64647","1","0","0","0","0","0","0","1","0","0","0","0","0","0","1","0","0","1","0","0","1","0","0","1"
"Covington","40.1417","-87.39474","1","0","0","0","0","0","0","1","0","0","0","0","0","0","1","0","0","1","0","0","1","0","0","1"
"Covington","39.08367","-84.50855","1","0","0","0","0","0","0","1","0","0","0","0","0","0","1","0","0","1","0","0","1","0","0","1"
"Covington","40.11727","-84.35384","1","0","0","0","0","0","0","1","0","0","0","0","0","0","1","0","0","1","0","0","1","0","0","1"
"Covington","33.59678","-83.86018","1","0","0","0","0","0","0","1","0","0","0","0","0","0","1","0","0","1","0","0","1","0","0","1"
"Covington","37.79346","-79.99395","1","0","0","0","0","0","0","1","0","0","0","0","0","0","1","0","0","1","0","0","1","0","0","1"
"Cowbridge","51.46028","-3.44167","2","0","0","0","1","0","0","3","1","1","1","0","3","3","0","0","0","3","0","1","2","0","0","3"
"Cowdenbeath","56.11194","-3.34426","2","0","0","0","0","0","0","2","0","1","1","0","2","1","0","1","0","2","0","0","2","0","0","2"
"Cowes","50.76306","-1.29772","1","0","0","0","0","0","0","1","0","1","0","0","1","1","0","0","0","1","0","0","1","0","0","1"
"Cowes","-38.45231","145.23865","1","0","0","0","0","0","0","1","0","1","0","0","1","1","0","0","0","1","0","0","1","0","0","1"
"Cowfold","50.98945","-0.27243","1","0","0","0","0","0","0","1","0","0","0","0","0","0","0","1","0","1","0","0","1","0","0","1"
"Cox’s Bāzār","21.43973","92.00955","7","1","0","0","0","0","0","8","4","1","1","0","6","3","4","2","1","10","1","1","6","1","0","9"
"Coyoacán","19.3467","-99.16174","1","0","0","0","0","0","0","1","1","0","0","0","1","0","0","1","0","1","0","0","1","0","0","1"
"Cradley Heath","52.47214","-2.08212","2","0","0","0","0","0","1","3","1","1","1","0","3","0","1","2","0","3","1","0","2","0","0","3"
"Craigavon","54.44709","-6.387","5","0","0","0","1","0","1","7","1","2","2","0","5","1","1","5","0","7","2","1","3","0","1","7"
"Craiova","44.31667","23.8","3","0","0","0","0","0","0","3","0","0","0","0","0","2","1","0","0","3","3","0","0","0","0","3"
"Cramlington","55.08652","-1.58598","23","1","0","0","0","0","1","25","0","7","10","0","17","10","6","9","0","25","4","11","9","0","1","25"
"Cranbrook","49.49991","-115.76879","5","0","0","0","1","0","0","6","1","3","2","0","6","3","0","3","0","6","1","0","4","0","1","6"
"Cranbrook","51.09662","0.53567","5","0","0","0","1","0","0","6","1","3","2","0","6","3","0","3","0","6","1","0","4","0","1","6"
"Cranbrook","-19.30553","146.75286","5","0","0","0","1","0","0","6","1","3","2","0","6","3","0","3","0","6","1","0","4","0","1","6"
"Cranleigh","51.14209","-0.48374","3","1","0","0","0","0","0","4","0","0","3","0","3","1","2","1","0","4","0","1","3","0","0","4"
"Craven Arms","52.44308","-2.83562","0","0","0","0","1","0","0","1","0","1","0","0","1","0","1","0","0","1","0","0","1","0","0","1"
"Crawley","51.11303","-0.18312","19","0","0","1","0","0","1","21","2","7","8","0","17","8","4","9","0","21","4","7","10","0","0","21"
"Crawley","-31.98418","115.81603","19","0","0","1","0","0","1","21","2","7","8","0","17","8","4","9","0","21","4","7","10","0","0","21"
"Crawley Down","51.12061","-0.0773","0","0","0","0","2","0","0","2","1","0","0","0","1","1","0","1","0","2","0","1","1","0","0","2"
"Crediton","50.78333","-3.65","2","0","0","0","0","0","0","2","0","1","0","0","1","1","0","1","0","2","0","1","1","0","0","2"
"Crescent City","41.75595","-124.20175","1","0","0","0","0","0","0","1","0","0","0","0","0","1","0","0","0","1","0","0","1","0","0","1"
"Crescent City","40.77004","-87.85893","1","0","0","0","0","0","0","1","0","0","0","0","0","1","0","0","0","1","0","0","1","0","0","1"
"Crescent City","29.43025","-81.51063","1","0","0","0","0","0","0","1","0","0","0","0","0","1","0","0","0","1","0","0","1","0","0","1"
"Crewe","37.17321","-78.12333","15","2","0","0","0","0","1","18","2","5","4","0","11","8","2","8","0","18","8","4","5","0","1","18"
"Crewe","53.09787","-2.44161","15","2","0","0","0","0","1","18","2","5","4","0","11","8","2","8","0","18","8","4","5","0","1","18"
"Crewkerne","50.88298","-2.79588","4","1","0","0","0","0","0","5","1","1","1","0","3","2","0","3","0","5","1","1","2","0","1","5"
"Crick","52.34808","-1.13708","1","0","0","0","0","0","0","1","0","0","1","0","1","0","0","1","0","1","0","0","1","0","0","1"
"Crickhowell","51.85992","-3.13771","1","0","0","0","0","0","0","1","0","0","0","0","0","0","1","0","0","1","0","0","1","0","0","1"
"Crieff","56.37268","-3.83891","1","0","0","0","0","0","0","1","1","0","0","0","1","1","0","0","0","1","0","1","0","0","0","1"
"Crofton","42.72889","-97.49562","1","0","0","0","0","0","0","1","0","0","1","0","1","1","0","0","0","1","0","1","0","0","0","1"
"Crofton","37.04782","-87.485","1","0","0","0","0","0","0","1","0","0","1","0","1","1","0","0","0","1","0","1","0","0","0","1"
"Crofton","39.00178","-76.68747","1","0","0","0","0","0","0","1","0","0","1","0","1","1","0","0","0","1","0","1","0","0","0","1"
"Crofton","53.65639","-1.42968","1","0","0","0","0","0","0","1","0","0","1","0","1","1","0","0","0","1","0","1","0","0","0","1"
"Cromarty","57.68095","-4.0341","1","0","0","0","0","0","0","1","0","0","0","0","0","1","0","0","0","1","0","0","1","0","0","1"
"Cromer","52.93123","1.29892","1","0","0","0","0","0","0","1","0","1","0","0","1","0","0","1","0","1","1","0","0","0","0","1"
"Cromer","-33.7312","151.26788","1","0","0","0","0","0","0","1","0","1","0","0","1","0","0","1","0","1","1","0","0","0","0","1"
"Cromford","53.10848","-1.56014","1","0","0","0","0","0","0","1","0","0","0","0","0","1","0","0","0","1","0","0","1","0","0","1"
"Crondall","51.23285","-0.86329","1","0","0","0","0","0","0","1","0","0","0","0","0","0","0","1","0","1","0","0","1","0","0","1"
"Crook","54.71252","-1.7497","2","0","0","0","0","0","0","2","0","2","0","0","2","0","1","1","0","2","1","1","0","0","0","2"
"Crosby","48.9142","-103.29491","3","0","0","0","0","0","0","3","0","1","1","0","2","0","3","0","0","3","0","0","3","0","0","3"
"Crosby","29.91189","-95.06215","3","0","0","0","0","0","0","3","0","1","1","0","2","0","3","0","0","3","0","0","3","0","0","3"
"Crosby","46.48218","-93.95776","3","0","0","0","0","0","0","3","0","1","1","0","2","0","3","0","0","3","0","0","3","0","0","3"
"Crosby","54.18333","-4.56667","3","0","0","0","0","0","0","3","0","1","1","0","2","0","3","0","0","3","0","0","3","0","0","3"
"Crosby","53.47778","-3.03333","3","0","0","0","0","0","0","3","0","1","1","0","2","0","3","0","0","3","0","0","3","0","0","3"
"Crosne","48.71921","2.45728","1","0","0","0","0","0","0","1","0","0","0","0","0","0","0","1","0","1","0","0","1","0","0","1"
"Crossgates","56.08366","-3.37712","1","0","0","0","0","0","0","1","0","0","1","0","1","0","0","1","0","1","0","1","0","0","0","1"
"Cross Hands","51.79306","-4.0875","1","0","0","0","0","0","0","1","0","1","0","0","1","0","0","1","0","1","1","0","0","0","0","1"
"Crosskeys","51.61917","-3.12361","1","0","0","0","0","0","0","1","0","0","1","0","1","0","0","1","0","1","0","0","1","0","0","1"
"Crowborough","51.06098","0.16342","6","0","0","0","0","0","0","6","0","4","2","0","6","1","3","2","0","6","1","2","2","0","1","6"
"Crowthorne","51.37027","-0.79219","5","0","0","0","0","0","1","6","0","1","1","0","2","2","1","3","0","6","2","1","3","0","0","6"
"Croydon","40.08733","-74.9035","101","10","0","4","11","0","7","133","28","30","49","4","111","39","19","72","3","133","23","33","69","4","4","133"
"Croydon","43.45063","-72.16314","101","10","0","4","11","0","7","133","28","30","49","4","111","39","19","72","3","133","23","33","69","4","4","133"
"Croydon","51.38333","-0.1","101","10","0","4","11","0","7","133","28","30","49","4","111","39","19","72","3","133","23","33","69","4","4","133"
"Croydon","-37.8","145.28333","101","10","0","4","11","0","7","133","28","30","49","4","111","39","19","72","3","133","23","33","69","4","4","133"
"Croydon","-33.88333","151.11667","101","10","0","4","11","0","7","133","28","30","49","4","111","39","19","72","3","133","23","33","69","4","4","133"
"Crymych","51.97361","-4.64722","2","0","0","0","1","0","0","3","0","1","1","0","2","1","0","2","0","3","1","1","1","0","0","3"
"Cuauhtemoc","24.29037","-103.80913","1","0","0","0","0","0","0","1","0","0","0","0","0","0","1","0","0","1","0","0","0","1","0","1"
"Cuautitlán Izcalli","19.64388","-99.21598","1","0","0","0","0","0","0","1","0","0","1","0","1","0","0","1","0","1","0","1","0","0","0","1"
"Cúcuta","7.89391","-72.50782","1","0","0","0","0","0","0","1","0","1","0","0","1","0","0","1","0","1","1","0","0","0","0","1"
"Cuddapah","14.47995","78.82346","1","0","0","0","0","0","0","1","1","0","0","0","1","0","1","0","0","1","1","0","0","0","0","1"
"Cudworth","53.57131","-1.41595","0","0","0","0","1","0","0","1","0","0","1","0","1","0","0","1","0","1","0","1","0","0","0","1"
"Cuenca","-2.90055","-79.00453","1","0","0","0","0","0","0","1","0","0","0","0","0","0","1","0","0","1","0","0","1","0","0","1"
"Cuenca","-12.43333","-75.03333","1","0","0","0","0","0","0","1","0","0","0","0","0","0","1","0","0","1","0","0","1","0","0","1"
"Cuenca","40.06667","-2.13333","1","0","0","0","0","0","0","1","0","0","0","0","0","0","1","0","0","1","0","0","1","0","0","1"
"Cuenca","13.902","121.0521","1","0","0","0","0","0","0","1","0","0","0","0","0","0","1","0","0","1","0","0","1","0","0","1"
"Cugir","45.83651","23.36998","1","0","0","0","0","0","0","1","1","0","0","0","1","0","1","0","0","1","0","0","1","0","0","1"
"Cuilapa","14.27639","-90.29889","1","0","0","0","0","0","0","1","1","0","0","0","1","1","0","0","0","1","0","0","1","0","0","1"
"Cullompton","50.8553","-3.39268","5","0","0","0","0","0","0","5","0","3","1","0","4","0","0","4","1","5","1","0","4","0","0","5"
"Culpeper","38.47318","-77.99666","1","0","0","0","0","0","0","1","0","0","0","0","0","1","0","0","0","1","1","0","0","0","0","1"
"Cumbernauld","55.94685","-3.99051","6","0","0","0","0","0","0","6","1","1","3","0","5","1","2","3","0","6","2","0","4","0","0","6"
"Cumming","34.20732","-84.14019","1","0","0","0","0","0","0","1","0","0","0","0","0","0","0","1","0","1","0","0","1","0","0","1"
"Cumnock","55.45445","-4.26644","2","0","0","0","0","0","0","2","0","2","0","0","2","0","1","1","0","2","2","0","0","0","0","2"
"Cupar","56.31876","-3.01204","5","0","0","2","0","0","2","9","4","3","2","0","9","1","1","7","0","9","2","0","6","0","0","8"
"Curepipe","-20.31628","57.52594","2","0","0","0","0","0","0","2","0","1","1","0","2","0","1","1","0","2","0","0","2","0","0","2"
"Curitiba","-25.42778","-49.27306","1","0","0","0","0","0","0","1","0","0","0","0","0","0","0","1","0","1","0","1","0","0","0","1"
"Curridabat","9.91179","-84.03407","3","0","0","0","0","0","0","3","0","2","0","0","2","1","1","1","0","3","2","0","1","0","0","3"
"Currie","55.8964","-3.30845","1","0","0","0","0","0","0","1","0","0","1","0","1","0","0","1","0","1","0","0","1","0","0","1"
"Currie","-39.92976","143.85385","1","0","0","0","0","0","0","1","0","0","1","0","1","0","0","1","0","1","0","0","1","0","0","1"
"Curtea de Argeş","45.13422","24.67409","1","0","0","0","0","0","0","1","1","0","0","0","1","0","0","1","0","1","0","0","1","0","0","1"
"Cuttack","20.46497","85.87927","1","0","0","0","0","0","0","1","1","0","0","0","1","1","0","0","0","1","0","0","1","0","0","1"
"Cwmbran","51.65446","-3.02281","9","0","0","0","0","0","0","9","2","2","4","0","8","2","3","4","0","9","2","4","3","0","0","9"
"Dabwāli","29.94906","74.73832","1","0","0","0","0","0","0","1","0","1","0","0","1","1","0","0","0","1","1","0","0","0","0","1"
"Dadu","26.73033","67.7769","2","0","0","0","0","0","0","2","1","0","1","0","2","1","0","1","0","2","0","0","2","0","0","2"
"Daga","27.07529","89.87688","0","0","0","0","0","0","1","1","0","0","0","0","0","0","1","0","0","1","1","0","0","0","0","1"
"Dagenham","51.55","0.16667","4","0","0","1","0","0","0","5","1","2","0","0","3","2","0","3","0","5","1","2","2","0","0","5"
"Dagupan","16.04313","120.33325","3","0","0","0","0","0","0","3","3","0","0","0","3","0","3","0","0","3","0","3","0","0","0","3"
"Dagupan","17.70039","121.50448","3","0","0","0","0","0","0","3","3","0","0","0","3","0","3","0","0","3","0","3","0","0","0","3"
"Daifam","26.9","92.1","2","0","0","0","0","0","0","2","1","1","0","0","2","1","1","0","0","2","0","0","1","0","1","2"
"Dailekh","28.84434","81.71011","2","0","0","0","0","0","0","2","0","0","0","2","2","0","1","1","0","2","0","0","1","0","1","2"
"Dajt","41.39361","19.91583","0","0","0","0","0","0","0","0","1","0","0","0","1","0","0","1","0","1","0","0","1","0","0","1"
"Dakar","14.6937","-17.44406","7","0","0","0","1","0","0","8","0","3","4","0","7","4","3","1","0","8","1","2","2","3","0","8"
"Dalgety Bay","56.03496","-3.35049","2","0","0","0","0","0","0","2","0","1","1","0","2","1","0","1","0","2","0","1","1","0","0","2"
"Dalheim","49.54083","6.25972","1","0","0","0","0","0","0","1","0","1","0","0","1","0","1","0","0","1","1","0","0","0","0","1"
"Dalheim","49.82667","8.29528","1","0","0","0","0","0","0","1","0","1","0","0","1","0","1","0","0","1","1","0","0","0","0","1"
"Dalkeith","55.89317","-3.06806","5","0","0","0","0","0","0","5","0","1","4","0","5","2","2","1","0","5","1","1","3","0","0","5"
"Dalkeith","-31.99517","115.7998","5","0","0","0","0","0","0","5","0","1","4","0","5","2","2","1","0","5","1","1","3","0","0","5"
"Dallas","44.91928","-123.31705","2","0","0","0","0","0","1","3","0","2","0","0","2","1","1","1","0","3","1","0","2","0","0","3"
"Dallas","32.78306","-96.80667","2","0","0","0","0","0","1","3","0","2","0","0","2","1","1","1","0","3","1","0","2","0","0","3"
"Dallas","33.92371","-84.84077","2","0","0","0","0","0","1","3","0","2","0","0","2","1","1","1","0","3","1","0","2","0","0","3"
"Dallas","35.31653","-81.17619","2","0","0","0","0","0","1","3","0","2","0","0","2","1","1","1","0","3","1","0","2","0","0","3"
"Dallas","41.33619","-75.96325","2","0","0","0","0","0","1","3","0","2","0","0","2","1","1","1","0","3","1","0","2","0","0","3"
"Dallas","-37.67083","144.93542","2","0","0","0","0","0","1","3","0","2","0","0","2","1","1","1","0","3","1","0","2","0","0","3"
"Dalry","55.70956","-4.72167","1","0","0","0","0","0","0","1","0","0","0","0","0","0","0","1","0","1","0","1","0","0","0","1"
"Daly City","37.70577","-122.46192","1","0","0","0","0","0","0","1","1","0","0","0","1","1","0","0","0","1","0","0","1","0","0","1"
"Damanhūr","31.03408","30.46823","3","0","0","0","0","0","1","4","0","2","0","2","4","2","0","0","2","4","1","0","2","1","0","4"
"Damascus","45.41762","-122.45898","2","0","0","0","0","0","0","2","0","2","0","0","2","1","1","0","0","2","1","0","1","0","0","2"
"Damascus","36.63373","-81.78373","2","0","0","0","0","0","0","2","0","2","0","0","2","1","1","0","0","2","1","0","1","0","0","2"
"Damascus","39.28844","-77.20387","2","0","0","0","0","0","0","2","0","2","0","0","2","1","1","0","0","2","1","0","1","0","0","2"
"Damascus","33.5102","36.29128","2","0","0","0","0","0","0","2","0","2","0","0","2","1","1","0","0","2","1","0","1","0","0","2"
"Damaturu","11.74697","11.96083","2","0","0","0","0","0","0","2","0","2","0","0","2","1","1","0","0","2","1","0","1","0","0","2"
"Damietta","31.41648","31.81332","6","0","0","0","0","0","2","8","1","3","0","0","4","4","1","3","0","8","0","2","1","4","1","8"
"Dammam","26.43442","50.10326","17","0","0","0","1","0","0","18","7","6","0","1","14","10","7","1","0","18","7","0","10","0","1","18"
"Damoh","23.83312","79.4419","1","0","0","0","0","0","0","1","1","0","0","0","1","0","0","1","0","1","0","0","1","0","0","1"
"Dankunku","13.56667","-15.31667","1","0","0","0","0","0","0","1","0","0","0","1","1","1","0","0","0","1","0","0","0","0","1","1"
"Dar Chioukh","34.89638","3.48543","1","0","0","0","0","0","0","1","0","1","0","0","1","0","1","0","0","1","1","0","0","0","0","1"
"Dar es Salaam","-6.82349","39.26951","35","1","0","2","1","0","0","39","4","19","2","7","32","24","11","4","1","40","8","2","13","12","6","41"
"Darley","54.03333","-1.7","1","0","0","0","0","0","0","1","0","0","0","0","0","0","1","0","0","1","0","1","0","0","0","1"
"Darley","-37.65807","144.44344","1","0","0","0","0","0","0","1","0","0","0","0","0","0","1","0","0","1","0","1","0","0","0","1"
"Darlington","42.68306","-90.11763","12","0","0","0","4","0","0","16","5","3","4","0","12","4","3","9","0","16","1","3","12","0","0","16"
"Darlington","40.11004","-86.77195","12","0","0","0","4","0","0","16","5","3","4","0","12","4","3","9","0","16","1","3","12","0","0","16"
"Darlington","34.29988","-79.87617","12","0","0","0","4","0","0","16","5","3","4","0","12","4","3","9","0","16","1","3","12","0","0","16"
"Darlington","54.52429","-1.55039","12","0","0","0","4","0","0","16","5","3","4","0","12","4","3","9","0","16","1","3","12","0","0","16"
"Darlington","-31.91906","116.0812","12","0","0","0","4","0","0","16","5","3","4","0","12","4","3","9","0","16","1","3","12","0","0","16"
"Darlington","-35.03151","138.55527","12","0","0","0","4","0","0","16","5","3","4","0","12","4","3","9","0","16","1","3","12","0","0","16"
"Darlington","-33.89103","151.19548","12","0","0","0","4","0","0","16","5","3","4","0","12","4","3","9","0","16","1","3","12","0","0","16"
"Darnah","32.76704","22.63669","2","0","0","0","0","0","0","2","0","0","2","0","2","0","2","0","0","2","2","0","0","0","0","2"
"Dartford","51.44657","0.21423","13","0","0","0","0","0","0","13","1","4","5","0","10","4","0","9","0","13","4","2","6","0","1","13"
"Dartington","50.44409","-3.70958","1","0","0","0","0","0","0","1","0","0","1","0","1","1","0","0","0","1","0","1","0","0","0","1"
"Dartmouth","44.67134","-63.57719","2","0","0","0","0","0","0","2","1","0","1","0","2","1","0","1","0","2","0","2","0","0","0","2"
"Dartmouth","50.3522","-3.5794","2","0","0","0","0","0","0","2","1","0","1","0","2","1","0","1","0","2","0","2","0","0","0","2"
"Darwen","53.69803","-2.46494","4","0","0","0","0","0","0","4","1","2","1","0","4","2","1","1","0","4","2","0","2","0","0","4"
"Dashtavan","40.1001","44.39172","1","0","0","0","0","0","0","1","0","1","0","0","1","1","0","0","0","1","1","0","0","0","0","1"
"Daska Kalan","32.32422","74.35039","1","1","0","0","0","0","0","2","1","0","0","0","1","0","1","1","0","2","0","0","2","0","0","2"
"Dasmariñas","14.32944","120.93667","1","0","0","0","0","0","0","1","0","0","1","0","1","0","1","0","0","1","0","0","1","0","0","1"
"Datu Paglas","6.76667","124.85","1","0","0","0","0","0","0","1","0","1","0","0","1","0","0","1","0","1","0","0","0","0","1","1"
"Davangere","14.46693","75.92694","2","0","0","0","0","0","0","2","1","1","0","0","2","0","2","0","0","2","0","0","2","0","0","2"
"Davao","7.07306","125.61278","3","1","0","0","0","0","0","4","2","1","0","0","3","1","1","2","0","4","1","0","3","0","0","4"
"Daventry","52.25688","-1.16066","11","0","0","0","3","0","1","15","3","4","7","0","14","2","4","9","0","15","1","6","7","0","1","15"
"David","8.42729","-82.43085","2","0","0","0","0","0","0","2","1","0","0","0","1","0","2","0","0","2","1","0","1","0","0","2"
"Dayr Abū Sa‘īd","32.49816","35.68671","0","1","0","0","0","0","0","1","0","0","1","0","1","0","1","0","0","1","1","0","0","0","0","1"
"Dayr Mawās","27.64148","30.85012","2","0","0","0","0","0","0","2","0","0","1","1","2","0","0","2","0","2","1","0","1","0","0","2"
"Dayrūţ","27.55642","30.81057","2","0","0","0","0","0","0","2","1","0","0","0","1","1","0","1","0","2","0","1","1","0","0","2"
"Deal","40.24317","-74.00069","7","0","0","0","1","0","0","8","1","1","3","0","5","2","0","6","0","8","1","1","6","0","0","8"
"Deal","51.22322","1.40432","7","0","0","0","1","0","0","8","1","1","3","0","5","2","0","6","0","8","1","1","6","0","0","8"
"Deal","45.8591","23.62747","7","0","0","0","1","0","0","8","1","1","3","0","5","2","0","6","0","8","1","1","6","0","0","8"
"Deanshanger","52.04996","-0.88663","1","0","0","0","0","0","0","1","0","0","1","0","1","1","0","0","0","1","0","0","1","0","0","1"
"Dearham","54.71175","-3.44364","1","0","0","0","0","0","0","1","1","0","0","0","1","0","0","1","0","1","1","0","0","0","0","1"
"Debar","41.52444","20.52421","0","1","0","0","0","0","1","2","1","0","0","0","1","2","0","0","0","2","0","0","2","0","0","2"
"Debre Birhan","9.67954","39.53262","1","0","0","0","0","0","0","1","0","0","0","0","0","1","0","0","0","1","1","0","0","0","0","1"
"Debrecen","47.53167","21.62444","6","0","0","0","0","0","1","7","0","2","1","0","3","2","3","2","0","7","2","0","5","0","0","7"
"Debre Mark’os","10.35","37.73333","1","0","0","0","0","0","0","1","0","1","0","0","1","0","1","0","0","1","0","0","1","0","0","1"
"Deerfield","37.97974","-101.13322","1","0","0","0","0","0","0","1","0","0","0","0","0","1","0","0","0","1","1","0","0","0","0","1"
"Deerfield","43.05194","-89.07567","1","0","0","0","0","0","0","1","0","0","0","0","0","1","0","0","0","1","1","0","0","0","0","1"
"Deerfield","42.17114","-87.84451","1","0","0","0","0","0","0","1","0","0","0","0","0","1","0","0","0","1","1","0","0","0","0","1"
"Deerfield","41.88894","-83.77883","1","0","0","0","0","0","0","1","0","0","0","0","0","1","0","0","0","1","1","0","0","0","0","1"
"Deerfield","42.54453","-72.60564","1","0","0","0","0","0","0","1","0","0","0","0","0","1","0","0","0","1","1","0","0","0","0","1"
"Deerfield","44.23062","-71.61703","1","0","0","0","0","0","0","1","0","0","0","0","0","1","0","0","0","1","1","0","0","0","0","1"
"Deeside","53.20053","-3.03841","2","0","0","0","0","0","0","2","0","0","1","0","1","1","0","1","0","2","0","0","2","0","0","2"
"Deganwy","53.30446","-3.82735","1","0","0","0","0","0","0","1","0","1","0","0","1","0","0","1","0","1","0","0","1","0","0","1"
"Dehra Dūn","30.32443","78.03392","3","0","0","0","0","0","0","3","3","0","0","0","3","0","2","1","0","3","0","0","3","0","0","3"
"Dej","47.15","23.86667","1","0","0","0","0","0","0","1","0","0","0","0","0","0","1","0","0","1","1","0","0","0","0","1"
"Delabole","50.62347","-4.7319","1","0","0","0","0","0","0","1","0","1","0","0","1","1","0","0","0","1","0","0","1","0","0","1"
"Delft","52.00667","4.35556","1","0","0","0","0","0","0","1","0","0","0","0","0","0","0","1","0","1","0","0","1","0","0","1"
"Delhi","37.43216","-120.77854","25","0","0","1","2","0","0","28","14","4","3","0","21","9","5","13","0","27","2","0","22","1","2","27"
"Delhi","32.45764","-91.49317","25","0","0","1","2","0","0","28","14","4","3","0","21","9","5","13","0","27","2","0","22","1","2","27"
"Delhi","42.27814","-74.91599","25","0","0","1","2","0","0","28","14","4","3","0","21","9","5","13","0","27","2","0","22","1","2","27"
"Delhi","28.65195","77.23149","25","0","0","1","2","0","0","28","14","4","3","0","21","9","5","13","0","27","2","0","22","1","2","27"
"Del Mar","32.95949","-117.26531","1","0","0","0","0","0","0","1","0","0","0","0","0","0","0","1","0","1","0","0","1","0","0","1"
"Delray Beach","26.46146","-80.07282","1","0","0","0","0","0","0","1","0","0","0","0","0","0","0","1","0","1","0","0","1","0","0","1"
"Denbigh","53.18333","-3.41667","5","0","0","0","0","0","0","5","0","3","1","0","4","0","3","2","0","5","3","1","1","0","0","5"
"Denham","51.56667","-0.5","2","0","0","0","0","0","0","2","1","1","0","0","2","0","1","1","0","2","0","0","2","0","0","2"
"Denham","-25.92679","113.53327","2","0","0","0","0","0","0","2","1","1","0","0","2","0","1","1","0","2","0","0","2","0","0","2"
"Denistone","-33.79835","151.09051","1","0","0","0","0","0","0","1","0","0","0","0","0","0","1","0","0","1","1","0","0","0","0","1"
"Denizli","37.77417","29.0875","4","0","0","0","1","0","0","5","0","3","1","0","4","2","3","0","0","5","3","1","1","0","0","5"
"Denmead","50.90395","-1.06744","3","0","0","0","0","0","0","3","1","1","1","0","3","2","1","0","0","3","0","0","3","0","0","3"
"Denny","56.0235","-3.90812","2","0","0","0","0","0","0","2","0","0","2","0","2","0","0","2","0","2","0","1","1","0","0","2"
"Denton","33.21484","-97.13307","1","1","0","0","0","0","0","2","0","2","0","0","2","0","1","1","0","2","0","0","2","0","0","2"
"Denton","35.63347","-80.11588","1","1","0","0","0","0","0","2","0","2","0","0","2","0","1","1","0","2","0","0","2","0","0","2"
"Denton","38.88456","-75.82716","1","1","0","0","0","0","0","2","0","2","0","0","2","0","1","1","0","2","0","0","2","0","0","2"
"Denton","13.5","-14.93333","1","1","0","0","0","0","0","2","0","2","0","0","2","0","1","1","0","2","0","0","2","0","0","2"
"Denton","53.45678","-2.11822","1","1","0","0","0","0","0","2","0","2","0","0","2","0","1","1","0","2","0","0","2","0","0","2"
"Denton","54.56667","-1.66667","1","1","0","0","0","0","0","2","0","2","0","0","2","0","1","1","0","2","0","0","2","0","0","2"
"Denver","39.73915","-104.9847","15","0","0","1","0","0","0","16","2","2","4","1","9","8","2","6","0","16","2","3","11","0","0","16"
"Denver","42.67137","-92.3374","15","0","0","1","0","0","0","16","2","2","4","1","9","8","2","6","0","16","2","3","11","0","0","16"
"Denver","35.53125","-81.0298","15","0","0","1","0","0","0","16","2","2","4","1","9","8","2","6","0","16","2","3","11","0","0","16"
"Denver","40.23315","-76.13717","15","0","0","1","0","0","0","16","2","2","4","1","9","8","2","6","0","16","2","3","11","0","0","16"
"Deogarh","21.53827","84.73337","1","0","0","0","0","0","0","1","1","0","0","0","1","0","0","1","0","1","0","1","0","0","0","1"
"Deoria","26.50167","83.77936","1","0","0","0","1","0","0","2","2","0","0","0","2","1","0","1","0","2","0","0","2","0","0","2"
"Dera Allahyar","28.37353","68.35078","2","0","0","0","0","0","0","2","1","1","0","0","2","0","0","1","1","2","0","0","1","0","1","2"
"Dera Ghazi Khan","30.04587","70.64029","6","0","0","0","0","0","0","6","3","2","1","0","6","4","0","2","0","6","1","2","2","0","1","6"
"Dera Ismail Khan","31.83129","70.9017","1","2","0","0","0","0","0","3","1","0","1","0","2","1","0","1","1","3","1","1","1","0","0","3"
"Dera Murad Jamali","28.54657","68.22308","1","0","0","0","0","0","0","1","0","0","0","0","0","0","0","1","0","1","0","0","1","0","0","1"
"Derbendîxan","35.11207","45.68663","1","0","0","0","0","0","0","1","1","0","0","0","1","1","0","0","0","1","0","1","0","0","0","1"
"Derby","39.83943","-104.91859","80","2","0","3","7","0","1","93","16","24","19","0","59","34","14","45","0","93","23","22","47","0","1","93"
"Derby","37.54557","-97.26893","80","2","0","3","7","0","1","93","16","24","19","0","59","34","14","45","0","93","23","22","47","0","1","93"
"Derby","41.32065","-73.089","80","2","0","3","7","0","1","93","16","24","19","0","59","34","14","45","0","93","23","22","47","0","1","93"
"Derby","52.92277","-1.47663","80","2","0","3","7","0","1","93","16","24","19","0","59","34","14","45","0","93","23","22","47","0","1","93"
"Derby","-17.30295","123.62864","80","2","0","3","7","0","1","93","16","24","19","0","59","34","14","45","0","93","23","22","47","0","1","93"
"Deri","51.70812","-3.26312","1","0","0","0","0","0","0","1","0","1","0","0","1","1","0","0","0","1","1","0","0","0","0","1"
"Derry","40.33396","-79.29976","9","3","1","0","0","0","0","13","5","7","1","0","13","4","1","6","2","13","5","2","6","0","0","13"
"Derry","42.88064","-71.32729","9","3","1","0","0","0","0","13","5","7","1","0","13","4","1","6","2","13","5","2","6","0","0","13"
"Derry","51.58666","-9.05026","9","3","1","0","0","0","0","13","5","7","1","0","13","4","1","6","2","13","5","2","6","0","0","13"
"Derry","54.9981","-7.30934","9","3","1","0","0","0","0","13","5","7","1","0","13","4","1","6","2","13","5","2","6","0","0","13"
"De Rust","-33.49035","22.53523","1","0","0","0","0","0","0","1","1","0","0","0","1","1","0","0","0","1","0","0","1","0","0","1"
"Desborough","52.44183","-0.82126","3","0","0","0","0","0","1","4","0","3","1","0","4","1","1","1","0","3","1","1","1","0","0","3"
"Desē","11.13333","39.63333","1","0","0","0","0","0","0","1","0","1","0","0","1","0","1","0","0","1","0","0","0","0","0","0"
"Des Moines","47.40177","-122.32429","2","0","0","0","0","0","0","2","0","0","0","0","0","1","0","1","0","2","1","0","1","0","0","2"
"Des Moines","41.60054","-93.60911","2","0","0","0","0","0","0","2","0","0","0","0","0","1","0","1","0","2","1","0","1","0","0","2"
"Detroit","33.6615","-95.26662","2","0","0","0","0","0","0","2","0","0","1","1","2","2","0","0","0","2","1","0","1","0","0","2"
"Detroit","42.33143","-83.04575","2","0","0","0","0","0","0","2","0","0","1","1","2","2","0","0","0","2","1","0","1","0","0","2"
"Detroit","44.79257","-69.29671","2","0","0","0","0","0","0","2","0","0","1","1","2","2","0","0","0","2","1","0","1","0","0","2"
"Devizes","51.35084","-1.99421","3","0","0","0","0","0","0","3","1","2","0","0","3","2","0","1","0","3","0","1","2","0","0","3"
"Dewsbury","53.69076","-1.62907","13","0","0","1","2","0","1","17","6","1","4","0","11","7","1","9","0","17","2","6","8","0","1","17"
"Dhahran","26.28864","50.11396","1","0","0","0","0","0","0","1","1","0","0","0","1","1","0","0","0","1","0","0","1","0","0","1"
"Dhaka","23.7104","90.40744","205","12","0","1","12","0","1","231","106","42","25","11","184","96","47","84","5","232","33","27","125","15","31","231"
"Dhangaḍhi̇̄","28.70137","80.58975","4","0","0","0","0","0","0","4","2","0","0","1","3","2","0","2","0","4","0","1","3","0","0","4"
"Dharamsala","32.22006","76.32013","1","0","0","0","0","0","0","1","0","0","0","0","0","1","0","0","0","1","1","0","0","0","0","1"
"Dharān","26.81436","87.27972","4","0","0","0","0","0","0","4","4","0","0","0","4","2","0","2","0","4","0","0","4","0","0","4"
"Dharapuram","10.73828","77.53223","1","0","0","0","0","0","0","1","0","0","0","1","1","0","0","1","0","1","0","0","1","0","0","1"
"Dharmapuri","12.1277","78.15794","1","0","0","0","0","0","0","1","1","0","0","0","1","1","0","0","0","1","0","0","1","0","0","1"
"Dharmavaram","14.41435","77.72035","1","0","0","0","0","0","0","1","1","0","0","0","1","1","0","0","0","1","0","0","1","0","0","1"
"Dhulikhel","27.6221","85.54281","4","0","0","0","0","0","0","4","3","0","0","1","4","2","1","1","0","4","0","2","2","0","0","4"
"Dibrugarh","27.47989","94.90837","0","0","0","0","1","0","0","1","0","0","0","1","1","0","1","0","0","1","0","0","1","0","0","1"
"Didcot","51.60928","-1.24214","7","1","0","0","1","0","0","9","3","4","1","0","8","5","1","3","0","9","3","0","5","0","1","9"
"Diego Martin","10.72081","-61.56616","2","0","0","0","0","0","0","2","0","2","0","0","2","1","0","1","0","2","2","0","0","0","0","2"
"Dihok","36.86709","42.98845","9","0","0","0","0","0","0","9","5","2","0","1","8","0","5","3","1","9","3","0","6","0","0","9"
"Dikirnis","31.08898","31.59478","3","0","0","0","0","0","1","4","2","1","0","0","3","1","2","0","0","3","1","1","2","0","0","4"
"Dili","-8.55861","125.57361","3","0","0","0","0","0","0","3","2","1","0","0","3","0","0","3","0","3","0","0","2","0","0","2"
"Dimāpur","25.91174","93.7217","0","0","0","0","0","0","0","0","0","0","0","0","0","0","0","0","0","0","0","0","0","0","0","0"
"Dinājpur","25.62745","88.63779","7","0","0","0","0","0","0","7","3","1","2","0","6","2","2","1","2","7","0","0","5","1","1","7"
"Dinas Powys","51.43486","-3.21398","4","0","0","0","0","0","1","5","2","1","2","0","5","3","0","2","0","5","0","1","4","0","0","5"
"Din Daeng","13.76994","100.55299","1","0","0","0","0","0","0","1","1","0","0","0","1","0","0","1","0","1","0","0","1","0","0","1"
"Dinnington","55.05428","-1.67542","1","0","0","0","0","0","0","1","1","0","0","0","1","0","0","1","0","1","0","1","0","0","0","1"
"Dinnington","53.36667","-1.2","1","0","0","0","0","0","0","1","1","0","0","0","1","0","0","1","0","1","0","1","0","0","0","1"
"Diofior","14.18333","-16.66667","1","0","0","0","0","0","0","1","1","0","0","0","1","1","0","0","0","1","0","0","1","0","0","1"
"Dipayal","29.26083","80.94","1","0","0","0","0","0","0","1","0","0","1","0","1","0","0","1","0","1","0","0","1","0","0","1"
"Dire Dawa","9.59306","41.86611","1","0","0","0","0","0","0","1","0","1","0","1","2","1","1","0","0","2","2","0","0","0","0","2"
"Dishnā","26.12467","32.47598","0","1","0","0","0","0","0","1","0","0","1","0","1","0","0","1","0","1","0","1","0","0","0","1"
"Dispur","26.13564","91.80069","0","1","0","0","0","0","0","1","1","0","0","0","1","0","0","1","0","1","0","1","0","0","0","1"
"Diss","52.37675","1.1091","2","0","0","0","2","0","0","4","1","1","2","0","4","1","0","3","0","4","1","1","2","0","0","4"
"Disūq","31.13259","30.64784","1","1","0","0","0","0","0","2","0","1","1","0","2","0","1","1","0","2","0","1","0","0","1","2"
"Diyarbakır","37.91363","40.21721","3","0","0","0","0","0","0","3","0","1","0","2","3","2","0","0","1","3","2","0","0","1","0","3"
"Diyarb Najm","30.75438","31.44016","1","0","0","0","0","0","0","1","0","0","1","0","1","0","1","0","0","1","0","0","1","0","0","1"
"Djelfa","34.67279","3.263","1","0","0","0","0","0","0","1","0","1","0","0","1","1","0","0","0","1","1","0","0","0","0","1"
"Djibouti","11.58901","43.14503","1","0","0","0","0","0","0","1","1","0","0","0","1","1","0","0","0","1","0","0","0","1","0","1"
"Dnipro","48.4593","35.03865","4","0","0","0","1","0","0","5","1","0","2","0","3","2","2","1","0","5","1","0","3","0","1","5"
"Doba","8.65","16.85","0","1","0","0","0","0","0","1","0","1","0","0","1","0","0","1","0","1","1","0","0","0","0","1"
"Doba","47.73333","22.71667","0","1","0","0","0","0","0","1","0","1","0","0","1","0","0","1","0","1","1","0","0","0","0","1"
"Doba","47.29087","23.0961","0","1","0","0","0","0","0","1","0","1","0","0","1","0","0","1","0","1","1","0","0","0","0","1"
"Doba","44.48679","24.24397","0","1","0","0","0","0","0","1","0","1","0","0","1","0","0","1","0","1","1","0","0","0","0","1"
"Dobrich","43.56667","27.83333","1","0","0","0","0","0","0","1","0","0","0","0","0","0","1","0","0","1","0","1","0","0","0","1"
"Dodola","6.98333","39.18333","1","0","0","0","0","0","0","1","0","1","0","0","1","0","1","0","0","1","0","0","0","0","1","1"
"Dodoma","-6.17221","35.73947","8","0","0","0","1","0","0","9","0","2","2","1","5","5","4","2","0","11","1","0","2","3","5","11"
"Doha","25.28545","51.53096","28","2","0","0","1","0","0","31","7","13","5","0","25","14","8","9","0","31","15","5","11","0","0","31"
"Dolgellau","52.74222","-3.88611","1","0","0","0","0","0","0","1","0","1","0","0","1","0","0","1","0","1","0","0","1","0","0","1"
"Dollar","56.16245","-3.67135","0","0","0","1","1","0","0","2","1","1","0","0","2","1","0","1","0","2","1","0","1","0","0","2"
"Donabate","53.48722","-6.15194","1","0","0","0","0","0","0","1","0","0","1","0","1","0","0","1","0","1","0","0","1","0","0","1"
"Doncaster","53.52285","-1.13116","40","2","0","0","1","0","1","44","9","14","16","1","40","14","7","23","0","44","10","8","25","0","1","44"
"Doncaster","-37.78828","145.12373","40","2","0","0","1","0","1","44","9","14","16","1","40","14","7","23","0","44","10","8","25","0","1","44"
"Donetsk","48.023","37.80224","1","0","0","0","0","0","0","1","0","0","0","1","1","0","1","0","0","1","0","0","1","0","0","1"
"Donetsk","48.33962","39.95948","1","0","0","0","0","0","0","1","0","0","0","1","1","0","1","0","0","1","0","0","1","0","0","1"
"Donna","26.17035","-98.05195","1","0","0","0","0","0","0","1","0","0","0","0","0","1","0","0","0","1","0","0","0","0","1","1"
"Doral","25.81954","-80.35533","0","0","0","0","1","0","0","1","0","1","0","0","1","0","1","0","0","1","1","0","0","0","0","1"
"Dorchester","40.64723","-97.11337","15","1","0","0","2","0","0","18","1","6","5","0","12","11","0","7","0","18","3","6","8","0","1","18"
"Dorchester","45.00302","-90.33569","15","1","0","0","2","0","0","18","1","6","5","0","12","11","0","7","0","18","3","6","8","0","1","18"
"Dorchester","42.98339","-81.06643","15","1","0","0","2","0","0","18","1","6","5","0","12","11","0","7","0","18","3","6","8","0","1","18"
"Dorchester","50.71667","-2.43333","15","1","0","0","2","0","0","18","1","6","5","0","12","11","0","7","0","18","3","6","8","0","1","18"
"Dorking","51.23228","-0.3338","15","0","0","0","2","0","0","17","5","1","9","0","15","3","1","13","0","17","1","3","13","0","0","17"
"Dornoch","57.8805","-4.02879","1","0","0","0","0","0","0","1","0","1","0","0","1","0","0","1","0","1","0","0","1","0","0","1"
"Dortmund","51.51494","7.466","2","0","0","0","0","0","0","2","0","0","2","0","2","1","0","1","0","2","0","0","2","0","0","2"
"Dorval","45.4473","-73.75335","1","0","0","0","0","0","0","1","1","0","0","0","1","0","0","1","0","1","0","1","0","0","0","1"
"Douala","4.04827","9.70428","8","0","0","0","1","0","1","10","2","4","1","2","9","4","3","4","0","11","4","1","3","0","3","11"
"Douglas","31.34455","-109.54534","3","0","0","0","0","0","0","3","0","2","1","0","3","0","1","2","0","3","0","1","2","0","0","3"
"Douglas","42.75969","-105.38221","3","0","0","0","0","0","0","3","0","2","1","0","3","0","1","2","0","3","0","1","2","0","0","3"
"Douglas","41.83476","-87.61811","3","0","0","0","0","0","0","3","0","2","1","0","3","0","1","2","0","3","0","1","2","0","0","3"
"Douglas","34.17371","-86.32359","3","0","0","0","0","0","0","3","0","2","1","0","3","0","1","2","0","3","0","1","2","0","0","3"
"Douglas","42.64336","-86.20059","3","0","0","0","0","0","0","3","0","2","1","0","3","0","1","2","0","3","0","1","2","0","0","3"
"Douglas","31.50881","-82.84987","3","0","0","0","0","0","0","3","0","2","1","0","3","0","1","2","0","3","0","1","2","0","0","3"
"Douglas","42.05426","-71.73951","3","0","0","0","0","0","0","3","0","2","1","0","3","0","1","2","0","3","0","1","2","0","0","3"
"Douglas","54.15","-4.48333","3","0","0","0","0","0","0","3","0","2","1","0","3","0","1","2","0","3","0","1","2","0","0","3"
"Douglas","55.55","-3.85","3","0","0","0","0","0","0","3","0","2","1","0","3","0","1","2","0","3","0","1","2","0","0","3"
"Douglas","-29.05531","23.7743","3","0","0","0","0","0","0","3","0","2","1","0","3","0","1","2","0","3","0","1","2","0","0","3"
"Douglas","-19.32394","146.75234","3","0","0","0","0","0","0","3","0","2","1","0","3","0","1","2","0","3","0","1","2","0","0","3"
"Dover","48.25159","-116.61103","13","0","0","0","3","0","1","17","3","7","6","1","17","12","2","3","0","17","6","6","5","0","0","17"
"Dover","35.40147","-93.11434","13","0","0","0","3","0","1","17","3","7","6","1","17","12","2","3","0","17","6","6","5","0","0","17"
"Dover","43.97357","-92.13905","13","0","0","0","3","0","1","17","3","7","6","1","17","12","2","3","0","17","6","6","5","0","0","17"
"Dover","36.48783","-87.83836","13","0","0","0","3","0","1","17","3","7","6","1","17","12","2","3","0","17","6","6","5","0","0","17"
"Dover","27.99419","-82.21953","13","0","0","0","3","0","1","17","3","7","6","1","17","12","2","3","0","17","6","6","5","0","0","17"
"Dover","40.52062","-81.47401","13","0","0","0","3","0","1","17","3","7","6","1","17","12","2","3","0","17","6","6","5","0","0","17"
"Dover","40.00176","-76.85025","13","0","0","0","3","0","1","17","3","7","6","1","17","12","2","3","0","17","6","6","5","0","0","17"
"Dover","39.15817","-75.52437","13","0","0","0","3","0","1","17","3","7","6","1","17","12","2","3","0","17","6","6","5","0","0","17"
"Dover","40.88399","-74.5621","13","0","0","0","3","0","1","17","3","7","6","1","17","12","2","3","0","17","6","6","5","0","0","17"
"Dover","42.94369","-72.80399","13","0","0","0","3","0","1","17","3","7","6","1","17","12","2","3","0","17","6","6","5","0","0","17"
"Dover","42.24593","-71.28283","13","0","0","0","3","0","1","17","3","7","6","1","17","12","2","3","0","17","6","6","5","0","0","17"
"Dover","43.19786","-70.87367","13","0","0","0","3","0","1","17","3","7","6","1","17","12","2","3","0","17","6","6","5","0","0","17"
"Dover","51.12598","1.31257","13","0","0","0","3","0","1","17","3","7","6","1","17","12","2","3","0","17","6","6","5","0","0","17"
"Dover","-43.31423","147.01488","13","0","0","0","3","0","1","17","3","7","6","1","17","12","2","3","0","17","6","6","5","0","0","17"
"Dover Heights","-33.87083","151.27917","1","0","0","0","0","0","0","1","0","0","1","0","1","0","1","0","0","1","0","1","0","0","0","1"
"Downham Market","52.60714","0.38375","2","0","0","0","0","0","0","2","1","0","1","0","2","0","0","2","0","2","0","1","1","0","0","2"
"Downingtown","40.0065","-75.70327","2","0","0","0","0","0","0","2","2","0","0","0","2","0","2","0","0","2","0","0","2","0","0","2"
"Driffield","54.00613","-0.44495","4","0","0","0","0","0","0","4","0","0","4","0","4","0","0","4","0","4","1","0","3","0","0","4"
"Drogheda","53.71889","-6.34778","1","0","0","0","0","0","0","1","0","0","0","0","0","0","1","0","0","1","1","0","0","0","0","1"
"Droichead Nua","53.18194","-6.79667","1","0","0","0","0","0","0","1","0","1","0","0","1","1","0","0","0","1","0","1","0","0","0","1"
"Droitwich","52.26667","-2.15","4","0","0","0","1","0","0","5","0","2","3","0","5","3","0","2","0","5","1","1","3","0","0","5"
"Dromore","54.51331","-7.45886","1","1","0","0","0","0","0","2","1","1","0","0","2","0","2","0","0","2","0","0","2","0","0","2"
"Dubai","25.07725","55.30927","38","4","0","0","1","0","0","43","8","8","6","0","22","20","10","13","0","43","13","7","20","2","1","43"
"Dublin","37.70215","-121.93579","37","1","0","3","1","0","2","44","9","10","16","0","35","13","6","24","1","44","7","5","27","1","4","44"
"Dublin","32.08514","-98.34199","37","1","0","3","1","0","2","44","9","10","16","0","35","13","6","24","1","44","7","5","27","1","4","44"
"Dublin","39.81227","-85.20885","37","1","0","3","1","0","2","44","9","10","16","0","35","13","6","24","1","44","7","5","27","1","4","44"
"Dublin","40.09923","-83.11408","37","1","0","3","1","0","2","44","9","10","16","0","35","13","6","24","1","44","7","5","27","1","4","44"
"Dublin","32.54044","-82.90375","37","1","0","3","1","0","2","44","9","10","16","0","35","13","6","24","1","44","7","5","27","1","4","44"
"Dublin","37.10568","-80.68534","37","1","0","3","1","0","2","44","9","10","16","0","35","13","6","24","1","44","7","5","27","1","4","44"
"Dublin","40.37177","-75.20156","37","1","0","3","1","0","2","44","9","10","16","0","35","13","6","24","1","44","7","5","27","1","4","44"
"Dublin","42.90758","-72.06258","37","1","0","3","1","0","2","44","9","10","16","0","35","13","6","24","1","44","7","5","27","1","4","44"
"Dublin","53.33306","-6.24889","37","1","0","3","1","0","2","44","9","10","16","0","35","13","6","24","1","44","7","5","27","1","4","44"
"Dubti","11.73292","41.082","1","0","0","0","0","0","0","1","1","0","0","0","1","0","1","0","0","1","0","0","0","1","0","1"
"Dudley","32.54239","-83.07043","29","1","0","3","3","0","3","39","11","9","2","0","22","17","8","14","0","39","14","7","16","0","2","39"
"Dudley","42.0451","-71.93007","29","1","0","3","3","0","3","39","11","9","2","0","22","17","8","14","0","39","14","7","16","0","2","39"
"Dudley","52.5","-2.08333","29","1","0","3","3","0","3","39","11","9","2","0","22","17","8","14","0","39","14","7","16","0","2","39"
"Dudley","-32.99373","151.72197","29","1","0","3","3","0","3","39","11","9","2","0","22","17","8","14","0","39","14","7","16","0","2","39"
"Dufftown","57.44571","-3.12708","1","0","0","0","0","0","0","1","1","0","0","0","1","0","0","1","0","1","0","1","0","0","0","1"
"Dugopolje","43.58056","16.60278","1","0","0","0","0","0","0","1","1","0","0","0","1","0","0","1","0","1","0","0","1","0","0","1"
"Dukinfield","53.47497","-2.08809","2","0","0","0","0","0","0","2","0","1","1","0","2","0","1","1","0","2","2","0","0","0","0","2"
"Duleek","53.65667","-6.41917","1","0","0","0","0","0","0","1","0","0","1","0","1","0","0","1","0","1","0","1","0","0","0","1"
"Duluth","46.78327","-92.10658","3","0","0","0","0","0","0","3","0","2","0","0","2","1","1","1","0","3","1","1","1","0","0","3"
"Duluth","34.00288","-84.14464","3","0","0","0","0","0","0","3","0","2","0","0","2","1","1","1","0","3","1","1","1","0","0","3"
"Dumaguete","9.30722","123.30261","1","0","0","0","0","0","0","1","0","0","0","0","0","0","1","0","0","1","1","0","0","0","0","1"
"Dumbarton","37.60376","-77.49137","2","2","0","0","0","0","0","4","0","2","2","0","4","2","1","1","0","4","3","1","0","0","0","4"
"Dumbarton","55.94433","-4.57061","2","2","0","0","0","0","0","4","0","2","2","0","4","2","1","1","0","4","3","1","0","0","0","4"
"Dumfries","38.56762","-77.32804","7","0","0","0","0","0","2","9","2","6","1","0","9","2","4","3","0","9","3","3","3","0","0","9"
"Dumfries","55.06959","-3.61139","7","0","0","0","0","0","2","9","2","6","1","0","9","2","4","3","0","9","3","3","3","0","0","9"
"Dunblane","56.18843","-3.96417","1","0","0","0","0","0","0","1","0","0","1","0","1","1","0","0","0","1","0","1","0","0","0","1"
"Duncanville","32.6518","-96.90834","1","0","0","1","0","0","0","2","1","0","1","0","2","1","0","1","0","2","0","1","1","0","0","2"
"Dundaga","57.50498","22.35041","1","0","0","0","0","0","0","1","0","1","0","0","1","1","0","0","0","1","0","0","0","1","0","1"
"Dundalk","39.25066","-76.52052","2","0","0","0","0","0","0","2","0","0","2","0","2","0","0","2","0","2","0","1","1","0","0","2"
"Dundalk","54","-6.41667","2","0","0","0","0","0","0","2","0","0","2","0","2","0","0","2","0","2","0","1","1","0","0","2"
"Dundee","45.27817","-123.01094","24","0","0","0","5","0","1","30","7","14","3","2","26","6","5","17","2","30","13","5","10","0","2","30"
"Dundee","41.95727","-83.65966","24","0","0","0","5","0","1","30","7","14","3","2","26","6","5","17","2","30","13","5","10","0","2","30"
"Dundee","28.02252","-81.61924","24","0","0","0","5","0","1","30","7","14","3","2","26","6","5","17","2","30","13","5","10","0","2","30"
"Dundee","42.5234","-76.97663","24","0","0","0","5","0","1","30","7","14","3","2","26","6","5","17","2","30","13","5","10","0","2","30"
"Dundee","56.46913","-2.97489","24","0","0","0","5","0","1","30","7","14","3","2","26","6","5","17","2","30","13","5","10","0","2","30"
"Dundee","-28.16678","30.23371","24","0","0","0","5","0","1","30","7","14","3","2","26","6","5","17","2","30","13","5","10","0","2","30"
"Dundrum","53.29067","-6.25714","1","0","0","0","0","0","0","1","0","1","0","0","1","0","0","1","0","1","1","0","0","0","0","1"
"Dundrum","54.2575","-5.84455","1","0","0","0","0","0","0","1","0","1","0","0","1","0","0","1","0","1","1","0","0","0","0","1"
"Dunfermline","56.07156","-3.45887","9","0","0","0","3","0","2","14","1","5","5","0","11","7","1","6","0","14","2","0","9","1","2","14"
"Dungannon","54.50344","-6.76723","2","0","0","0","0","0","0","2","0","0","1","0","1","0","1","1","0","2","0","1","1","0","0","2"
"Dungarvan","52.08806","-7.62528","0","0","0","0","1","0","0","1","0","1","0","0","1","1","0","0","0","1","1","0","0","0","0","1"
"Dunoon","55.95031","-4.92734","1","0","0","0","0","0","0","1","0","0","1","0","1","1","0","0","0","1","0","1","0","0","0","1"
"Dunoon","-28.6846","153.31766","1","0","0","0","0","0","0","1","0","0","1","0","1","1","0","0","0","1","0","1","0","0","0","1"
"Duns","55.77704","-2.34575","1","0","0","0","1","0","0","2","1","3","0","0","4","4","0","1","0","5","0","0","2","0","3","5"
"Dunstable","42.67509","-71.48284","13","0","0","0","3","0","0","16","3","4","6","1","14","5","4","7","0","16","2","3","10","0","1","16"
"Dunstable","51.88571","-0.52288","13","0","0","0","3","0","0","16","3","4","6","1","14","5","4","7","0","16","2","3","10","0","1","16"
"Durban","-29.8579","31.0292","6","0","0","0","1","0","0","7","2","4","1","0","7","6","1","0","0","7","2","3","2","0","0","7"
"Durg","21.19147","81.27619","2","0","0","0","0","0","0","2","2","0","0","0","2","1","0","1","0","2","0","0","2","0","0","2"
"Durgapur","23.51583","87.30801","1","0","0","0","0","0","0","1","0","0","0","1","1","0","0","1","0","1","0","0","0","0","1","1"
"Durham","45.40206","-122.75287","87","6","0","3","7","0","6","109","26","29","40","1","96","36","10","61","2","109","26","28","53","0","2","109"
"Durham","39.64627","-121.79998","87","6","0","3","7","0","6","109","26","29","40","1","96","36","10","61","2","109","26","28","53","0","2","109"
"Durham","35.99403","-78.89862","87","6","0","3","7","0","6","109","26","29","40","1","96","36","10","61","2","109","26","28","53","0","2","109"
"Durham","42.39953","-74.17236","87","6","0","3","7","0","6","109","26","29","40","1","96","36","10","61","2","109","26","28","53","0","2","109"
"Durham","41.48176","-72.68121","87","6","0","3","7","0","6","109","26","29","40","1","96","36","10","61","2","109","26","28","53","0","2","109"
"Durham","43.13397","-70.92645","87","6","0","3","7","0","6","109","26","29","40","1","96","36","10","61","2","109","26","28","53","0","2","109"
"Durham","54.77676","-1.57566","87","6","0","3","7","0","6","109","26","29","40","1","96","36","10","61","2","109","26","28","53","0","2","109"
"Durrës","41.32355","19.45469","3","1","0","0","0","0","0","4","2","1","0","0","3","0","2","2","0","4","1","0","3","0","0","4"
"Dursley","51.68139","-2.35333","1","0","0","0","0","0","0","1","0","0","0","0","0","0","0","1","0","1","0","0","1","0","0","1"
"Düsseldorf","51.22172","6.77616","5","0","0","0","0","0","0","5","0","0","5","0","5","1","0","5","0","6","0","0","6","0","0","6"
"Düzce","40.83889","31.16389","1","0","0","0","0","0","0","1","0","0","0","0","0","0","1","0","0","1","1","0","0","0","0","1"
"Dymchurch","51.02544","0.99392","1","0","0","0","0","0","0","1","0","0","0","0","0","0","0","1","0","1","0","0","1","0","0","1"
"Dyserth","53.30032","-3.41262","0","0","0","0","0","0","1","1","0","1","0","0","1","1","0","0","0","1","0","0","1","0","0","1"
"Eagle Butte","45.00248","-101.23349","1","0","0","0","0","0","0","1","0","0","0","0","0","1","0","0","0","1","1","0","0","0","0","1"
"Eaglesham","55.74119","-4.27459","1","0","0","0","0","0","0","1","0","0","1","0","1","0","0","1","0","1","0","0","1","0","0","1"
"Ealing","51.51216","-0.30204","6","0","0","1","2","0","0","9","2","1","4","0","7","3","1","5","0","9","2","1","6","0","0","9"
"Ealing Broadway","51.51566","-0.30079","1","0","0","0","0","0","0","1","0","0","1","0","1","0","1","0","0","1","0","1","0","0","0","1"
"Eardisley","52.14045","-3.00843","1","0","0","0","0","0","0","1","0","0","1","0","1","0","0","1","0","1","0","1","0","0","0","1"
"Earl Shilton","52.57682","-1.31536","1","0","0","0","0","0","0","1","0","1","0","0","1","0","0","1","0","1","0","1","0","0","0","1"
"Easington","17.92397","-76.58824","2","0","0","0","0","0","0","2","0","1","1","0","2","1","0","1","0","2","0","1","1","0","0","2"
"Easington","54.78528","-1.35917","2","0","0","0","0","0","0","2","0","1","1","0","2","1","0","1","0","2","0","1","1","0","0","2"
"Easington","54.55345","-0.85058","2","0","0","0","0","0","0","2","0","1","1","0","2","1","0","1","0","2","0","1","1","0","0","2"
"Easington","53.65359","0.11501","2","0","0","0","0","0","0","2","0","1","1","0","2","1","0","1","0","2","0","1","1","0","0","2"
"Easingwold","54.1201","-1.1939","1","0","0","0","0","0","0","1","0","0","0","0","0","1","0","0","0","1","0","0","1","0","0","1"
"East Boldon","54.94452","-1.42815","5","0","0","0","0","0","0","5","0","1","3","0","4","2","2","1","0","5","2","2","1","0","0","5"
"Eastbourne","50.76871","0.28453","17","0","0","2","2","0","0","21","3","8","8","1","20","7","4","9","1","21","3","5","9","2","1","20"
"East Bridgford","52.97954","-0.96563","1","0","0","0","0","0","0","1","0","1","0","0","1","0","0","1","0","1","1","0","0","0","0","1"
"East Cowes","50.75774","-1.28815","1","0","0","0","0","0","0","1","0","0","1","0","1","0","0","1","0","1","0","1","0","0","0","1"
"East Dereham","52.68333","0.93333","1","0","0","0","0","0","0","1","0","1","0","0","1","0","1","0","0","1","0","0","0","0","1","1"
"East Grinstead","51.12382","-0.0061","7","0","0","0","1","0","0","8","1","2","4","0","7","2","2","4","0","8","1","3","4","0","0","8"
"East Horsley","51.27358","-0.43207","1","0","0","0","0","0","0","1","0","1","0","0","1","0","1","0","0","1","0","0","1","0","0","1"
"East Kilbride","55.76412","-4.17669","6","1","0","0","0","0","0","7","0","2","4","0","6","4","2","1","0","7","1","2","4","0","0","7"
"East Lansing","42.73698","-84.48387","1","0","0","0","0","0","0","1","0","0","0","0","0","0","0","1","0","1","1","0","0","0","0","1"
"East Leake","52.83015","-1.18103","1","0","0","0","0","0","0","1","0","0","0","0","0","0","0","1","0","1","0","0","1","0","0","1"
"Eastleigh","50.96667","-1.35","12","2","0","0","1","0","2","17","5","6","4","0","15","6","1","10","0","17","5","4","7","0","1","17"
"Eastleigh","-26.12965","28.15541","12","2","0","0","1","0","2","17","5","6","4","0","15","6","1","10","0","17","5","4","7","0","1","17"
"East London","-33.01529","27.91162","1","0","0","0","0","0","0","1","1","0","0","0","1","1","0","0","0","1","0","0","1","0","0","1"
"East Molesey","51.39872","-0.34916","2","1","0","0","0","0","0","3","0","1","2","0","3","2","0","1","0","3","0","0","3","0","0","3"
"East Rudham","52.8207","0.7111","1","0","0","0","0","0","0","1","0","0","0","0","0","0","1","0","0","1","0","0","1","0","0","1"
"East Tilbury","51.48053","0.41714","0","0","0","1","0","0","0","1","1","0","0","0","1","0","1","0","0","1","0","0","1","0","0","1"
"Eaton","40.53026","-104.71135","0","0","0","0","1","0","0","1","1","0","0","0","1","1","0","0","0","1","0","0","1","0","0","1"
"Eaton","40.34032","-85.3508","0","0","0","0","1","0","0","1","1","0","0","0","1","1","0","0","0","1","0","0","1","0","0","1"
"Eaton","39.74394","-84.63662","0","0","0","0","1","0","0","1","1","0","0","0","1","1","0","0","0","1","0","0","1","0","0","1"
"Eaton","53.18333","-2.2","0","0","0","0","1","0","0","1","1","0","0","0","1","1","0","0","0","1","0","0","1","0","0","1"
"Eaton","-33.31664","115.70503","0","0","0","0","1","0","0","1","1","0","0","0","1","1","0","0","0","1","0","0","1","0","0","1"
"Eaton","-12.4124","130.8807","0","0","0","0","1","0","0","1","1","0","0","0","1","1","0","0","0","1","0","0","1","0","0","1"
"Eau Claire","44.81135","-91.49849","1","0","0","0","0","0","0","1","0","0","0","0","0","1","0","0","0","1","0","0","1","0","0","1"
"Eau Claire","41.98505","-86.29974","1","0","0","0","0","0","0","1","0","0","0","0","0","1","0","0","0","1","0","0","1","0","0","1"
"Ebbw Vale","51.77714","-3.20792","9","0","0","0","1","0","0","10","2","5","2","0","9","1","3","6","0","10","6","1","3","0","0","10"
"Eccles","53.48333","-2.33333","3","0","0","0","0","0","0","3","0","3","0","0","3","1","0","2","0","3","0","0","3","0","0","3"
"Eccleshall","52.85789","-2.24971","0","0","0","0","0","0","1","1","0","0","1","0","1","0","0","1","0","1","0","1","0","0","0","1"
"Eckerö","60.21249","19.61442","1","0","0","0","0","0","0","1","0","1","0","0","1","0","0","1","0","1","1","0","0","0","0","1"
"Eckington","52.06667","-2.11667","2","0","0","0","0","0","0","2","0","1","1","0","2","0","1","1","0","2","0","0","1","1","0","2"
"Ede","7.73635","4.43536","1","0","0","0","0","0","0","1","0","1","0","0","1","0","0","1","0","1","0","0","1","0","0","1"
"Ede","52.03333","5.65833","1","0","0","0","0","0","0","1","0","1","0","0","1","0","0","1","0","1","0","0","1","0","0","1"
"Edenbridge","51.19172","0.06729","4","0","0","0","1","0","1","6","2","0","1","0","3","2","1","3","0","6","0","1","5","0","0","6"
"Eden Glen Ext 60","-26.12593","28.165","1","0","0","0","0","0","0","1","0","0","1","0","1","0","1","0","0","1","0","0","1","0","0","1"
"Edenvale","-26.14095","28.15247","2","0","0","0","0","0","0","2","1","0","1","0","2","0","0","2","0","2","0","1","1","0","0","2"
"Edgware","51.6128","-0.27539","4","0","0","1","1","0","0","6","2","0","3","0","5","2","1","3","0","6","0","3","3","0","0","6"
"Edinburgh","39.35422","-85.96666","127","4","0","8","14","0","9","162","23","47","68","1","139","58","24","79","1","162","20","36","97","2","7","162"
"Edinburgh","55.95206","-3.19648","127","4","0","8","14","0","9","162","23","47","68","1","139","58","24","79","1","162","20","36","97","2","7","162"
"Edison","31.55823","-84.73825","1","0","0","0","0","0","0","1","0","0","0","0","0","0","0","1","0","1","0","1","0","0","0","1"
"Edison","40.51872","-74.4121","1","0","0","0","0","0","0","1","0","0","0","0","0","0","0","1","0","1","0","1","0","0","0","1"
"Edmond","35.65283","-97.4781","1","0","0","0","0","0","0","1","0","0","0","0","0","1","0","0","0","1","0","0","1","0","0","1"
"Edmonton","53.55014","-113.46871","6","0","0","0","0","0","0","6","0","3","1","0","4","3","2","1","0","6","3","3","0","0","0","6"
"Edmonton","36.98006","-85.61219","6","0","0","0","0","0","0","6","0","3","1","0","4","3","2","1","0","6","3","3","0","0","0","6"
"Edmonton","-17.01902","145.74443","6","0","0","0","0","0","0","6","0","3","1","0","4","3","2","1","0","6","3","3","0","0","0","6"
"Edwardsburg","41.7956","-86.08084","1","0","0","0","0","0","0","1","0","0","0","0","0","0","0","1","0","1","0","1","0","0","0","1"
"Eenhana","-17.46667","16.33333","1","0","0","0","0","0","0","1","0","1","0","0","1","1","0","0","0","1","0","0","1","0","0","1"
"Eger","47.90265","20.37329","2","0","0","0","0","0","0","2","0","0","1","0","1","1","0","1","0","2","0","0","1","0","1","2"
"Egham","51.43158","-0.55239","6","0","0","0","0","0","2","8","1","2","4","0","7","3","0","5","0","8","1","1","6","0","0","8"
"Eglise Catholique, Centrale GIKO","-1.93653","29.8061","1","0","0","0","0","0","0","1","0","0","0","1","1","0","0","0","1","1","1","0","0","0","0","1"
"Egremont","54.47941","-3.52756","3","0","0","0","0","0","0","3","1","1","1","0","3","1","0","2","0","3","1","0","2","0","0","3"
"Eighty Four","40.18174","-80.13311","1","0","0","0","0","0","0","1","0","1","0","0","1","0","1","0","0","1","1","0","0","0","0","1"
"Eindhoven","51.44083","5.47778","2","0","0","0","0","0","0","2","0","2","0","0","2","1","0","1","0","2","1","1","0","0","0","2"
"Ekpoma","6.743","6.14029","2","0","0","0","0","0","0","2","1","0","0","0","1","1","0","1","0","2","0","0","2","0","0","2"
"Eksjö","57.66643","14.97205","1","0","0","0","0","0","0","1","0","0","0","1","1","1","0","0","0","1","0","0","0","0","1","1"
"Elbasan","41.1125","20.08222","3","1","0","0","0","0","0","4","1","1","1","0","3","1","1","1","0","3","0","1","1","0","1","3"
"El Bayadh","33.68318","1.01927","1","0","0","0","0","0","0","1","0","0","0","0","0","0","1","0","0","1","0","0","0","0","1","1"
"Elbląg","54.1522","19.40884","2","0","0","0","0","0","0","2","0","0","0","0","0","1","0","1","0","2","1","1","0","0","0","2"
"El Cajon","32.79477","-116.96253","3","0","0","0","0","0","0","3","1","1","0","0","2","2","0","1","0","3","1","1","1","0","0","3"
"Eldoret","0.52036","35.26993","9","0","0","0","0","0","0","9","0","6","0","0","6","2","6","1","0","9","5","0","0","0","4","9"
"Elford","52.69103","-1.72103","1","0","0","0","0","0","0","1","0","1","0","0","1","0","0","1","0","1","0","0","1","0","0","1"
"Elgin","45.56486","-117.91743","2","0","0","0","2","0","0","4","0","1","2","0","3","2","0","2","0","4","0","0","3","0","1","4"
"Elgin","46.4039","-101.84598","2","0","0","0","2","0","0","4","0","1","2","0","3","2","0","2","0","4","0","0","3","0","1","4"
"Elgin","34.78035","-98.29227","2","0","0","0","2","0","0","4","0","1","2","0","3","2","0","2","0","4","0","0","3","0","1","4"
"Elgin","41.98334","-98.08368","2","0","0","0","2","0","0","4","0","1","2","0","3","2","0","2","0","4","0","0","3","0","1","4"
"Elgin","30.34965","-97.37027","2","0","0","0","2","0","0","4","0","1","2","0","3","2","0","2","0","4","0","0","3","0","1","4"
"Elgin","44.13024","-92.25156","2","0","0","0","2","0","0","4","0","1","2","0","3","2","0","2","0","4","0","0","3","0","1","4"
"Elgin","42.95748","-91.63071","2","0","0","0","2","0","0","4","0","1","2","0","3","2","0","2","0","4","0","0","3","0","1","4"
"Elgin","42.03725","-88.28119","2","0","0","0","2","0","0","4","0","1","2","0","3","2","0","2","0","4","0","0","3","0","1","4"
"Elgin","34.17098","-80.79425","2","0","0","0","2","0","0","4","0","1","2","0","3","2","0","2","0","4","0","0","3","0","1","4"
"Elgin","34.67293","-80.71896","2","0","0","0","2","0","0","4","0","1","2","0","3","2","0","2","0","4","0","0","3","0","1","4"
"Elgin","57.64947","-3.31843","2","0","0","0","2","0","0","4","0","1","2","0","3","2","0","2","0","4","0","0","3","0","1","4"
"Elizabeth","39.36027","-104.59691","1","0","0","0","0","0","0","1","0","0","0","0","0","1","0","0","0","1","1","0","0","0","0","1"
"Elizabeth","30.86853","-92.79293","1","0","0","0","0","0","0","1","0","0","0","0","0","1","0","0","0","1","1","0","0","0","0","1"
"Elizabeth","42.31779","-90.22152","1","0","0","0","0","0","0","1","0","0","0","0","0","1","0","0","0","1","1","0","0","0","0","1"
"Elizabeth","39.06341","-81.39512","1","0","0","0","0","0","0","1","0","0","0","0","0","1","0","0","0","1","1","0","0","0","0","1"
"Elizabeth","40.26924","-79.88977","1","0","0","0","0","0","0","1","0","0","0","0","0","1","0","0","0","1","1","0","0","0","0","1"
"Elizabeth","40.66399","-74.2107","1","0","0","0","0","0","0","1","0","0","0","0","0","1","0","0","0","1","1","0","0","0","0","1"
"Elizabeth","-34.71944","138.67707","1","0","0","0","0","0","0","1","0","0","0","0","0","1","0","0","0","1","1","0","0","0","0","1"
"Elizabeth Downs","-34.69982","138.69132","1","0","0","0","0","0","0","1","0","1","0","0","1","1","0","0","0","1","1","0","0","0","0","1"
"El Jadid","33.25682","-8.50882","4","0","0","0","0","0","0","4","2","2","0","0","4","1","0","3","0","4","1","2","0","0","0","3"
"Elkridge","39.21261","-76.71358","0","1","0","0","0","0","0","1","0","1","0","0","1","1","0","0","0","1","1","0","0","0","0","1"
"Ellesmere","52.90838","-2.89806","1","0","0","0","0","0","0","1","1","0","0","0","1","0","0","1","0","1","0","0","1","0","0","1"
"Ellesmere Port","53.27875","-2.90134","9","0","0","1","0","0","0","10","2","3","3","0","8","2","2","6","0","10","3","3","3","0","1","10"
"Ellinikó","37.89013","23.74406","1","0","0","0","0","0","0","1","0","1","0","0","1","0","0","1","0","1","1","0","0","0","0","1"
"Ellon","57.36405","-2.07313","4","0","0","0","0","0","0","4","1","0","2","0","3","0","0","4","0","4","0","3","1","0","0","4"
"El Oued","33.35608","6.86319","1","0","0","0","0","0","0","1","0","1","0","0","1","0","1","0","0","1","1","0","0","0","0","1"
"Eloy Alfaro","-2.17579","-79.85519","1","0","0","0","0","0","0","1","1","0","0","0","1","0","1","0","0","1","0","1","0","0","0","1"
"El Paso","31.75872","-106.48693","1","0","0","0","0","0","0","1","0","0","0","0","0","0","1","0","0","1","0","0","1","0","0","1"
"El Paso","19.55651","-100.35656","1","0","0","0","0","0","0","1","0","0","0","0","0","0","1","0","0","1","0","0","1","0","0","1"
"El Paso","18.97889","-97.19","1","0","0","0","0","0","0","1","0","0","0","0","0","0","1","0","0","1","0","0","1","0","0","1"
"El Paso","44.76969","-92.34408","1","0","0","0","0","0","0","1","0","0","0","0","0","0","1","0","0","1","0","0","1","0","0","1"
"El Paso","40.7392","-89.01646","1","0","0","0","0","0","0","1","0","0","0","0","0","0","1","0","0","1","0","0","1","0","0","1"
"El Paso","9.65724","-73.74685","1","0","0","0","0","0","0","1","0","0","0","0","0","0","1","0","0","1","0","0","1","0","0","1"
"El Paso","28.65007","-17.88274","1","0","0","0","0","0","0","1","0","0","0","0","0","0","1","0","0","1","0","0","1","0","0","1"
"El Prat de Llobregat","41.32784","2.09472","1","0","0","0","0","0","0","1","1","0","0","0","1","1","0","0","0","1","0","0","1","0","0","1"
"Elst","51.91917","5.84167","1","0","0","0","0","0","0","1","0","0","1","0","1","0","1","0","0","1","0","1","0","0","0","1"
"Elsternwick","-37.88639","145.0025","1","0","0","0","0","0","0","1","0","0","1","0","1","0","0","1","0","1","0","0","1","0","0","1"
"Elstree","51.6403","-0.29693","3","1","0","1","0","0","0","5","3","1","1","0","5","2","0","3","0","5","0","4","0","0","1","5"
"El Tejar","19.07433","-96.16097","1","0","0","0","0","0","0","1","0","1","0","0","1","1","0","0","0","1","1","0","0","0","0","1"
"El Tejar","14.64683","-90.79122","1","0","0","0","0","0","0","1","0","1","0","0","1","1","0","0","0","1","1","0","0","0","0","1"
"El Tejar","8.42973","-82.57294","1","0","0","0","0","0","0","1","0","1","0","0","1","1","0","0","0","1","1","0","0","0","0","1"
"Ely","39.24744","-114.88863","15","0","0","0","0","0","0","15","2","2","7","2","13","3","3","9","0","15","1","5","9","0","0","15"
"Ely","47.90324","-91.86709","15","0","0","0","0","0","0","15","2","2","7","2","13","3","3","9","0","15","1","5","9","0","0","15"
"Ely","41.87362","-91.58518","15","0","0","0","0","0","0","15","2","2","7","2","13","3","3","9","0","15","1","5","9","0","0","15"
"Ely","52.39964","0.26196","15","0","0","0","0","0","0","15","2","2","7","2","13","3","3","9","0","15","1","5","9","0","0","15"
"Embu","-23.64889","-46.85222","2","0","0","1","0","0","0","3","0","1","0","2","3","2","0","1","0","3","0","1","1","0","1","3"
"Embu","-0.53987","37.45743","2","0","0","1","0","0","0","3","0","1","0","2","3","2","0","1","0","3","0","1","1","0","1","3"
"Empangeni","-28.76197","31.89329","1","0","0","0","0","0","0","1","1","0","0","0","1","0","1","0","0","1","0","0","1","0","0","1"
"Emsworth","40.51007","-80.0945","4","0","0","0","1","0","2","7","2","1","3","0","6","7","0","0","0","7","0","2","5","0","0","7"
"Emsworth","50.84779","-0.93697","4","0","0","0","1","0","2","7","2","1","3","0","6","7","0","0","0","7","0","2","5","0","0","7"
"Emure-Ekiti","7.43636","5.45925","1","0","0","0","0","0","0","1","1","0","0","0","1","0","0","0","0","0","0","1","0","0","0","1"
"Enfield Town","51.65147","-0.08497","15","0","0","0","0","0","0","15","3","2","3","0","8","5","2","8","0","15","4","6","5","0","0","15"
"Ennis","45.34882","-111.7297","1","0","0","0","0","0","0","1","0","0","1","0","1","0","0","1","0","1","0","0","1","0","0","1"
"Ennis","32.32931","-96.62527","1","0","0","0","0","0","0","1","0","0","1","0","1","0","0","1","0","1","0","0","1","0","0","1"
"Ennis","52.84361","-8.98639","1","0","0","0","0","0","0","1","0","0","1","0","1","0","0","1","0","1","0","0","1","0","0","1"
"Enniskillen","54.34615","-7.64133","7","0","0","0","1","0","0","8","0","1","2","0","3","2","1","5","0","8","3","1","4","0","0","8"
"Ennistimon","52.94472","-9.29222","1","0","0","0","0","0","0","1","0","0","1","0","1","1","0","0","0","1","0","0","1","0","0","1"
"Enschede","52.21833","6.89583","3","0","0","0","0","0","0","3","1","2","0","0","3","2","0","1","0","3","0","0","2","0","1","3"
"Ensenada","31.87149","-116.60071","3","0","0","0","1","0","0","4","2","1","0","0","3","2","1","1","0","4","1","1","1","0","1","4"
"Ensenada","25.86961","-97.86757","3","0","0","0","1","0","0","4","2","1","0","0","3","2","1","1","0","4","1","1","1","0","1","4"
"Ensenada","-34.86186","-57.91126","3","0","0","0","1","0","0","4","2","1","0","0","3","2","1","1","0","4","1","1","1","0","1","4"
"Enstone","51.91537","-1.45371","0","0","0","0","1","0","0","1","0","0","0","0","0","1","0","0","0","1","0","0","1","0","0","1"
"Entebbe","0.05621","32.47949","2","0","0","0","1","0","0","3","0","3","0","0","3","2","0","0","1","3","2","0","0","1","0","3"
"Entrecasteaux","43.51591","6.24204","1","0","0","0","0","0","0","1","0","0","1","0","1","0","0","1","0","1","0","0","1","0","0","1"
"Enugu","6.44132","7.49883","7","1","0","0","0","0","0","8","4","2","1","0","7","6","1","1","0","8","0","1","4","1","1","7"
"Epping","43.03342","-71.07423","4","0","0","0","1","0","0","5","2","3","0","0","5","2","1","2","0","5","2","0","3","0","0","5"
"Epping","51.69815","0.11055","4","0","0","0","1","0","0","5","2","3","0","0","5","2","1","2","0","5","2","0","3","0","0","5"
"Epping","49.11178","7.31706","4","0","0","0","1","0","0","5","2","3","0","0","5","2","1","2","0","5","2","0","3","0","0","5"
"Epping","-37.65","145.03333","4","0","0","0","1","0","0","5","2","3","0","0","5","2","1","2","0","5","2","0","3","0","0","5"
"Epping","-33.77271","151.08184","4","0","0","0","1","0","0","5","2","3","0","0","5","2","1","2","0","5","2","0","3","0","0","5"
"Epsom","43.22286","-71.33201","17","1","0","0","4","0","2","24","4","4","9","0","17","11","3","10","0","24","2","7","14","0","1","24"
"Epsom","51.3305","-0.27011","17","1","0","0","4","0","2","24","4","4","9","0","17","11","3","10","0","24","2","7","14","0","1","24"
"Epsom","-36.71667","144.31667","17","1","0","0","4","0","2","24","4","4","9","0","17","11","3","10","0","24","2","7","14","0","1","24"
"Erbil","36.18333","44.01193","49","5","0","0","0","0","1","55","26","12","8","0","46","16","14","25","0","55","6","8","34","0","7","55"
"Ericeira","38.96275","-9.41563","0","0","0","1","0","0","0","1","0","1","0","0","1","1","0","0","0","1","1","0","0","0","0","1"
"Erith","51.48315","0.17484","2","0","0","0","0","0","0","2","0","1","1","0","2","1","0","1","0","2","1","0","1","0","0","2"
"Erode","11.3428","77.72741","6","0","0","0","0","0","0","6","6","0","0","0","6","0","0","5","1","6","0","0","6","0","0","6"
"Erving","42.60009","-72.39814","0","0","0","1","0","0","0","1","1","0","0","0","1","0","1","0","0","1","0","0","1","0","0","1"
"Escazú","9.91887","-84.13989","2","0","0","0","0","0","0","2","0","0","0","0","0","2","0","0","0","2","0","0","2","0","0","2"
"Esch-sur-Alzette","49.49583","5.98056","1","0","0","0","0","0","0","1","0","0","1","0","1","0","0","1","0","1","0","1","0","0","0","1"
"Esher","51.36969","-0.36693","8","0","0","1","1","0","1","11","3","2","4","0","9","4","0","6","1","11","0","1","10","0","0","11"
"Eskişehir","39.77667","30.52056","1","0","0","0","0","0","0","1","0","0","0","0","0","0","0","1","0","1","1","0","0","0","0","1"
"Esmeraldas","0.9592","-79.65397","1","0","0","0","0","0","0","1","1","0","0","0","1","0","0","1","0","1","0","0","1","0","0","1"
"Esmeraldas","-19.7625","-44.31389","1","0","0","0","0","0","0","1","1","0","0","0","1","0","0","1","0","1","0","0","1","0","0","1"
"Espoo","60.2052","24.6522","1","0","0","0","0","0","0","1","0","1","0","0","1","1","0","0","0","1","0","0","1","0","0","1"
"Essen","51.46791","4.46901","2","0","0","0","1","0","0","3","0","2","0","0","2","3","0","0","0","3","1","0","0","2","0","3"
"Essen","51.45657","7.01228","2","0","0","0","1","0","0","3","0","2","0","0","2","3","0","0","0","3","1","0","0","2","0","3"
"Essen","52.72258","7.9371","2","0","0","0","1","0","0","3","0","2","0","0","2","3","0","0","0","3","1","0","0","2","0","3"
"Esslingen","47.28325","8.71038","1","0","0","0","0","0","0","1","0","1","0","0","1","1","0","0","0","1","0","0","1","0","0","1"
"Esslingen","48.73961","9.30473","1","0","0","0","0","0","0","1","0","1","0","0","1","1","0","0","0","1","0","0","1","0","0","1"
"Estelí","13.09185","-86.35384","1","0","0","0","0","0","0","1","0","0","0","0","0","0","1","0","0","1","0","0","1","0","0","1"
"Estella-Lizarra","42.67182","-2.03226","0","0","0","0","1","0","0","1","0","0","0","0","0","0","0","1","0","1","1","0","0","0","0","1"
"Etobicoke","43.65421","-79.56711","0","0","0","0","1","0","1","2","1","0","0","0","1","0","1","1","0","2","1","0","1","0","0","2"
"Eton","34.82508","-84.76327","2","0","0","0","0","0","0","2","0","0","0","0","0","2","0","0","0","2","0","0","2","0","0","2"
"Eton","51.48833","-0.60905","2","0","0","0","0","0","0","2","0","0","0","0","0","2","0","0","0","2","0","0","2","0","0","2"
"Eton","-21.26471","148.97237","2","0","0","0","0","0","0","2","0","0","0","0","0","2","0","0","0","2","0","0","2","0","0","2"
"Etwall","52.88353","-1.60023","0","0","0","0","1","0","0","1","0","0","1","0","1","0","1","0","0","1","0","0","1","0","0","1"
"Euless","32.83707","-97.08195","2","0","0","0","0","0","0","2","0","0","2","0","2","1","1","0","0","2","0","1","1","0","0","2"
"Evanston","41.26828","-110.96324","1","0","0","0","0","0","0","1","0","0","0","0","0","0","1","0","0","1","1","0","0","0","0","1"
"Evanston","42.04114","-87.69006","1","0","0","0","0","0","0","1","0","0","0","0","0","0","1","0","0","1","1","0","0","0","0","1"
"Evanston","-34.61657","138.73369","1","0","0","0","0","0","0","1","0","0","0","0","0","0","1","0","0","1","1","0","0","0","0","1"
"Evesham","52.09237","-1.94887","4","0","0","1","1","0","1","7","1","3","2","0","6","4","0","3","0","7","2","1","4","0","0","7"
"Évora","38.56667","-7.9","1","0","0","0","0","0","0","1","1","0","0","0","1","0","0","1","0","1","0","0","1","0","0","1"
"Ewenny","51.48183","-3.57367","1","0","0","0","0","0","0","1","0","0","1","0","1","0","0","1","0","1","0","0","1","0","0","1"
"Exeter","36.29606","-119.14205","51","1","0","3","5","0","3","63","10","15","26","2","53","18","6","37","2","63","6","11","42","0","4","63"
"Exeter","40.64417","-97.45033","51","1","0","3","5","0","3","63","10","15","26","2","53","18","6","37","2","63","6","11","42","0","4","63"
"Exeter","36.67229","-93.94104","51","1","0","3","5","0","3","63","10","15","26","2","53","18","6","37","2","63","6","11","42","0","4","63"
"Exeter","41.32064","-75.81908","51","1","0","3","5","0","3","63","10","15","26","2","53","18","6","37","2","63","6","11","42","0","4","63"
"Exeter","41.5776","-71.53756","51","1","0","3","5","0","3","63","10","15","26","2","53","18","6","37","2","63","6","11","42","0","4","63"
"Exeter","42.98148","-70.94783","51","1","0","3","5","0","3","63","10","15","26","2","53","18","6","37","2","63","6","11","42","0","4","63"
"Exeter","50.7236","-3.52751","51","1","0","3","5","0","3","63","10","15","26","2","53","18","6","37","2","63","6","11","42","0","4","63"
"Exeter","-34.83994","138.48902","51","1","0","3","5","0","3","63","10","15","26","2","53","18","6","37","2","63","6","11","42","0","4","63"
"Exeter","-41.29749","146.95055","51","1","0","3","5","0","3","63","10","15","26","2","53","18","6","37","2","63","6","11","42","0","4","63"
"Exeter","-34.61283","150.32083","51","1","0","3","5","0","3","63","10","15","26","2","53","18","6","37","2","63","6","11","42","0","4","63"
"Exmouth","50.61723","-3.40233","2","0","0","1","0","0","2","5","3","1","0","0","4","4","0","1","0","5","0","1","4","0","0","5"
"Exmouth","-21.93063","114.12091","2","0","0","1","0","0","2","5","3","1","0","0","4","4","0","1","0","5","0","1","4","0","0","5"
"Exton","40.029","-75.62077","1","0","0","0","0","0","0","1","0","0","1","0","1","0","0","1","0","1","0","0","1","0","0","1"
"Exton","52.69106","-0.63463","1","0","0","0","0","0","0","1","0","0","1","0","1","0","0","1","0","1","0","0","1","0","0","1"
"Eye","52.608","-0.19209","0","0","0","1","0","0","0","1","1","0","0","0","1","0","0","1","0","1","0","1","0","0","0","1"
"Eyemouth","55.8713","-2.0901","1","0","0","0","1","0","0","2","1","1","0","0","2","1","0","1","0","2","1","0","1","0","0","2"
"Eynsham","51.78077","-1.37454","1","0","0","0","0","0","0","1","0","0","1","0","1","0","1","0","0","1","0","1","0","0","0","1"
"Factoryville","41.56313","-75.78269","1","0","0","0","0","0","0","1","0","1","0","0","1","1","0","0","0","1","0","0","1","0","0","1"
"Factoryville","40.82482","-75.20962","1","0","0","0","0","0","0","1","0","1","0","0","1","1","0","0","0","1","0","0","1","0","0","1"
"Făgăraș","45.85","24.96667","1","0","0","0","0","0","0","1","1","0","0","0","1","0","0","1","0","1","0","0","1","0","0","1"
"Failsworth","53.50484","-2.16568","1","0","0","0","1","0","0","2","0","2","0","0","2","2","0","0","0","2","0","0","1","0","0","1"
"Fairfax","37.98715","-122.58887","2","0","0","0","0","0","0","2","1","0","1","0","2","0","0","2","0","2","0","1","1","0","0","2"
"Fairfax","36.57366","-96.7042","2","0","0","0","0","0","0","2","1","0","1","0","2","0","0","2","0","2","0","1","1","0","0","2"
"Fairfax","40.33861","-95.39331","2","0","0","0","0","0","0","2","1","0","1","0","2","0","0","2","0","2","0","1","1","0","0","2"
"Fairfax","44.52913","-94.72082","2","0","0","0","0","0","0","2","1","0","1","0","2","0","0","2","0","2","0","1","1","0","0","2"
"Fairfax","41.91945","-91.78101","2","0","0","0","0","0","0","2","1","0","1","0","2","0","0","2","0","2","0","1","1","0","0","2"
"Fairfax","39.14534","-84.39327","2","0","0","0","0","0","0","2","1","0","1","0","2","0","0","2","0","2","0","1","1","0","0","2"
"Fairfax","32.95905","-81.2365","2","0","0","0","0","0","0","2","1","0","1","0","2","0","0","2","0","2","0","1","1","0","0","2"
"Fairfax","38.84622","-77.30637","2","0","0","0","0","0","0","2","1","0","1","0","2","0","0","2","0","2","0","1","1","0","0","2"
"Faisalabad","31.41554","73.08969","31","1","0","0","1","0","0","33","16","7","6","1","30","11","9","13","0","33","9","1","22","2","4","38"
"Fakenham","52.82996","0.8477","3","0","0","0","0","0","0","3","0","3","0","0","3","2","0","1","0","3","2","0","1","0","0","3"
"Falam","22.91335","93.67779","2","0","0","0","0","0","0","2","0","1","0","1","2","1","0","0","1","2","0","0","2","0","0","2"
"Falkirk","56.0021","-3.78535","19","0","0","2","1","0","0","22","3","8","9","0","20","10","0","12","0","22","2","5","14","0","1","22"
"Fällanden","47.37169","8.63869","1","0","0","0","0","0","0","1","0","0","0","0","0","1","0","0","0","1","0","0","1","0","0","1"
"Fall River","43.38443","-89.04511","1","0","0","0","0","0","0","1","0","0","1","0","1","0","0","1","0","1","1","0","0","0","0","1"
"Fall River","41.70149","-71.15505","1","0","0","0","0","0","0","1","0","0","1","0","1","0","0","1","0","1","1","0","0","0","0","1"
"Fall River","44.81685","-63.6154","1","0","0","0","0","0","0","1","0","0","1","0","1","0","0","1","0","1","1","0","0","0","0","1"
"Falls Church","38.88233","-77.17109","1","0","0","0","0","0","0","1","0","0","1","0","1","0","1","0","0","1","0","0","1","0","0","1"
"Falmouth","38.67674","-84.33021","1","0","0","0","1","0","1","3","1","2","0","0","3","0","0","3","0","3","1","1","1","0","0","3"
"Falmouth","18.49358","-77.65587","1","0","0","0","1","0","1","3","1","2","0","0","3","0","0","3","0","3","1","1","1","0","0","3"
"Falmouth","38.32402","-77.46832","1","0","0","0","1","0","1","3","1","2","0","0","3","0","0","3","0","3","1","1","1","0","0","3"
"Falmouth","41.5515","-70.61475","1","0","0","0","1","0","1","3","1","2","0","0","3","0","0","3","0","3","1","1","1","0","0","3"
"Falmouth","43.72953","-70.24199","1","0","0","0","1","0","1","3","1","2","0","0","3","0","0","3","0","3","1","1","1","0","0","3"
"Falmouth","17.02741","-61.78136","1","0","0","0","1","0","1","3","1","2","0","0","3","0","0","3","0","3","1","1","1","0","0","3"
"Falmouth","50.15441","-5.07113","1","0","0","0","1","0","1","3","1","2","0","0","3","0","0","3","0","3","1","1","1","0","0","3"
"Fāqūs","30.72816","31.79697","1","0","0","0","1","0","0","2","0","0","1","1","2","1","0","1","0","2","1","0","1","0","0","2"
"Farafangana","-22.82223","47.82615","1","0","0","0","0","0","0","1","0","0","0","0","0","0","1","0","0","1","0","0","0","0","1","1"
"Fareham","50.85162","-1.17929","13","2","0","1","2","0","1","19","4","6","8","0","18","5","3","10","0","18","2","4","12","0","0","18"
"Faribault","44.29496","-93.26883","0","0","0","1","0","0","0","1","1","0","0","0","1","1","0","0","0","1","0","0","1","0","0","1"
"Faridabad","28.41124","77.31316","2","0","0","0","0","0","0","2","0","1","1","0","2","1","0","1","0","2","0","0","1","0","1","2"
"Farīdpur","28.20997","79.54149","3","0","0","0","0","0","0","3","0","0","0","2","2","1","1","0","1","3","1","1","0","0","1","3"
"Farīdpur","23.60612","89.84064","3","0","0","0","0","0","0","3","0","0","0","2","2","1","1","0","1","3","1","1","0","0","1","3"
"Faringdon","51.65644","-1.58676","1","0","0","0","1","0","0","2","1","0","1","0","2","1","0","1","0","2","0","0","2","0","0","2"
"Farmers Branch","32.92651","-96.89612","2","0","0","0","0","0","0","2","1","0","0","0","1","1","0","1","0","2","0","0","2","0","0","2"
"Farnborough","52.14289","-1.36926","18","0","0","0","0","0","0","18","0","4","11","1","16","3","4","11","0","18","4","5","8","0","1","18"
"Farnborough","51.53333","-1.36667","18","0","0","0","0","0","0","18","0","4","11","1","16","3","4","11","0","18","4","5","8","0","1","18"
"Farnborough","51.29424","-0.75565","18","0","0","0","0","0","0","18","0","4","11","1","16","3","4","11","0","18","4","5","8","0","1","18"
"Farnborough","51.35948","0.06905","18","0","0","0","0","0","0","18","0","4","11","1","16","3","4","11","0","18","4","5","8","0","1","18"
"Farnborough","-23.09122","150.74148","18","0","0","0","0","0","0","18","0","4","11","1","16","3","4","11","0","18","4","5","8","0","1","18"
"Farnham","45.28338","-72.98244","12","0","0","1","4","0","0","17","6","4","3","0","13","8","1","8","0","17","2","4","11","0","0","17"
"Farnham","51.21444","-0.80054","12","0","0","1","4","0","0","17","6","4","3","0","13","8","1","8","0","17","2","4","11","0","0","17"
"Farnham Royal","51.54208","-0.61584","1","0","0","0","0","0","0","1","1","0","0","0","1","0","0","1","0","1","1","0","0","0","0","1"
"Farnsfield","53.10223","-1.0332","2","0","0","0","0","0","0","2","0","1","1","0","2","0","0","2","0","2","0","2","0","0","0","2"
"Faro","37.01869","-7.92716","2","0","0","0","0","0","0","2","1","0","0","0","1","0","1","1","0","2","0","0","1","0","1","2"
"Farrukhābād","27.39134","79.5793","1","0","0","0","0","0","0","1","1","0","0","0","1","1","0","0","0","1","0","0","1","0","0","1"
"Farshūţ","26.05494","32.16329","1","0","0","0","0","0","0","1","1","0","0","0","1","0","1","0","0","1","0","0","1","0","0","1"
"Fatehpur","27.99486","74.95628","1","0","0","0","0","0","0","1","1","0","0","0","1","1","0","0","0","1","0","0","1","0","0","1"
"Fatehpur","25.92774","80.81266","1","0","0","0","0","0","0","1","1","0","0","0","1","1","0","0","0","1","0","0","1","0","0","1"
"Fatehpur","27.17281","81.21061","1","0","0","0","0","0","0","1","1","0","0","0","1","1","0","0","0","1","0","0","1","0","0","1"
"Faversham","51.3148","0.88856","0","0","0","0","1","0","0","1","0","1","0","0","1","1","0","0","0","1","0","0","1","0","0","1"
"Fayetteville","36.06258","-94.15743","1","0","0","0","0","0","0","1","0","1","0","0","1","0","0","1","0","1","0","0","1","0","0","1"
"Fayetteville","35.15203","-86.57055","1","0","0","0","0","0","0","1","0","1","0","0","1","0","0","1","0","1","0","0","1","0","0","1"
"Fayetteville","33.14567","-86.40581","1","0","0","0","0","0","0","1","0","1","0","0","1","0","0","1","0","1","0","0","1","0","0","1"
"Fayetteville","33.44873","-84.45493","1","0","0","0","0","0","0","1","0","1","0","0","1","0","0","1","0","1","0","0","1","0","0","1"
"Fayetteville","38.05289","-81.10399","1","0","0","0","0","0","0","1","0","1","0","0","1","0","0","1","0","1","0","0","1","0","0","1"
"Fayetteville","35.05266","-78.87836","1","0","0","0","0","0","0","1","0","1","0","0","1","0","0","1","0","1","0","0","1","0","0","1"
"Fayetteville","39.9112","-77.54999","1","0","0","0","0","0","0","1","0","1","0","0","1","0","0","1","0","1","0","0","1","0","0","1"
"Fayetteville","43.02979","-76.00436","1","0","0","0","0","0","0","1","0","1","0","0","1","0","0","1","0","1","0","0","1","0","0","1"
"Fazilpur","32.17629","75.06583","1","0","0","0","0","0","0","1","1","0","0","0","1","0","0","1","0","1","0","0","1","0","0","1"
"Felixstowe","51.96375","1.3511","3","0","0","0","0","0","0","3","0","3","0","0","3","1","0","2","0","3","1","0","2","0","0","3"
"Felling","54.95297","-1.57152","1","0","0","0","0","0","0","1","1","0","0","0","1","0","0","1","0","1","0","1","0","0","0","1"
"Feltham","51.4462","-0.41388","3","1","0","1","0","0","0","5","3","0","1","0","4","1","0","4","0","5","0","2","3","0","0","5"
"Feni","23.0144","91.3966","2","0","0","0","1","0","0","3","2","0","1","0","3","2","1","0","0","3","1","0","2","0","0","3"
"Fenstanton","52.29903","-0.06712","2","0","0","0","0","0","0","2","0","2","0","0","2","1","0","1","0","2","0","2","0","0","0","2"
"Ferizaj","42.37056","21.15528","1","0","0","0","0","0","0","1","0","0","0","0","0","0","0","1","0","1","0","0","1","0","0","1"
"Fernando de la Mora","-25.3386","-57.52167","1","0","0","0","0","0","0","1","0","0","0","0","0","0","1","0","0","1","0","0","1","0","0","1"
"Ferndale","40.57624","-124.26394","6","0","0","0","0","0","1","7","1","3","3","0","7","1","1","5","0","7","2","2","3","0","0","7"
"Ferndale","48.8465","-122.59101","6","0","0","0","0","0","1","7","1","3","3","0","7","1","1","5","0","7","2","2","3","0","0","7"
"Ferndale","42.46059","-83.13465","6","0","0","0","0","0","1","7","1","3","3","0","7","1","1","5","0","7","2","2","3","0","0","7"
"Ferndale","40.28896","-78.91475","6","0","0","0","0","0","1","7","1","3","3","0","7","1","1","5","0","7","2","2","3","0","0","7"
"Ferndale","39.18316","-76.64024","6","0","0","0","0","0","1","7","1","3","3","0","7","1","1","5","0","7","2","2","3","0","0","7"
"Ferndale","51.66056","-3.4475","6","0","0","0","0","0","1","7","1","3","3","0","7","1","1","5","0","7","2","2","3","0","0","7"
"Ferndale","-32.03494","115.92233","6","0","0","0","0","0","1","7","1","3","3","0","7","1","1","5","0","7","2","2","3","0","0","7"
"Ferndown","50.80743","-1.89975","1","0","0","0","0","0","0","1","0","1","0","0","1","0","0","1","0","1","0","1","0","0","0","1"
"Ferntree Gully","-37.88461","145.29539","1","0","0","0","0","0","0","1","0","0","1","0","1","0","0","1","0","1","1","0","0","0","0","1"
"Ferozepore","30.92574","74.61311","2","0","0","0","0","0","0","2","2","0","0","0","2","1","1","0","0","2","0","0","2","0","0","2"
"Fès","34.03313","-5.00028","5","0","0","0","0","0","0","5","2","1","0","2","5","1","1","1","2","5","1","0","4","0","0","5"
"Fichē","9.8","38.73333","0","0","0","0","0","0","0","0","1","0","0","0","1","0","1","0","0","1","0","0","1","0","0","1"
"Fier","40.72389","19.55611","5","2","0","0","0","0","0","7","3","1","1","0","5","4","0","3","0","7","0","1","4","0","2","7"
"Figueira da Foz","40.15085","-8.86179","0","0","0","0","0","0","1","1","0","0","0","0","0","0","1","0","0","1","1","0","0","0","0","1"
"Figueras","43.53943","-7.02559","1","0","0","0","0","0","0","1","1","0","0","0","1","1","0","0","0","1","0","1","0","0","0","1"
"Filabusi","-20.53333","29.28502","1","0","0","0","0","0","0","1","0","1","0","0","1","0","1","0","0","1","0","0","0","0","1","1"
"Filey","54.21","-0.28917","3","0","0","0","0","0","0","3","0","1","2","0","3","1","0","2","0","3","1","0","2","0","0","3"
"Findon","50.86816","-0.40735","1","0","0","0","0","0","0","1","0","0","0","0","0","1","0","0","0","1","0","0","1","0","0","1"
"Findon","-34.9","138.53333","1","0","0","0","0","0","0","1","0","0","0","0","0","1","0","0","0","1","0","0","1","0","0","1"
"Finedon","52.33917","-0.65008","1","0","0","0","0","0","0","1","0","1","0","0","1","0","0","1","0","1","0","0","1","0","0","1"
"Finote Selam","10.7","37.26667","1","0","0","0","0","0","0","1","0","1","0","0","1","0","0","0","0","0","0","0","0","0","0","0"
"Fishers","39.95559","-86.01387","2","0","0","0","0","0","0","2","1","0","0","0","1","0","0","2","0","2","0","0","2","0","0","2"
"Fishguard","51.99376","-4.97631","2","0","0","0","0","0","0","2","1","0","1","0","2","0","1","1","0","2","0","1","1","0","0","2"
"Fittleworth","50.9644","-0.56185","1","0","0","0","0","0","0","1","0","0","0","0","0","1","0","0","0","1","0","0","1","0","0","1"
"Fivemiletown","54.38333","-7.3","1","0","0","0","0","0","0","1","0","0","1","0","1","0","0","1","0","1","1","0","0","0","0","1"
"Fleckney","52.53497","-1.04598","1","0","0","0","0","0","0","1","0","1","0","0","1","0","0","1","0","1","1","0","0","0","0","1"
"Fleet","51.28333","-0.83333","18","0","0","0","2","0","1","21","3","6","7","0","16","9","1","11","0","21","1","7","13","0","0","21"
"Fleet","52.79321","0.05854","18","0","0","0","2","0","1","21","3","6","7","0","16","9","1","11","0","21","1","7","13","0","0","21"
"Fleetwood","40.45398","-75.81798","3","1","0","1","1","0","0","6","0","1","3","0","4","1","1","4","0","6","0","2","4","0","0","6"
"Fleetwood","53.92527","-3.01085","3","1","0","1","1","0","0","6","0","1","3","0","4","1","1","4","0","6","0","2","4","0","0","6"
"Flemington","31.85965","-81.564","1","0","0","0","0","0","0","1","1","0","0","0","1","1","0","0","0","1","0","0","1","0","0","1"
"Flemington","41.12646","-77.47165","1","0","0","0","0","0","0","1","1","0","0","0","1","1","0","0","0","1","0","0","1","0","0","1"
"Flemington","40.51233","-74.85933","1","0","0","0","0","0","0","1","1","0","0","0","1","1","0","0","0","1","0","0","1","0","0","1"
"Flemington","-37.78825","144.93001","1","0","0","0","0","0","0","1","1","0","0","0","1","1","0","0","0","1","0","0","1","0","0","1"
"Flensburg","54.78431","9.43961","1","0","0","0","0","0","0","1","0","0","1","0","1","1","0","0","0","1","0","0","1","0","0","1"
"Flint","43.01253","-83.68746","2","0","0","0","0","0","0","2","2","0","0","0","2","1","0","1","0","2","0","1","1","0","0","2"
"Flint","53.24488","-3.13231","2","0","0","0","0","0","0","2","2","0","0","0","2","1","0","1","0","2","0","1","1","0","0","2"
"Flitwick","52.00338","-0.49472","3","0","0","0","1","0","0","4","0","0","3","0","3","2","0","2","0","4","0","2","2","0","0","4"
"Florence","43.98262","-124.09984","2","0","0","0","0","0","0","2","1","0","0","0","1","0","1","1","0","2","0","0","2","0","0","2"
"Florence","46.63159","-114.079","2","0","0","0","0","0","0","2","1","0","0","0","1","0","1","1","0","2","0","0","2","0","0","2"
"Florence","33.03145","-111.38734","2","0","0","0","0","0","0","2","1","0","0","0","1","0","1","1","0","2","0","0","2","0","0","2"
"Florence","38.39028","-105.1186","2","0","0","0","0","0","0","2","1","0","0","0","1","0","1","1","0","2","0","0","2","0","0","2"
"Florence","30.8413","-97.79363","2","0","0","0","0","0","0","2","1","0","0","0","1","0","1","1","0","2","0","0","2","0","0","2"
"Florence","32.15348","-90.1312","2","0","0","0","0","0","0","2","1","0","0","0","1","0","1","1","0","2","0","0","2","0","0","2"
"Florence","45.92218","-88.2518","2","0","0","0","0","0","0","2","1","0","0","0","1","0","1","1","0","2","0","0","2","0","0","2"
"Florence","34.79981","-87.67725","2","0","0","0","0","0","0","2","1","0","0","0","1","0","1","1","0","2","0","0","2","0","0","2"
"Florence","38.99895","-84.62661","2","0","0","0","0","0","0","2","1","0","0","0","1","0","1","1","0","2","0","0","2","0","0","2"
"Florence","34.19543","-79.76256","2","0","0","0","0","0","0","2","1","0","0","0","1","0","1","1","0","2","0","0","2","0","0","2"
"Florence","39.73428","-74.91822","2","0","0","0","0","0","0","2","1","0","0","0","1","0","1","1","0","2","0","0","2","0","0","2"
"Florence","40.11955","-74.80544","2","0","0","0","0","0","0","2","1","0","0","0","1","0","1","1","0","2","0","0","2","0","0","2"
"Florence","43.77925","11.24626","2","0","0","0","0","0","0","2","1","0","0","0","1","0","1","1","0","2","0","0","2","0","0","2"
"Floreşti","44.76306","22.94778","1","0","0","0","0","0","0","1","0","0","0","0","0","1","0","0","0","1","0","0","1","0","0","1"
"Floreşti","46.74574","23.49375","1","0","0","0","0","0","0","1","0","0","0","0","0","1","0","0","0","1","0","0","1","0","0","1"
"Floreşti","45.05","25.78333","1","0","0","0","0","0","0","1","0","0","0","0","0","1","0","0","0","1","0","0","1","0","0","1"
"Floreşti","47.89137","28.29312","1","0","0","0","0","0","0","1","0","0","0","0","0","1","0","0","0","1","0","0","1","0","0","1"
"Florianópolis","-27.59667","-48.54917","1","0","0","0","0","0","0","1","1","0","0","0","1","0","1","0","0","1","1","0","0","0","0","1"
"Florida","15.03333","-88.83333","2","0","0","0","0","0","0","2","0","1","0","0","1","0","0","2","0","2","1","0","1","0","0","2"
"Florida","21.52536","-78.22579","2","0","0","0","0","0","0","2","0","1","0","0","1","0","0","2","0","2","1","0","1","0","0","2"
"Florida","3.3223","-76.2348","2","0","0","0","0","0","0","2","0","1","0","0","1","0","0","2","0","2","1","0","1","0","0","2"
"Florida","41.33176","-74.35682","2","0","0","0","0","0","0","2","0","1","0","0","1","0","0","2","0","2","1","0","1","0","0","2"
"Florida","42.66675","-73.01121","2","0","0","0","0","0","0","2","0","1","0","0","1","0","0","2","0","2","1","0","1","0","0","2"
"Florida","18.36245","-66.56128","2","0","0","0","0","0","0","2","0","1","0","0","1","0","0","2","0","2","1","0","1","0","0","2"
"Florida","-34.09556","-56.21417","2","0","0","0","0","0","0","2","0","1","0","0","1","0","0","2","0","2","1","0","1","0","0","2"
"Floridablanca","7.06222","-73.08644","1","0","0","0","0","0","0","1","0","1","0","0","1","1","0","0","0","1","0","0","0","0","1","1"
"Floridablanca","14.9775","120.5285","1","0","0","0","0","0","0","1","0","1","0","0","1","1","0","0","0","1","0","0","0","0","1","1"
"Flourtown","40.10344","-75.2124","1","0","0","0","0","0","0","1","0","0","0","0","0","1","0","0","0","1","0","0","1","0","0","1"
"Foča","43.50646","18.77854","6","0","0","0","0","0","0","6","0","0","0","0","0","0","6","0","0","6","6","0","0","0","0","6"
"Folkestone","51.08169","1.16734","9","0","0","0","1","0","0","10","1","3","3","0","7","2","2","6","0","10","3","2","5","0","0","10"
"Fomento","22.10475","-79.72141","1","0","0","0","0","0","0","1","0","1","0","0","1","1","0","0","0","1","1","0","0","0","0","1"
"Fond du Sac","-20.04732","57.584","1","0","0","0","0","0","0","1","1","0","0","0","1","0","0","1","0","1","0","1","0","0","0","1"
"Fontainebleau","48.40908","2.70177","0","0","0","0","0","0","1","1","1","0","0","0","1","0","0","1","0","1","0","0","1","0","0","1"
"Footscray","-37.8","144.9","1","0","0","0","0","0","0","1","1","0","0","0","1","0","0","1","0","1","0","0","1","0","0","1"
"Førde","61.45217","5.85717","1","0","0","0","0","0","0","1","0","1","0","0","1","0","0","1","0","1","0","0","1","0","0","1"
"Fordingbridge","50.92747","-1.79029","1","0","0","0","0","0","0","1","0","0","0","0","0","0","0","1","0","1","0","0","1","0","0","1"
"Forest Row","51.09641","0.03262","1","0","0","0","0","0","0","1","0","1","0","0","1","0","0","1","0","1","1","0","0","0","0","1"
"Forfar","56.64382","-2.89001","3","0","0","1","0","0","0","4","2","1","1","0","4","2","1","1","0","4","1","1","2","0","0","4"
"Formby","53.55838","-3.06999","1","0","0","0","1","0","0","2","0","1","1","0","2","1","0","1","0","2","0","0","2","0","0","2"
"Fort Abbas","29.19344","72.85525","1","0","0","0","0","0","0","1","0","1","0","0","1","0","0","1","0","1","0","0","0","0","0","0"
"Fort Lauderdale","26.12231","-80.14338","0","0","0","1","0","0","0","1","0","0","0","0","0","0","1","0","0","1","0","0","1","0","0","1"
"Fort Lee","37.4957","-77.33526","1","0","0","0","0","0","0","1","0","0","0","0","0","0","0","1","0","1","0","0","1","0","0","1"
"Fort Lee","37.24694","-77.33442","1","0","0","0","0","0","0","1","0","0","0","0","0","0","0","1","0","1","0","0","1","0","0","1"
"Fort Lee","40.85093","-73.97014","1","0","0","0","0","0","0","1","0","0","0","0","0","0","0","1","0","1","0","0","1","0","0","1"
"Fort Myers","26.62168","-81.84059","2","0","0","0","0","0","0","2","0","1","1","0","2","0","0","2","0","2","0","1","1","0","0","2"
"Fort Portal","0.66174","30.2748","1","0","0","0","0","0","0","1","0","0","1","0","1","0","0","1","0","1","0","0","1","0","0","1"
"Fort William","56.81648","-5.11208","2","0","0","0","0","0","0","2","0","1","1","0","2","2","0","0","0","2","0","0","1","0","1","2"
"Fort Worth","32.72541","-97.32085","1","0","0","0","0","0","0","1","0","0","0","0","0","1","0","0","0","1","1","0","0","0","0","1"
"Foulridge","53.87579","-2.16864","1","0","0","0","0","0","0","1","0","0","0","1","1","1","0","0","0","1","1","0","0","0","0","1"
"Founex","46.33277","6.19243","1","0","0","0","0","0","0","1","0","0","1","0","1","1","0","0","0","1","0","1","0","0","0","1"
"Fountain Valley","33.70918","-117.95367","1","0","0","0","0","0","0","1","0","0","0","0","0","0","0","1","0","1","0","0","1","0","0","1"
"Fowlmere","52.09343","0.07433","1","0","0","0","0","0","0","1","0","1","0","0","1","0","0","1","0","1","0","0","1","0","0","1"
"Foxrock","53.26667","-6.17417","1","0","0","0","0","0","0","1","0","0","0","0","0","1","0","0","0","1","0","0","1","0","0","1"
"Fraijanes","14.46528","-90.44083","1","0","0","0","0","0","0","1","0","1","0","0","1","1","0","0","0","1","0","1","0","0","0","1"
"Francistown","-21.17","27.50778","1","0","0","0","0","0","0","1","0","1","0","0","1","0","1","0","0","1","1","0","0","0","0","1"
"Frankfurt am Main","50.11552","8.68417","3","1","0","0","0","0","0","4","1","1","0","0","2","1","0","3","0","4","0","0","4","0","0","4"
"Franklin","42.01354","-111.80717","2","0","0","0","0","0","0","2","1","1","0","0","2","1","0","1","0","2","0","0","2","0","0","2"
"Franklin","40.09612","-98.95258","2","0","0","0","0","0","0","2","1","1","0","0","2","1","0","1","0","2","0","0","2","0","0","2"
"Franklin","31.02602","-96.48524","2","0","0","0","0","0","0","2","1","1","0","0","2","1","0","1","0","2","0","0","2","0","0","2"
"Franklin","29.79604","-91.5015","2","0","0","0","0","0","0","2","1","1","0","0","2","1","0","1","0","2","0","0","2","0","0","2"
"Franklin","39.62033","-90.044","2","0","0","0","0","0","0","2","1","1","0","0","2","1","0","1","0","2","0","0","2","0","0","2"
"Franklin","42.88863","-88.03842","2","0","0","0","0","0","0","2","1","1","0","0","2","1","0","1","0","2","0","0","2","0","0","2"
"Franklin","35.92506","-86.86889","2","0","0","0","0","0","0","2","1","1","0","0","2","1","0","1","0","2","0","0","2","0","0","2"
"Franklin","36.72226","-86.57722","2","0","0","0","0","0","0","2","1","1","0","0","2","1","0","1","0","2","0","0","2","0","0","2"
"Franklin","39.48061","-86.05499","2","0","0","0","0","0","0","2","1","1","0","0","2","1","0","1","0","2","0","0","2","0","0","2"
"Franklin","33.27762","-85.098","2","0","0","0","0","0","0","2","1","1","0","0","2","1","0","1","0","2","0","0","2","0","0","2"
"Franklin","39.55895","-84.30411","2","0","0","0","0","0","0","2","1","1","0","0","2","1","0","1","0","2","0","0","2","0","0","2"
"Franklin","35.18232","-83.38154","2","0","0","0","0","0","0","2","1","1","0","0","2","1","0","1","0","2","0","0","2","0","0","2"
"Franklin","42.52226","-83.30604","2","0","0","0","0","0","0","2","1","1","0","0","2","1","0","1","0","2","0","0","2","0","0","2"
"Franklin","35.72125","-80.49895","2","0","0","0","0","0","0","2","1","1","0","0","2","1","0","1","0","2","0","0","2","0","0","2"
"Franklin","41.39784","-79.83144","2","0","0","0","0","0","0","2","1","1","0","0","2","1","0","1","0","2","0","0","2","0","0","2"
"Franklin","38.64289","-79.33115","2","0","0","0","0","0","0","2","1","1","0","0","2","1","0","1","0","2","0","0","2","0","0","2"
"Franklin","36.67765","-76.92246","2","0","0","0","0","0","0","2","1","1","0","0","2","1","0","1","0","2","0","0","2","0","0","2"
"Franklin","41.12204","-74.58044","2","0","0","0","0","0","0","2","1","1","0","0","2","1","0","1","0","2","0","0","2","0","0","2"
"Franklin","45.03338","-73.91591","2","0","0","0","0","0","0","2","1","1","0","0","2","1","0","1","0","2","0","0","2","0","0","2"
"Franklin","43.44424","-71.6473","2","0","0","0","0","0","0","2","1","1","0","0","2","1","0","1","0","2","0","0","2","0","0","2"
"Franklin","42.08343","-71.39673","2","0","0","0","0","0","0","2","1","1","0","0","2","1","0","1","0","2","0","0","2","0","0","2"
"Franklin","44.58702","-68.23224","2","0","0","0","0","0","0","2","1","1","0","0","2","1","0","1","0","2","0","0","2","0","0","2"
"Franklin","-43.08884","147.00906","2","0","0","0","0","0","0","2","1","1","0","0","2","1","0","1","0","2","0","0","2","0","0","2"
"Franklin","-35.19946","149.14329","2","0","0","0","0","0","0","2","1","1","0","0","2","1","0","1","0","2","0","0","2","0","0","2"
"Fraser","39.94499","-105.81723","0","0","0","1","0","0","0","1","0","1","0","0","1","1","0","0","0","1","0","0","1","0","0","1"
"Fraser","42.5392","-82.94937","0","0","0","1","0","0","0","1","0","1","0","0","1","1","0","0","0","1","0","0","1","0","0","1"
"Fraser","-35.1917","149.04534","0","0","0","1","0","0","0","1","0","1","0","0","1","1","0","0","0","1","0","0","1","0","0","1"
"Frederick","40.09915","-104.9372","1","0","0","0","0","0","0","1","1","0","0","0","1","0","1","0","0","1","0","0","1","0","0","1"
"Frederick","34.39203","-99.01841","1","0","0","0","0","0","0","1","1","0","0","0","1","0","1","0","0","1","0","0","1","0","0","1"
"Frederick","39.41427","-77.41054","1","0","0","0","0","0","0","1","1","0","0","0","1","0","1","0","0","1","0","0","1","0","0","1"
"Frederiksberg","55.41618","11.56934","1","0","0","0","0","0","0","1","0","0","0","0","0","1","0","0","0","1","0","0","1","0","0","1"
"Frederiksberg","55.67938","12.53463","1","0","0","0","0","0","0","1","0","0","0","0","0","1","0","0","0","1","0","0","1","0","0","1"
"Freedom","36.93523","-121.77301","1","0","0","0","0","0","0","1","0","0","1","0","1","1","0","0","0","1","0","0","1","0","0","1"
"Freedom","40.68562","-80.25173","1","0","0","0","0","0","0","1","0","0","1","0","1","1","0","0","0","1","0","0","1","0","0","1"
"Freedom","43.8123","-71.03562","1","0","0","0","0","0","0","1","0","0","1","0","1","1","0","0","0","1","0","0","1","0","0","1"
"Freedom","44.53035","-69.29782","1","0","0","0","0","0","0","1","0","0","1","0","1","1","0","0","0","1","0","0","1","0","0","1"
"Freetown","41.76677","-71.03282","20","0","0","0","0","0","0","20","5","6","0","6","17","15","3","2","0","20","5","1","11","3","2","22"
"Freetown","17.04791","-61.70332","20","0","0","0","0","0","0","20","5","6","0","6","17","15","3","2","0","20","5","1","11","3","2","22"
"Freetown","8.43194","-13.28972","20","0","0","0","0","0","0","20","5","6","0","6","17","15","3","2","0","20","5","1","11","3","2","22"
"Freetown","8.48714","-13.2356","20","0","0","0","0","0","0","20","5","6","0","6","17","15","3","2","0","20","5","1","11","3","2","22"
"Freiburg","47.9959","7.85222","3","0","0","0","0","0","0","3","0","1","0","0","1","1","1","1","0","3","1","0","2","0","0","3"
"Freiburg","53.82529","9.28803","3","0","0","0","0","0","0","3","0","1","0","0","1","1","1","1","0","3","1","0","2","0","0","3"
"Freistadt","48.51103","14.50453","1","0","0","0","0","0","0","1","0","0","0","0","0","0","1","0","0","1","1","0","0","0","0","1"
"Fremantle","-32.05632","115.74557","2","0","0","0","0","0","0","2","0","1","1","0","2","1","0","1","0","2","1","1","0","0","0","2"
"Frimley","51.31667","-0.74544","0","1","0","0","0","0","0","1","0","0","1","0","1","0","0","1","0","1","0","0","1","0","0","1"
"Frinton-on-Sea","51.83061","1.24424","3","0","0","0","1","0","0","4","0","2","1","0","3","3","0","1","0","4","3","0","1","0","0","4"
"Frizington","54.54185","-3.4946","2","6","0","0","1","0","0","9","5","2","1","0","8","7","1","1","0","9","6","2","1","0","0","9"
"Frodsham","53.29485","-2.72745","1","0","0","0","0","0","0","1","0","0","0","0","0","1","0","0","0","1","0","0","1","0","0","1"
"Frome","18.29407","-78.15469","4","0","0","0","0","0","1","5","1","1","2","0","4","2","0","3","0","5","1","2","2","0","0","5"
"Frome","51.22834","-2.32211","4","0","0","0","0","0","1","5","1","1","2","0","4","2","0","3","0","5","1","2","2","0","0","5"
"Front Royal","38.91817","-78.19444","0","0","0","0","1","0","0","1","0","0","1","0","1","0","1","0","0","1","0","0","1","0","0","1"
"Fujiang","46.03267","127.45638","1","0","0","0","0","0","0","1","0","0","0","1","1","0","0","0","1","1","0","0","1","0","0","1"
"Fulda","43.87052","-95.60029","1","0","0","0","0","0","0","1","0","0","0","1","1","0","0","0","1","1","1","0","0","0","0","1"
"Fulda","50.55162","9.67518","1","0","0","0","0","0","0","1","0","0","0","1","1","0","0","0","1","1","1","0","0","0","0","1"
"Fulton","38.4963","-122.76999","0","0","0","0","1","0","0","1","1","0","0","0","1","1","0","0","0","1","0","0","1","0","0","1"
"Fulton","28.0614","-97.0411","0","0","0","0","1","0","0","1","1","0","0","0","1","1","0","0","0","1","0","0","1","0","0","1"
"Fulton","38.84671","-91.94796","0","0","0","0","1","0","0","1","1","0","0","0","1","1","0","0","0","1","0","0","1","0","0","1"
"Fulton","41.86725","-90.15957","0","0","0","0","1","0","0","1","1","0","0","0","1","1","0","0","0","1","0","0","1","0","0","1"
"Fulton","36.50423","-88.87423","0","0","0","0","1","0","0","1","1","0","0","0","1","1","0","0","0","1","0","0","1","0","0","1"
"Fulton","34.27399","-88.40921","0","0","0","0","1","0","0","1","1","0","0","0","1","1","0","0","0","1","0","0","1","0","0","1"
"Fulton","39.15094","-76.92303","0","0","0","0","1","0","0","1","1","0","0","0","1","1","0","0","0","1","0","0","1","0","0","1"
"Fulton","43.32285","-76.41716","0","0","0","0","1","0","0","1","1","0","0","0","1","1","0","0","0","1","0","0","1","0","0","1"
"Funafuti","-8.52425","179.19417","1","0","0","0","0","0","0","1","0","0","0","0","0","0","0","0","1","1","0","0","0","0","1","1"
"Fyfield","51.41667","-1.78333","0","0","0","0","1","0","0","1","0","1","0","0","1","1","0","0","0","1","0","0","1","0","0","1"
"Fyfield","51.74065","0.26976","0","0","0","0","1","0","0","1","0","1","0","0","1","1","0","0","0","1","0","0","1","0","0","1"
"Fylde","53.83333","-2.91667","1","0","0","0","0","0","0","1","1","0","0","0","1","0","1","0","0","1","0","0","1","0","0","1"
"Gaalkacyo","6.76972","47.43083","1","0","0","0","0","0","0","1","1","0","0","0","1","1","0","0","0","1","0","0","1","0","0","1"
"Gaborone","-24.65451","25.90859","4","0","0","0","0","0","0","4","0","2","0","2","4","3","0","0","0","3","1","0","2","0","1","4"
"Gabrovo","41.8","25.26667","2","0","0","0","0","0","0","2","0","0","1","0","1","0","1","1","0","2","1","0","1","0","0","2"
"Gabrovo","42.87472","25.33417","2","0","0","0","0","0","0","2","0","0","1","0","1","0","1","1","0","2","1","0","1","0","0","2"
"Gaerwen","53.22112","-4.27362","0","0","0","0","0","0","1","1","1","0","0","0","1","1","0","0","0","1","0","0","1","0","0","1"
"Gafsa","34.425","8.78417","2","0","0","0","0","0","0","2","0","1","1","0","2","0","0","2","0","2","0","0","2","0","0","2"
"Gaibandha","25.3293","89.5438","2","0","0","0","0","0","0","2","0","1","0","1","2","2","0","0","0","2","0","1","1","0","0","2"
"Gaillimh","53.27245","-9.05095","1","0","0","0","0","0","0","1","0","0","1","0","1","0","0","1","0","1","0","1","0","0","0","1"
"Gainesville","33.62594","-97.13335","2","0","0","0","0","0","0","2","0","0","1","0","1","1","0","1","0","2","0","1","1","0","0","2"
"Gainesville","36.60312","-92.42822","2","0","0","0","0","0","0","2","0","0","1","0","1","1","0","1","0","2","0","1","1","0","0","2"
"Gainesville","34.29788","-83.82407","2","0","0","0","0","0","0","2","0","0","1","0","1","1","0","1","0","2","0","1","1","0","0","2"
"Gainesville","29.65163","-82.32483","2","0","0","0","0","0","0","2","0","0","1","0","1","1","0","1","0","2","0","1","1","0","0","2"
"Gainesville","38.79567","-77.61388","2","0","0","0","0","0","0","2","0","0","1","0","1","1","0","1","0","2","0","1","1","0","0","2"
"Gainford","54.54718","-1.73601","1","0","0","0","0","0","0","1","0","0","1","0","1","0","0","1","0","1","0","0","1","0","0","1"
"Gainsborough","53.38333","-0.76667","3","0","0","0","0","0","0","3","1","0","0","0","1","1","1","1","0","3","0","1","1","0","1","3"
"Galanta","48.19001","17.72747","1","0","0","0","0","0","0","1","0","0","1","0","1","1","0","0","0","1","0","0","1","0","0","1"
"Galashiels","55.61458","-2.80695","2","1","0","0","0","0","0","3","0","2","1","0","3","1","1","1","0","3","1","2","0","0","0","3"
"Galaţi","45.43687","28.05028","3","0","0","0","0","0","0","3","0","0","2","1","3","0","0","2","1","3","0","1","2","0","0","3"
"Galgate","53.99362","-2.79201","1","0","0","0","0","0","0","1","0","1","0","0","1","0","1","0","0","1","0","1","0","0","0","1"
"Galița","44.09995","27.49117","0","0","0","0","1","0","0","1","0","0","0","0","0","0","1","0","0","1","1","0","0","0","0","1"
"Galle","6.0461","80.2103","2","0","0","0","0","0","0","2","1","0","0","1","2","1","0","0","1","2","0","0","0","1","1","2"
"Gambat","27.3517","68.5215","1","0","0","0","0","0","0","1","1","0","0","0","1","1","0","0","0","1","0","0","1","0","0","1"
"Gambēla","8.25","34.58333","1","0","0","0","1","0","0","2","0","1","1","0","2","0","1","0","0","1","1","0","0","0","1","2"
"Gampaha","7.0897","79.9925","3","0","0","0","1","0","0","4","4","0","0","0","4","1","1","1","1","4","0","0","4","0","0","4"
"Gandhinagar","23.21667","72.68333","1","0","0","0","0","0","0","1","1","0","0","0","1","0","0","0","0","0","0","0","0","0","0","0"
"Ganja","40.68278","46.36056","1","0","0","0","0","0","1","2","0","0","1","1","2","0","1","0","1","2","1","0","1","0","0","2"
"Gänserndorf","48.33925","16.72016","1","0","0","0","0","0","0","1","1","0","0","0","1","1","0","0","0","1","0","0","1","0","0","1"
"Garden Grove","33.77391","-117.94145","1","0","0","0","0","0","0","1","0","0","0","0","0","1","0","0","0","1","0","1","0","0","0","1"
"Garden Grove","28.48027","-82.43509","1","0","0","0","0","0","0","1","0","0","0","0","0","1","0","0","0","1","0","1","0","0","0","1"
"Gardez","33.59744","69.22592","0","0","0","0","0","0","0","0","0","0","0","0","0","0","0","0","0","0","0","0","0","0","0","0"
"Garh Maharaja","30.83383","71.90491","1","0","0","0","0","0","0","1","0","0","1","0","1","1","0","0","0","1","0","1","0","0","0","1"
"Garissa","-0.45275","39.64601","8","0","0","0","0","0","0","8","1","5","0","1","7","5","1","1","1","8","2","1","2","0","3","8"
"Garoowe","8.40207","48.48284","4","0","0","0","0","0","0","4","1","3","0","0","4","1","1","1","1","4","2","0","2","0","1","5"
"Garoua","9.30143","13.39771","1","0","0","0","0","0","0","1","0","1","0","0","1","0","1","0","0","1","0","0","1","0","0","1"
"Garrucha","37.18141","-1.82252","1","0","0","0","0","0","0","1","1","0","0","0","1","0","0","1","0","1","0","1","0","0","0","1"
"Garstang","53.90081","-2.77417","1","0","0","0","0","0","0","1","1","0","0","0","1","0","0","1","0","1","0","0","1","0","0","1"
"Gateshead","54.96209","-1.60168","28","0","0","1","1","0","1","31","6","7","11","0","24","11","5","15","0","31","8","10","12","1","0","31"
"Gateshead","-32.98208","151.69188","28","0","0","1","1","0","1","31","6","7","11","0","24","11","5","15","0","31","8","10","12","1","0","31"
"Gatineau","45.47723","-75.70164","1","0","0","0","0","0","0","1","0","0","1","0","1","0","1","0","0","1","0","0","1","0","0","1"
"Gaur","26.76448","85.27841","1","0","0","0","0","0","1","2","1","0","1","0","2","1","0","1","0","2","0","0","2","0","0","2"
"Gawsworth","53.23178","-2.17014","2","0","0","0","0","0","0","2","0","0","2","0","2","0","0","2","0","2","0","1","1","0","0","2"
"Gaya","11.88435","3.44919","1","0","0","0","0","0","0","1","1","0","0","0","1","0","0","1","0","1","0","0","1","0","0","1"
"Gaya","11.86064","9.0027","1","0","0","0","0","0","0","1","1","0","0","0","1","0","0","1","0","1","0","0","1","0","0","1"
"Gaya","24.79686","85.00385","1","0","0","0","0","0","0","1","1","0","0","0","1","0","0","1","0","1","0","0","1","0","0","1"
"Gaza","31.50161","34.46672","8","0","0","0","0","0","0","8","1","4","0","2","7","3","1","4","0","8","6","1","1","0","0","8"
"Gaziantep","37.05944","37.3825","4","1","0","0","1","0","0","6","3","0","0","0","3","2","2","2","0","6","2","1","3","0","0","6"
"Gdańsk","54.35227","18.64912","4","0","0","0","0","0","0","4","0","0","1","0","1","1","2","1","0","4","1","0","3","0","0","4"
"Geelong","-38.14711","144.36069","1","0","0","0","0","0","0","1","0","0","1","0","1","0","0","1","0","1","0","0","1","0","0","1"
"Geidam","12.89439","11.92649","0","0","0","0","0","0","0","0","0","0","0","1","1","1","0","0","0","1","1","0","0","0","0","1"
"Geita","-2.8725","32.2325","1","0","0","0","0","0","0","1","1","1","0","0","2","0","2","0","0","2","0","0","2","0","0","2"
"Geldern","51.51908","6.32363","0","1","0","0","0","0","0","1","0","1","0","0","1","0","0","1","0","1","0","0","1","0","0","1"
"General Santos","6.11278","125.17167","1","0","0","0","0","0","0","1","1","0","0","0","1","0","1","0","0","1","0","1","0","0","0","1"
"Geneva","48.74567","-122.40183","2","0","0","0","0","0","0","2","0","0","1","0","1","0","0","2","0","2","0","0","2","0","0","2"
"Geneva","40.52695","-97.59588","2","0","0","0","0","0","0","2","0","0","1","0","1","0","0","2","0","2","0","0","2","0","0","2"
"Geneva","43.82329","-93.26771","2","0","0","0","0","0","0","2","0","0","1","0","1","0","0","2","0","2","0","0","2","0","0","2"
"Geneva","41.88753","-88.30535","2","0","0","0","0","0","0","2","0","0","1","0","1","0","0","2","0","2","0","0","2","0","0","2"
"Geneva","31.03296","-85.86382","2","0","0","0","0","0","0","2","0","0","1","0","1","0","0","2","0","2","0","0","2","0","0","2"
"Geneva","39.39172","-85.71998","2","0","0","0","0","0","0","2","0","0","1","0","1","0","0","2","0","2","0","0","2","0","0","2"
"Geneva","40.59199","-84.95719","2","0","0","0","0","0","0","2","0","0","1","0","1","0","0","2","0","2","0","0","2","0","0","2"
"Geneva","39.66201","-82.43349","2","0","0","0","0","0","0","2","0","0","1","0","1","0","0","2","0","2","0","0","2","0","0","2"
"Geneva","28.73972","-81.11506","2","0","0","0","0","0","0","2","0","0","1","0","1","0","0","2","0","2","0","0","2","0","0","2"
"Geneva","41.80505","-80.94815","2","0","0","0","0","0","0","2","0","0","1","0","1","0","0","2","0","2","0","0","2","0","0","2"
"Geneva","42.86896","-76.97774","2","0","0","0","0","0","0","2","0","0","1","0","1","0","0","2","0","2","0","0","2","0","0","2"
"Geneva","-28.62191","152.98902","2","0","0","0","0","0","0","2","0","0","1","0","1","0","0","2","0","2","0","0","2","0","0","2"
"Genève","46.20222","6.14569","2","0","0","1","0","0","1","4","1","0","2","0","3","2","1","1","0","4","0","1","3","0","0","4"
"Genoa","39.00435","-119.84712","2","0","0","0","0","0","0","2","1","0","0","0","1","0","0","2","0","2","0","0","2","0","0","2"
"Genoa","41.44862","-97.73061","2","0","0","0","0","0","0","2","1","0","0","0","1","0","0","2","0","2","0","0","2","0","0","2"
"Genoa","42.09725","-88.69287","2","0","0","0","0","0","0","2","1","0","0","0","1","0","0","2","0","2","0","0","2","0","0","2"
"Genoa","41.51811","-83.35909","2","0","0","0","0","0","0","2","1","0","0","0","1","0","0","2","0","2","0","0","2","0","0","2"
"Genoa","40.78284","-81.46651","2","0","0","0","0","0","0","2","1","0","0","0","1","0","0","2","0","2","0","0","2","0","0","2"
"Genoa","44.40478","8.94439","2","0","0","0","0","0","0","2","1","0","0","0","1","0","0","2","0","2","0","0","2","0","0","2"
"Genoa City","42.49835","-88.32815","1","0","0","0","0","0","0","1","0","0","0","0","0","0","0","1","0","1","1","0","0","0","0","1"
"Gent","51.05","3.71667","1","0","0","0","0","0","0","1","0","1","0","0","1","1","0","0","0","1","1","0","0","0","0","1"
"Georgetown","38.90684","-120.83855","8","0","0","0","1","0","0","9","3","1","2","1","7","5","1","3","0","9","3","0","6","0","0","9"
"Georgetown","39.7061","-105.6975","8","0","0","0","1","0","0","9","3","1","2","1","7","5","1","3","0","9","3","0","6","0","0","9"
"Georgetown","30.63269","-97.67723","8","0","0","0","1","0","0","9","3","1","2","1","7","5","1","3","0","9","3","0","6","0","0","9"
"Georgetown","42.13975","-89.82873","8","0","0","0","1","0","0","9","3","1","2","1","7","5","1","3","0","9","3","0","6","0","0","9"
"Georgetown","39.97531","-87.63585","8","0","0","0","1","0","0","9","3","1","2","1","7","5","1","3","0","9","3","0","6","0","0","9"
"Georgetown","40.7406","-86.50473","8","0","0","0","1","0","0","9","3","1","2","1","7","5","1","3","0","9","3","0","6","0","0","9"
"Georgetown","41.72949","-86.22834","8","0","0","0","1","0","0","9","3","1","2","1","7","5","1","3","0","9","3","0","6","0","0","9"
"Georgetown","38.29451","-85.97552","8","0","0","0","1","0","0","9","3","1","2","1","7","5","1","3","0","9","3","0","6","0","0","9"
"Georgetown","31.88461","-85.10743","8","0","0","0","1","0","0","9","3","1","2","1","7","5","1","3","0","9","3","0","6","0","0","9"
"Georgetown","38.2098","-84.55883","8","0","0","0","1","0","0","9","3","1","2","1","7","5","1","3","0","9","3","0","6","0","0","9"
"Georgetown","38.86451","-83.90409","8","0","0","0","1","0","0","9","3","1","2","1","7","5","1","3","0","9","3","0","6","0","0","9"
"Georgetown","31.98326","-81.22733","8","0","0","0","1","0","0","9","3","1","2","1","7","5","1","3","0","9","3","0","6","0","0","9"
"Georgetown","33.37683","-79.2945","8","0","0","0","1","0","0","9","3","1","2","1","7","5","1","3","0","9","3","0","6","0","0","9"
"Georgetown","39.9376","-76.08329","8","0","0","0","1","0","0","9","3","1","2","1","7","5","1","3","0","9","3","0","6","0","0","9"
"Georgetown","41.2273","-75.86881","8","0","0","0","1","0","0","9","3","1","2","1","7","5","1","3","0","9","3","0","6","0","0","9"
"Georgetown","38.69011","-75.38547","8","0","0","0","1","0","0","9","3","1","2","1","7","5","1","3","0","9","3","0","6","0","0","9"
"Georgetown","41.25565","-73.43484","8","0","0","0","1","0","0","9","3","1","2","1","7","5","1","3","0","9","3","0","6","0","0","9"
"Georgetown","13.28054","-61.1185","8","0","0","0","1","0","0","9","3","1","2","1","7","5","1","3","0","9","3","0","6","0","0","9"
"Georgetown","6.80448","-58.15527","8","0","0","0","1","0","0","9","3","1","2","1","7","5","1","3","0","9","3","0","6","0","0","9"
"Georgetown","13.54039","-14.76374","8","0","0","0","1","0","0","9","3","1","2","1","7","5","1","3","0","9","3","0","6","0","0","9"
"Georgetown","-7.92861","-14.41194","8","0","0","0","1","0","0","9","3","1","2","1","7","5","1","3","0","9","3","0","6","0","0","9"
"Georgetown","-32.9081","151.73119","8","0","0","0","1","0","0","9","3","1","2","1","7","5","1","3","0","9","3","0","6","0","0","9"
"George Town","19.2866","-81.37436","1","0","0","0","0","0","0","1","0","1","0","0","1","0","0","1","0","1","0","0","0","0","1","1"
"George Town","23.51616","-75.78665","1","0","0","0","0","0","0","1","0","1","0","0","1","0","0","1","0","1","0","0","0","0","1","1"
"George Town","13.0926","80.2801","1","0","0","0","0","0","0","1","0","1","0","0","1","0","0","1","0","1","0","0","0","0","1","1"
"George Town","5.41123","100.33543","1","0","0","0","0","0","0","1","0","1","0","0","1","0","0","1","0","1","0","0","0","0","1","1"
"George Town","-41.10559","146.82606","1","0","0","0","0","0","0","1","0","1","0","0","1","0","0","1","0","1","0","0","0","0","1","1"
"Geraardsbergen","50.77343","3.88223","1","0","0","0","0","0","0","1","1","0","0","0","1","0","0","1","0","1","0","1","0","0","0","1"
"Germiston","-26.23481","28.17665","1","0","0","0","0","0","0","1","0","0","0","0","0","1","0","0","0","1","0","0","1","0","0","1"
"Gerrards Cross","51.5861","-0.55543","14","1","0","2","0","0","3","20","7","3","5","0","15","11","0","9","0","20","3","5","12","0","0","20"
"Gewanē","10.16658","40.64689","1","0","0","0","0","0","0","1","0","0","0","1","1","0","0","0","1","1","0","0","0","0","1","1"
"Gex","46.33323","6.05766","0","0","0","0","2","0","0","2","0","1","1","0","2","2","0","0","0","2","0","0","2","0","0","2"
"Ghadāmis","30.13366","9.50072","1","0","0","0","0","0","0","1","0","0","1","0","1","0","0","1","0","1","0","1","0","0","0","1"
"Ghardaïa","32.49094","3.67347","1","0","0","0","1","0","0","2","0","1","0","0","1","1","1","0","0","2","0","2","0","0","0","2"
"Gharyan","32.17222","13.02028","1","0","0","0","0","0","0","1","0","0","0","0","0","0","0","0","0","0","0","0","1","0","0","1"
"Ghazieh","33.5175","35.36889","2","1","0","0","0","0","0","3","3","0","0","0","3","0","3","0","0","3","0","2","1","0","0","3"
"Ghiroda","45.76389","21.30028","1","0","0","0","0","0","0","1","0","0","0","0","0","1","0","0","0","1","1","0","0","0","0","1"
"Ghotki","28.00437","69.31569","0","1","0","0","0","0","0","1","0","1","0","0","1","0","1","0","0","1","0","0","0","0","1","1"
"Giannitsá","40.79194","22.4075","1","0","0","0","0","0","0","1","0","0","0","0","0","0","1","0","0","1","0","1","0","0","0","1"
"Gibraltar","42.09504","-83.18965","1","0","0","0","0","0","0","1","0","0","1","0","1","1","0","0","0","1","0","0","1","0","0","1"
"Gibraltar","40.28426","-75.87187","1","0","0","0","0","0","0","1","0","0","1","0","1","1","0","0","0","1","0","0","1","0","0","1"
"Gibraltar","36.14474","-5.35257","1","0","0","0","0","0","0","1","0","0","1","0","1","1","0","0","0","1","0","0","1","0","0","1"
"Gikongoro","-2.46397","29.57389","1","0","0","0","0","0","0","1","0","1","0","0","1","1","0","0","0","1","1","0","0","0","0","1"
"Gilbert","33.35283","-111.78903","1","0","0","0","0","0","0","1","0","1","0","0","1","1","0","0","0","1","0","0","1","0","0","1"
"Gilbert","42.10693","-93.64966","1","0","0","0","0","0","0","1","0","1","0","0","1","1","0","0","0","1","0","0","1","0","0","1"
"Gilbert","47.48882","-92.46491","1","0","0","0","0","0","0","1","0","1","0","0","1","1","0","0","0","1","0","0","1","0","0","1"
"Gilbert","32.04932","-91.65818","1","0","0","0","0","0","0","1","0","1","0","0","1","1","0","0","0","1","0","0","1","0","0","1"
"Gilbert","33.92431","-81.39371","1","0","0","0","0","0","0","1","0","1","0","0","1","1","0","0","0","1","0","0","1","0","0","1"
"Gilbert","-32.53499","-58.93135","1","0","0","0","0","0","0","1","0","1","0","0","1","1","0","0","0","1","0","0","1","0","0","1"
"Gilgit","35.91869","74.31245","2","0","0","0","0","0","0","2","1","0","0","0","1","2","0","0","0","2","2","0","0","0","0","2"
"Gillingham","51.03833","-2.27611","11","0","0","0","1","0","2","14","5","4","2","0","11","6","0","8","0","14","2","3","8","0","1","14"
"Gillingham","51.38914","0.54863","11","0","0","0","1","0","2","14","5","4","2","0","11","6","0","8","0","14","2","3","8","0","1","14"
"Giresun","40.91698","38.38741","1","0","0","0","0","0","0","1","0","0","0","1","1","1","0","0","0","1","1","0","0","0","0","1"
"Girona","41.98311","2.82493","1","0","0","0","0","0","0","1","1","0","0","0","1","0","0","1","0","1","0","0","1","0","0","1"
"Girvan","55.24255","-4.85551","1","0","0","0","0","0","0","1","0","0","1","0","1","1","0","0","0","1","0","0","1","0","0","1"
"Gisenyi","-1.70278","29.25639","2","0","0","0","0","0","0","2","0","2","0","0","2","0","2","0","0","2","0","1","1","0","0","2"
"Giyani","-23.30246","30.71868","0","1","0","0","0","0","0","1","1","0","0","0","1","1","0","0","0","1","0","0","1","0","0","1"
"Giza","30.00944","31.20861","41","1","0","1","2","0","1","46","12","15","6","0","33","22","17","8","0","47","17","4","19","5","2","47"
"Gjakovë","42.38028","20.43083","3","0","0","0","0","0","0","3","0","2","0","0","2","0","2","1","0","3","1","0","0","0","2","3"
"Gjilan","42.46045","21.46986","1","0","0","0","0","0","0","1","0","0","0","0","0","0","1","0","0","1","1","0","0","0","0","1"
"Gjirokastër","40.07583","20.13889","1","0","0","0","0","0","0","1","1","0","0","0","1","0","1","0","0","1","0","0","1","0","0","1"
"Glanamman","51.8","-3.93333","1","0","0","0","0","0","0","1","0","0","0","0","0","1","0","0","0","1","0","0","1","0","0","1"
"Glasgow","43.43456","-124.21122","136","4","0","9","11","0","6","166","31","59","47","2","139","65","20","80","1","166","38","31","91","4","2","166"
"Glasgow","48.19696","-106.63671","136","4","0","9","11","0","6","166","31","59","47","2","139","65","20","80","1","166","38","31","91","4","2","166"
"Glasgow","39.22725","-92.84658","136","4","0","9","11","0","6","166","31","59","47","2","139","65","20","80","1","166","38","31","91","4","2","166"
"Glasgow","36.99588","-85.91192","136","4","0","9","11","0","6","166","31","59","47","2","139","65","20","80","1","166","38","31","91","4","2","166"
"Glasgow","38.21538","-81.42456","136","4","0","9","11","0","6","166","31","59","47","2","139","65","20","80","1","166","38","31","91","4","2","166"
"Glasgow","37.63402","-79.45031","136","4","0","9","11","0","6","166","31","59","47","2","139","65","20","80","1","166","38","31","91","4","2","166"
"Glasgow","39.60483","-75.74521","136","4","0","9","11","0","6","166","31","59","47","2","139","65","20","80","1","166","38","31","91","4","2","166"
"Glasgow","55.86515","-4.25763","136","4","0","9","11","0","6","166","31","59","47","2","139","65","20","80","1","166","38","31","91","4","2","166"
"Glastonbury","41.71232","-72.60815","1","0","0","0","0","0","0","1","0","0","1","0","1","0","0","1","0","1","0","0","1","0","0","1"
"Glastonbury","51.14745","-2.72075","1","0","0","0","0","0","0","1","0","0","1","0","1","0","0","1","0","1","0","0","1","0","0","1"
"Glen Cove","40.86232","-73.63374","1","0","0","0","0","0","0","1","0","0","0","0","0","1","0","0","0","1","0","0","1","0","0","1"
"Glendale","42.73623","-123.4234","1","0","0","0","0","0","0","1","1","0","0","0","1","1","0","0","0","1","0","1","0","0","0","1"
"Glendale","34.14251","-118.25508","1","0","0","0","0","0","0","1","1","0","0","0","1","1","0","0","0","1","0","1","0","0","0","1"
"Glendale","33.53865","-112.18599","1","0","0","0","0","0","0","1","1","0","0","0","1","1","0","0","0","1","0","1","0","0","0","1"
"Glendale","39.70499","-104.93359","1","0","0","0","0","0","0","1","1","0","0","0","1","1","0","0","0","1","0","1","0","0","0","1"
"Glendale","38.59589","-90.37706","1","0","0","0","0","0","0","1","1","0","0","0","1","1","0","0","0","1","0","1","0","0","0","1"
"Glendale","31.36462","-89.30617","1","0","0","0","0","0","0","1","1","0","0","0","1","1","0","0","0","1","0","1","0","0","0","1"
"Glendale","43.13529","-87.93564","1","0","0","0","0","0","0","1","1","0","0","0","1","1","0","0","0","1","0","1","0","0","0","1"
"Glendale","39.27061","-84.45939","1","0","0","0","0","0","0","1","1","0","0","0","1","1","0","0","0","1","0","1","0","0","0","1"
"Glendale","41.397","-81.54234","1","0","0","0","0","0","0","1","1","0","0","0","1","1","0","0","0","1","0","1","0","0","0","1"
"Glendale","39.94924","-80.75425","1","0","0","0","0","0","0","1","1","0","0","0","1","1","0","0","0","1","0","1","0","0","0","1"
"Glendale","40.70149","-73.8868","1","0","0","0","0","0","0","1","1","0","0","0","1","1","0","0","0","1","0","1","0","0","0","1"
"Glendale","-17.35514","31.06718","1","0","0","0","0","0","0","1","1","0","0","0","1","1","0","0","0","1","0","1","0","0","0","1"
"Glendale","-32.93194","151.64103","1","0","0","0","0","0","0","1","1","0","0","0","1","1","0","0","0","1","0","1","0","0","0","1"
"Glendale Heights","41.9146","-88.06486","1","0","0","0","0","0","0","1","1","0","0","0","1","0","1","0","0","1","0","0","0","0","1","1"
"Glen Iris","-33.33713","115.6743","1","0","0","1","0","0","0","2","0","1","0","0","1","1","0","1","0","2","0","0","2","0","0","2"
"Glen Iris","-37.86667","145.06667","1","0","0","1","0","0","0","2","0","1","0","0","1","1","0","1","0","2","0","0","2","0","0","2"
"Glenrothes","56.19514","-3.17316","4","0","0","0","0","0","1","5","1","1","3","0","5","1","0","4","0","5","0","1","4","0","0","5"
"Glossop","53.44325","-1.949","9","0","0","0","0","0","0","9","2","4","1","0","7","3","0","6","0","9","0","4","5","0","0","9"
"Glossop","-34.27688","140.541","9","0","0","0","0","0","0","9","2","4","1","0","7","3","0","6","0","9","0","4","5","0","0","9"
"Gloucester","34.72627","-76.54104","40","1","0","1","6","0","3","51","8","26","17","1","52","20","7","24","1","52","11","6","32","2","1","52"
"Gloucester","42.61405","-70.66313","40","1","0","1","6","0","3","51","8","26","17","1","52","20","7","24","1","52","11","6","32","2","1","52"
"Gloucester","51.86568","-2.2431","40","1","0","1","6","0","3","51","8","26","17","1","52","20","7","24","1","52","11","6","32","2","1","52"
"Gloucester","-32.0077","151.9633","40","1","0","1","6","0","3","51","8","26","17","1","52","20","7","24","1","52","11","6","32","2","1","52"
"Glyfáda","37.86289","23.75802","1","0","0","0","0","0","1","2","1","0","0","0","1","0","0","2","0","2","0","0","1","0","1","2"
"Glyn-neath","51.7475","-3.61833","1","0","0","0","0","0","0","1","0","0","1","0","1","0","0","1","0","1","0","1","0","0","0","1"
"Gnosall","52.78558","-2.25483","1","0","0","0","0","0","0","1","0","1","0","0","1","1","0","0","0","1","1","0","0","0","0","1"
"Goaso","6.80355","-2.5172","1","0","0","0","0","0","0","1","1","0","0","0","1","1","0","0","0","1","0","1","0","0","0","1"
"Goa Velha","15.44384","73.88572","1","0","0","0","0","0","0","1","0","0","0","0","0","0","0","1","0","1","0","1","0","0","0","1"
"Goba","7.01667","39.98333","2","0","0","0","0","0","0","2","0","2","0","0","2","1","1","0","0","2","1","0","0","0","1","2"
"Gobichettipalayam","11.45496","77.4422","0","1","0","0","0","0","0","1","1","0","0","0","1","0","1","0","0","1","0","0","1","0","0","1"
"Godalming","51.1858","-0.61489","34","0","0","1","4","0","3","42","6","9","17","1","33","16","1","24","1","42","7","12","22","1","0","42"
"Godhra","22.77547","73.61488","1","0","0","0","0","0","0","1","1","0","0","0","1","0","0","1","0","1","0","0","1","0","0","1"
"Godmanchester","52.31939","-0.17509","1","1","0","0","0","0","0","2","2","0","0","0","2","0","0","2","0","2","0","0","2","0","0","2"
"Godshill","50.63308","-1.25476","1","0","0","0","0","0","0","1","0","0","1","0","1","0","0","1","0","1","0","0","1","0","0","1"
"Goes","51.50417","3.88889","1","0","0","0","0","0","0","1","0","0","0","0","0","0","1","0","0","1","0","0","1","0","0","1"
"Goiânia","-16.67861","-49.25389","1","0","0","0","0","0","0","1","1","0","0","0","1","0","1","0","0","1","0","0","1","0","0","1"
"Gojra","31.14926","72.68323","0","1","0","0","0","0","0","1","1","0","0","0","1","0","0","1","0","1","0","0","1","0","0","1"
"Golborne","53.47693","-2.59651","2","0","0","0","1","0","0","3","0","0","1","0","1","0","0","3","0","3","0","3","0","0","0","3"
"Gold Coast","-28.00029","153.43088","2","0","0","0","1","0","0","3","0","1","1","0","2","1","1","1","0","3","1","0","1","0","1","3"
"Goleta","34.43583","-119.82764","1","0","0","0","0","0","0","1","0","0","0","0","0","1","0","0","0","1","0","0","1","0","0","1"
"Goma","-1.67409","29.22845","3","0","0","0","0","0","0","3","1","1","0","0","2","2","0","0","0","2","0","1","1","0","1","3"
"Goma","6.79194","125.32083","3","0","0","0","0","0","0","3","1","1","0","0","2","2","0","0","0","2","0","1","1","0","1","3"
"Gombe","10.28969","11.16729","5","0","0","0","0","0","0","5","2","1","0","1","4","1","3","1","0","5","2","0","3","0","0","5"
"Gombe","0.20333","32.08806","5","0","0","0","0","0","0","5","2","1","0","1","4","1","3","1","0","5","2","0","3","0","0","5"
"Gombe","0.48695","32.47938","5","0","0","0","0","0","0","5","2","1","0","1","4","1","3","1","0","5","2","0","3","0","0","5"
"Gondal","21.96074","70.80255","1","0","0","0","0","0","0","1","1","0","0","0","1","0","0","1","0","1","0","0","1","0","0","1"
"Gondar","12.6","37.46667","3","0","0","0","0","0","0","3","1","1","1","1","4","1","0","1","1","3","0","1","3","0","0","4"
"Gonzaga","44.95193","10.81913","1","0","0","0","0","0","0","1","0","1","0","0","1","0","0","1","0","1","1","0","0","0","0","1"
"Gonzaga","18.25937","121.99495","1","0","0","0","0","0","0","1","0","1","0","0","1","0","0","1","0","1","1","0","0","0","0","1"
"Goodlands","-20.03841","57.65055","1","0","0","0","0","0","0","1","0","0","0","1","1","0","1","0","0","1","1","0","0","0","0","1"
"Goodwick","52.00491","-4.99511","2","0","0","0","1","0","0","3","2","0","0","0","2","1","0","2","0","3","2","1","0","0","0","3"
"Goole","53.70324","-0.87732","3","0","0","0","0","0","0","3","0","3","0","0","3","1","2","0","0","3","1","0","2","0","0","3"
"Goostrey","53.22731","-2.33919","1","0","0","0","0","0","0","1","0","0","1","0","1","0","0","1","0","1","0","1","0","0","0","1"
"Gorakhpur","29.44768","75.67206","1","0","0","0","0","0","0","1","1","0","0","0","1","0","1","0","0","1","0","0","1","0","0","1"
"Gorakhpur","26.76628","83.36889","1","0","0","0","0","0","0","1","1","0","0","0","1","0","1","0","0","1","0","0","1","0","0","1"
"Goražde","43.66795","18.97564","1","0","0","0","0","0","0","1","1","0","0","0","1","0","0","1","0","1","0","0","1","0","0","1"
"Gordon","42.80472","-102.20322","1","0","0","0","0","0","0","1","0","0","0","0","0","0","0","1","0","1","0","0","1","0","0","1"
"Gordon","32.88209","-83.33238","1","0","0","0","0","0","0","1","0","0","0","0","0","0","0","1","0","1","0","0","1","0","0","1"
"Gordon","40.75175","-76.33606","1","0","0","0","0","0","0","1","0","0","0","0","0","0","0","1","0","1","0","0","1","0","0","1"
"Gordon","-37.5823","144.10925","1","0","0","0","0","0","0","1","0","0","0","0","0","0","0","1","0","1","0","0","1","0","0","1"
"Gordon","-35.45676","149.08498","1","0","0","0","0","0","0","1","0","0","0","0","0","0","0","1","0","1","0","0","1","0","0","1"
"Gordon","-33.75535","151.15115","1","0","0","0","0","0","0","1","0","0","0","0","0","0","0","1","0","1","0","0","1","0","0","1"
"Gore","35.52926","-95.11718","1","0","0","0","0","0","0","1","0","1","0","0","1","1","0","0","0","1","1","0","0","0","0","1"
"Gore","-46.10282","168.94357","1","0","0","0","0","0","0","1","0","1","0","0","1","1","0","0","0","1","1","0","0","0","0","1"
"Gorey","52.67472","-6.2925","2","0","0","0","0","0","0","2","0","1","1","0","2","2","0","0","0","2","2","0","0","0","0","2"
"Gorna Oryahovitsa","43.12778","25.70167","1","0","0","0","0","0","0","1","0","1","0","0","1","0","1","0","0","1","1","0","0","0","0","1"
"Gornja Tuzla","44.55659","18.76159","0","1","0","0","0","0","0","1","1","0","0","0","1","0","0","1","0","1","0","1","0","0","0","1"
"Gornji Milanovac","44.02603","20.46152","1","0","0","0","0","0","0","1","0","1","0","0","1","0","0","1","0","1","0","0","0","0","1","1"
"Goroka","-6.085","145.38667","1","0","0","0","0","0","0","1","0","0","0","1","1","0","0","0","1","1","1","0","0","0","0","1"
"Gosfield","51.93657","0.59197","1","0","0","0","0","0","0","1","0","1","0","0","1","0","0","1","0","1","0","0","1","0","0","1"
"Gosport","39.35088","-86.66695","6","1","0","0","2","0","1","10","2","0","4","1","7","2","0","6","2","10","1","5","2","1","1","10"
"Gosport","50.79509","-1.12902","6","1","0","0","2","0","1","10","2","0","4","1","7","2","0","6","2","10","1","5","2","1","1","10"
"Gostivar","41.79601","20.90819","3","0","0","0","0","0","0","3","1","1","0","0","2","2","1","0","0","3","1","1","1","0","0","3"
"Göteborg","57.70716","11.96679","4","0","0","2","0","0","1","7","1","2","4","0","7","6","0","1","0","7","1","1","3","1","1","7"
"Gourdon","56.82979","-2.28641","1","0","0","0","0","0","0","1","0","1","0","0","1","1","0","0","0","1","0","0","1","0","0","1"
"Gourdon","44.73742","1.38297","1","0","0","0","0","0","0","1","0","1","0","0","1","1","0","0","0","1","0","0","1","0","0","1"
"Gourdon","46.64154","4.44619","1","0","0","0","0","0","0","1","0","1","0","0","1","1","0","0","0","1","0","0","1","0","0","1"
"Gourock","55.96157","-4.81789","3","0","0","0","0","0","1","4","0","2","2","0","4","3","0","1","0","4","1","3","0","0","0","4"
"Gračanica","43.73333","18.28333","1","0","0","0","0","0","0","1","0","0","0","0","0","0","1","0","0","1","1","0","0","0","0","1"
"Gračanica","44.70307","18.3101","1","0","0","0","0","0","0","1","0","0","0","0","0","0","1","0","0","1","1","0","0","0","0","1"
"Gračanica","42.60111","21.19583","1","0","0","0","0","0","0","1","0","0","0","0","0","0","1","0","0","1","1","0","0","0","0","1"
"Graiguenamanagh","52.54028","-6.95472","1","0","0","0","0","0","0","1","0","0","1","0","1","0","0","1","0","1","0","0","1","0","0","1"
"Granada","25.64127","-103.2671","1","0","0","0","0","0","0","1","1","0","0","0","1","1","0","0","0","1","0","1","0","0","0","1"
"Granada","11.92988","-85.95602","1","0","0","0","0","0","0","1","1","0","0","0","1","1","0","0","0","1","0","1","0","0","0","1"
"Granada","-6.09917","-77.62667","1","0","0","0","0","0","0","1","1","0","0","0","1","1","0","0","0","1","0","1","0","0","0","1"
"Granada","6.14353","-75.18532","1","0","0","0","0","0","0","1","1","0","0","0","1","1","0","0","0","1","0","1","0","0","0","1"
"Granada","5.06667","-74.56667","1","0","0","0","0","0","0","1","1","0","0","0","1","1","0","0","0","1","0","1","0","0","0","1"
"Granada","4.51997","-74.35261","1","0","0","0","0","0","0","1","1","0","0","0","1","1","0","0","0","1","0","1","0","0","0","1"
"Granada","3.54625","-73.70687","1","0","0","0","0","0","0","1","1","0","0","0","1","1","0","0","0","1","0","1","0","0","0","1"
"Granada","37.18817","-3.60667","1","0","0","0","0","0","0","1","1","0","0","0","1","1","0","0","0","1","0","1","0","0","0","1"
"Granada","11.63333","123.35","1","0","0","0","0","0","0","1","1","0","0","0","1","1","0","0","0","1","0","1","0","0","0","1"
"Grand Baie","-20.01816","57.58015","1","0","0","0","0","0","0","1","1","0","0","0","1","0","0","1","0","1","0","1","0","0","0","1"
"Grand Bois","-20.41889","57.54417","1","0","0","0","0","0","0","1","1","0","0","0","1","0","0","1","0","1","0","0","1","0","0","1"
"Grândola","38.17718","-8.56675","1","0","0","0","0","0","0","1","0","1","0","0","1","1","0","0","0","1","1","0","0","0","0","1"
"Grange-over-Sands","54.18508","-2.92488","1","0","0","0","0","0","0","1","0","0","0","0","0","0","0","1","0","1","0","1","0","0","0","1"
"Granite City","38.70144","-90.14872","1","0","0","0","0","0","0","1","0","0","0","0","0","0","1","0","0","1","0","0","1","0","0","1"
"Grantham","43.48952","-72.13759","9","1","0","0","3","0","0","13","2","7","2","0","11","2","2","8","0","12","5","3","5","0","0","13"
"Grantham","52.91149","-0.64184","9","1","0","0","3","0","0","13","2","7","2","0","11","2","2","8","0","12","5","3","5","0","0","13"
"Grantham","-27.57918","152.20167","9","1","0","0","3","0","0","13","2","7","2","0","11","2","2","8","0","12","5","3","5","0","0","13"
"Grantown on Spey","57.33051","-3.60867","1","0","0","0","0","0","0","1","0","0","1","0","1","0","0","1","0","1","0","1","0","0","0","1"
"Granville","41.26115","-89.22759","0","0","0","0","0","0","1","1","0","0","0","0","0","0","0","1","0","1","0","0","1","0","0","1"
"Granville","40.06812","-82.5196","0","0","0","0","0","0","1","1","0","0","0","0","0","0","0","1","0","1","0","0","1","0","0","1"
"Granville","39.64591","-79.98729","0","0","0","0","0","0","1","1","0","0","0","0","0","0","0","1","0","1","0","0","1","0","0","1"
"Granville","43.40785","-73.25955","0","0","0","0","0","0","1","1","0","0","0","0","0","0","0","1","0","1","0","0","1","0","0","1"
"Granville","42.06676","-72.86149","0","0","0","0","0","0","1","1","0","0","0","0","0","0","0","1","0","1","0","0","1","0","0","1"
"Granville","48.83792","-1.59714","0","0","0","0","0","0","1","1","0","0","0","0","0","0","0","1","0","1","0","0","1","0","0","1"
"Granville","-33.8406","151.00748","0","0","0","0","0","0","1","1","0","0","0","0","0","0","0","1","0","1","0","0","1","0","0","1"
"Granville","-25.54486","152.73346","0","0","0","0","0","0","1","1","0","0","0","0","0","0","0","1","0","1","0","0","1","0","0","1"
"Grasse","43.65783","6.92537","1","0","0","0","0","0","0","1","1","0","0","0","1","0","0","1","0","1","0","0","1","0","0","1"
"Grassington","54.0714","-1.99822","1","0","0","0","0","0","0","1","0","1","0","0","1","0","0","1","0","1","0","1","0","0","0","1"
"Gravesend","40.5976","-73.96514","14","0","0","2","1","0","2","19","5","8","4","1","18","5","4","10","0","19","2","5","12","0","0","19"
"Gravesend","51.44206","0.37106","14","0","0","2","1","0","2","19","5","8","4","1","18","5","4","10","0","19","2","5","12","0","0","19"
"Grays","51.47566","0.32521","6","0","0","0","1","0","0","7","3","2","2","0","7","3","0","4","0","7","0","4","3","0","0","7"
"Graz","47.06667","15.45","1","0","0","0","0","0","0","1","0","1","0","0","1","0","0","1","0","1","0","0","1","0","0","1"
"Greasby","53.373","-3.1233","3","0","0","0","0","0","0","3","0","1","2","0","3","1","0","2","0","3","1","1","1","0","0","3"
"Great Bookham","51.27916","-0.37423","1","0","0","0","0","0","0","1","0","0","1","0","1","0","1","0","0","1","0","0","1","0","0","1"
"Great Dunmow","51.8723","0.36255","0","0","0","0","1","0","0","1","0","0","1","0","1","0","0","1","0","1","0","0","1","0","0","1"
"Greater Noida","28.49615","77.53601","1","0","0","0","0","0","0","1","1","0","0","0","1","0","1","0","0","1","0","0","1","0","0","1"
"Great Glen","52.57548","-1.0349","1","0","0","0","0","0","0","1","0","0","1","0","1","1","0","0","0","1","0","1","0","0","0","1"
"Great Harwood","53.78512","-2.40865","2","0","0","0","0","0","0","2","0","1","0","0","1","1","1","0","0","2","0","0","2","0","0","2"
"Great Horkesley","51.93821","0.87551","1","0","0","0","0","0","0","1","0","0","1","0","1","0","1","0","0","1","0","0","1","0","0","1"
"Great Malvern","52.11161","-2.32515","1","0","0","0","1","0","0","2","0","2","0","0","2","0","0","2","0","2","1","0","1","0","0","2"
"Great Missenden","51.70419","-0.70797","3","0","0","0","0","0","0","3","0","1","2","0","3","0","0","3","0","3","1","0","2","0","0","3"
"Great Rollright","51.97595","-1.52864","1","0","0","0","0","0","0","1","1","0","0","0","1","1","0","0","0","1","0","0","1","0","0","1"
"Great Shefford","51.4747","-1.44959","1","0","0","0","0","0","0","1","0","0","0","0","0","0","0","1","0","1","0","1","0","0","0","1"
"Great Wyrley","52.66277","-2.01111","1","0","0","0","0","0","0","1","1","0","0","0","1","0","0","1","0","1","0","1","0","0","0","1"
"Great Yarmouth","52.60831","1.73052","3","0","0","0","0","0","0","3","0","1","2","0","3","0","2","1","0","3","1","1","1","0","0","3"
"Greenford","51.52866","-0.35508","0","1","0","0","0","0","0","1","0","1","0","0","1","0","0","1","0","1","0","0","1","0","0","1"
"Greenhithe","51.45026","0.28539","2","0","0","0","0","0","1","3","1","1","1","0","3","3","0","0","0","3","0","0","3","0","0","3"
"Greenock","40.31229","-79.80671","5","1","0","1","1","0","0","8","1","5","2","0","8","5","1","2","0","8","3","3","1","0","1","8"
"Greenock","55.94838","-4.76121","5","1","0","1","1","0","0","8","1","5","2","0","8","5","1","2","0","8","3","3","1","0","1","8"
"Greenock","-34.457","138.92719","5","1","0","1","1","0","0","8","1","5","2","0","8","5","1","2","0","8","3","3","1","0","1","8"
"Greensboro","32.70415","-87.5955","1","0","0","0","0","0","0","1","0","1","0","0","1","1","0","0","0","1","0","1","0","0","0","1"
"Greensboro","30.56961","-84.74527","1","0","0","0","0","0","0","1","0","1","0","0","1","1","0","0","0","1","0","1","0","0","0","1"
"Greensboro","33.57568","-83.18238","1","0","0","0","0","0","0","1","0","1","0","0","1","1","0","0","0","1","0","1","0","0","0","1"
"Greensboro","36.07264","-79.79198","1","0","0","0","0","0","0","1","0","1","0","0","1","1","0","0","0","1","0","1","0","0","0","1"
"Greensboro","38.97372","-75.80493","1","0","0","0","0","0","0","1","0","1","0","0","1","1","0","0","0","1","0","1","0","0","0","1"
"Greenville","40.13961","-120.95107","1","0","0","0","0","0","0","1","1","0","0","0","1","0","0","1","0","1","0","0","1","0","0","1"
"Greenville","33.13845","-96.11081","1","0","0","0","0","0","0","1","1","0","0","0","1","0","0","1","0","1","0","0","1","0","0","1"
"Greenville","33.40898","-91.05978","1","0","0","0","0","0","0","1","1","0","0","0","1","0","0","1","0","1","0","0","1","0","0","1"
"Greenville","37.12727","-90.45011","1","0","0","0","0","0","0","1","1","0","0","0","1","0","0","1","0","1","0","0","1","0","0","1"
"Greenville","38.89227","-89.41314","1","0","0","0","0","0","0","1","1","0","0","0","1","0","0","1","0","1","0","0","1","0","0","1"
"Greenville","39.14088","-87.30196","1","0","0","0","0","0","0","1","1","0","0","0","1","0","0","1","0","1","0","0","1","0","0","1"
"Greenville","37.20115","-87.17889","1","0","0","0","0","0","0","1","1","0","0","0","1","0","0","1","0","1","0","0","1","0","0","1"
"Greenville","31.8296","-86.61775","1","0","0","0","0","0","0","1","1","0","0","0","1","0","0","1","0","1","0","0","1","0","0","1"
"Greenville","38.37256","-85.98636","1","0","0","0","0","0","0","1","1","0","0","0","1","0","0","1","0","1","0","0","1","0","0","1"
"Greenville","43.17753","-85.2528","1","0","0","0","0","0","0","1","1","0","0","0","1","0","0","1","0","1","0","0","1","0","0","1"
"Greenville","33.02874","-84.71298","1","0","0","0","0","0","0","1","1","0","0","0","1","0","0","1","0","1","0","0","1","0","0","1"
"Greenville","40.10283","-84.63301","1","0","0","0","0","0","0","1","1","0","0","0","1","0","0","1","0","1","0","0","1","0","0","1"
"Greenville","30.46937","-83.63015","1","0","0","0","0","0","0","1","1","0","0","0","1","0","0","1","0","1","0","0","1","0","0","1"
"Greenville","34.85262","-82.39401","1","0","0","0","0","0","0","1","1","0","0","0","1","0","0","1","0","1","0","0","1","0","0","1"
"Greenville","41.4045","-80.39118","1","0","0","0","0","0","0","1","1","0","0","0","1","0","0","1","0","1","0","0","1","0","0","1"
"Greenville","38.00347","-79.15586","1","0","0","0","0","0","0","1","1","0","0","0","1","0","0","1","0","1","0","0","1","0","0","1"
"Greenville","35.61266","-77.36635","1","0","0","0","0","0","0","1","1","0","0","0","1","0","0","1","0","1","0","0","1","0","0","1"
"Greenville","39.779","-75.59826","1","0","0","0","0","0","0","1","1","0","0","0","1","0","0","1","0","1","0","0","1","0","0","1"
"Greenville","42.41536","-74.02208","1","0","0","0","0","0","0","1","1","0","0","0","1","0","0","1","0","1","0","0","1","0","0","1"
"Greenville","40.99315","-73.81986","1","0","0","0","0","0","0","1","1","0","0","0","1","0","0","1","0","1","0","0","1","0","0","1"
"Greenville","42.76731","-71.8123","1","0","0","0","0","0","0","1","1","0","0","0","1","0","0","1","0","1","0","0","1","0","0","1"
"Greenville","41.87121","-71.55201","1","0","0","0","0","0","0","1","1","0","0","0","1","0","0","1","0","1","0","0","1","0","0","1"
"Greenville","45.45949","-69.59061","1","0","0","0","0","0","0","1","1","0","0","0","1","0","0","1","0","1","0","0","1","0","0","1"
"Greenville","5.01133","-9.0388","1","0","0","0","0","0","0","1","1","0","0","0","1","0","0","1","0","1","0","0","1","0","0","1"
"Grenoble","45.17869","5.71479","1","0","0","0","0","0","0","1","0","1","0","0","1","0","0","1","0","1","0","0","1","0","0","1"
"Gretna","41.14083","-96.23974","0","0","0","0","1","0","0","1","1","0","0","0","1","0","0","1","0","1","0","0","1","0","0","1"
"Gretna","29.91465","-90.05396","0","0","0","0","1","0","0","1","1","0","0","0","1","0","0","1","0","1","0","0","1","0","0","1"
"Gretna","30.61714","-84.65991","0","0","0","0","1","0","0","1","1","0","0","0","1","0","0","1","0","1","0","0","1","0","0","1"
"Gretna","36.95375","-79.35891","0","0","0","0","1","0","0","1","1","0","0","0","1","0","0","1","0","1","0","0","1","0","0","1"
"Gretna","54.9938","-3.06594","0","0","0","0","1","0","0","1","1","0","0","0","1","0","0","1","0","1","0","0","1","0","0","1"
"Grevenbroich","51.09102","6.5827","1","0","0","0","0","0","0","1","1","0","0","0","1","1","0","0","0","1","0","0","1","0","0","1"
"Greystones","53.14083","-6.06306","1","0","0","0","0","0","0","1","0","0","0","0","0","0","1","0","0","1","1","0","0","0","0","1"
"Griffin","33.24678","-84.26409","1","0","0","0","0","0","0","1","0","1","0","0","1","0","0","1","0","1","0","0","1","0","0","1"
"Griffin","-27.27149","153.03942","1","0","0","0","0","0","0","1","0","1","0","0","1","0","0","1","0","1","0","0","1","0","0","1"
"Grigny","48.65412","2.39343","1","0","0","0","0","0","0","1","1","0","0","0","1","0","1","0","0","1","0","0","0","1","0","1"
"Grigny","45.60843","4.78976","1","0","0","0","0","0","0","1","1","0","0","0","1","0","1","0","0","1","0","0","0","1","0","1"
"Grimbsy","53.55989","-0.09888","6","1","0","1","0","0","0","8","2","1","5","0","8","3","1","4","0","8","1","3","3","0","1","8"
"Grimsby","53.56539","-0.07553","5","0","0","0","0","0","0","5","1","3","1","0","5","2","1","2","0","5","2","2","1","0","0","5"
"Grosse Ile","42.12921","-83.14437","1","0","0","0","0","0","0","1","0","1","0","0","1","0","0","1","0","1","0","0","1","0","0","1"
"Grove","36.59369","-94.76912","0","0","0","1","0","0","0","1","1","0","0","0","1","0","0","1","0","1","1","0","0","0","0","1"
"Grove","51.60954","-1.42187","0","0","0","1","0","0","0","1","1","0","0","0","1","0","0","1","0","1","1","0","0","0","0","1"
"Grove","53.53333","10.48333","0","0","0","1","0","0","0","1","1","0","0","0","1","0","0","1","0","1","1","0","0","0","0","1"
"Grugliasco","45.06516","7.57954","2","0","0","0","0","0","0","2","0","2","0","0","2","0","0","2","0","2","0","0","2","0","0","2"
"Gstaad","46.47215","7.28685","0","0","0","1","0","0","0","1","0","0","0","0","0","0","1","0","0","1","0","1","0","0","0","1"
"Guadalajara","20.66682","-103.39182","4","0","0","0","0","0","0","4","1","0","1","0","2","3","0","1","0","4","1","0","2","1","0","4"
"Guadalajara","40.62862","-3.16185","4","0","0","0","0","0","0","4","1","0","1","0","2","3","0","1","0","4","1","0","2","1","0","4"
"Guadalajara de Buga","3.90089","-76.29783","1","0","0","0","0","0","0","1","0","1","0","0","1","0","0","1","0","1","1","0","0","0","0","1"
"Guagua","14.9653","120.6325","0","0","0","1","0","0","0","1","1","0","0","0","1","1","0","0","0","1","0","1","0","0","0","1"
"Guanajuato","32.51857","-115.33847","1","0","0","0","0","0","0","1","1","0","0","0","1","0","1","0","0","1","0","0","1","0","0","1"
"Guanajuato","21.01858","-101.2591","1","0","0","0","0","0","0","1","1","0","0","0","1","0","1","0","0","1","0","0","1","0","0","1"
"Guanajuato","15.64707","-93.15573","1","0","0","0","0","0","0","1","1","0","0","0","1","0","1","0","0","1","0","0","1","0","0","1"
"Guantánamo","20.14444","-75.20917","1","0","0","0","0","0","0","1","0","0","0","0","0","1","0","0","0","1","0","0","1","0","0","1"
"Guarapuava","-25.39048","-51.46541","1","0","0","0","0","0","0","1","0","1","0","0","1","1","0","0","0","1","0","0","1","0","0","1"
"Guarda","40.53733","-7.26575","1","0","0","0","0","0","0","1","0","0","1","0","1","0","1","0","0","1","0","0","1","0","0","1"
"Guatemala City","14.64072","-90.51327","24","0","0","0","0","0","0","24","7","6","4","1","18","6","6","12","0","24","10","2","12","0","0","24"
"Guayaquil","-2.19616","-79.88621","6","1","0","0","1","0","1","9","4","0","2","1","7","1","2","6","0","9","2","1","6","0","0","9"
"Gubbio","43.34996","12.57309","1","0","0","0","0","0","0","1","0","0","0","0","0","0","0","1","0","1","0","0","1","0","0","1"
"Gudalur","9.67826","77.24951","1","0","0","0","0","0","0","1","1","0","0","0","1","1","0","0","0","1","0","0","1","0","0","1"
"Guildford","51.23536","-0.57427","58","3","0","1","3","0","3","68","8","10","22","0","40","30","5","32","0","67","3","17","42","4","2","68"
"Guildford","-31.9","115.96667","58","3","0","1","3","0","3","68","8","10","22","0","40","30","5","32","0","67","3","17","42","4","2","68"
"Guimbal","10.6633","122.3228","1","0","0","0","0","0","0","1","0","1","0","0","1","0","0","1","0","1","0","1","0","0","0","1"
"Guisborough","54.53478","-1.05606","1","0","0","0","0","0","0","1","0","0","0","0","0","0","0","1","0","1","1","0","0","0","0","1"
"Gujranwala","32.15567","74.18705","13","0","0","0","0","0","0","13","7","3","2","1","13","8","2","2","1","13","5","1","5","0","2","13"
"Gujrat","32.5742","74.07542","7","2","0","0","0","0","0","9","4","2","2","0","8","1","2","6","0","9","2","2","4","0","1","9"
"Gullane","56.03652","-2.82829","2","0","0","0","0","0","0","2","0","1","1","0","2","1","0","1","0","2","0","0","2","0","0","2"
"Gulu","2.77457","32.29899","2","0","0","0","0","0","0","2","0","0","0","0","0","1","1","0","0","2","0","1","1","0","0","2"
"Gulu","29.83885","106.7426","2","0","0","0","0","0","0","2","0","0","0","0","0","1","1","0","0","2","0","1","1","0","0","2"
"Gulu","31.3301","109.43991","2","0","0","0","0","0","0","2","0","0","0","0","0","1","1","0","0","2","0","1","1","0","0","2"
"Gumel","12.6269","9.38807","1","0","0","0","0","0","0","1","0","0","1","0","1","0","0","1","0","1","0","0","1","0","0","1"
"Gummidipundi","13.40765","80.10879","0","0","0","0","0","0","0","0","1","0","0","0","1","0","0","1","0","1","0","0","1","0","0","1"
"Gundlupēt","11.81004","76.69027","1","0","0","0","0","0","0","1","1","0","0","0","1","0","1","0","0","1","0","0","1","0","0","1"
"Gunnislake","50.52441","-4.21333","1","0","0","0","0","0","0","1","0","0","0","0","0","1","0","0","0","1","1","0","0","0","0","1"
"Gurasada","45.95483","22.59491","1","0","0","0","0","0","0","1","1","0","0","0","1","1","0","0","0","1","0","1","0","0","0","1"
"Gurgaon","28.4601","77.02635","5","1","0","0","0","0","0","6","4","0","1","0","5","2","1","3","0","6","0","0","6","0","0","6"
"Gurjaani","41.74292","45.80111","1","0","0","0","0","0","0","1","0","0","0","0","0","0","0","1","0","1","0","0","1","0","0","1"
"Gusau","12.17024","6.66412","5","0","0","0","0","0","0","5","0","3","0","1","4","3","2","0","0","5","4","0","0","0","1","5"
"Gustavsberg","59.32684","18.38975","0","0","0","0","1","0","0","1","0","0","0","0","0","1","0","0","0","1","0","0","1","0","0","1"
"Gütersloh","51.90693","8.37853","1","0","0","0","0","0","0","1","0","1","0","0","1","0","0","1","0","1","1","0","0","0","0","1"
"Guwahati","26.1844","91.7458","3","0","0","0","0","0","0","3","2","1","0","0","3","0","1","2","0","3","1","0","2","0","0","3"
"Guyancourt","48.77334","2.07393","1","0","0","0","0","0","0","1","1","0","0","0","1","0","0","1","0","1","0","0","1","0","0","1"
"Gwadar","25.12163","62.32541","0","0","0","1","0","0","0","1","1","0","0","0","1","0","0","1","0","1","0","1","0","0","0","1"
"Gwagwalada","8.94342","7.08165","0","0","0","0","1","0","0","1","0","0","1","0","1","0","0","0","1","1","0","0","1","0","0","1"
"Gwalior","26.22983","78.17337","3","0","0","0","0","0","0","3","4","0","0","0","4","3","1","0","0","4","0","0","4","0","0","4"
"Gwangju","35.15472","126.91556","1","0","0","0","0","0","0","1","0","0","0","1","1","0","1","0","0","1","0","0","0","0","1","1"
"Gwangju","37.41","127.25722","1","0","0","0","0","0","0","1","0","0","0","1","1","0","1","0","0","1","0","0","0","0","1","1"
"Gweru","-19.45","29.81667","1","0","0","0","0","0","0","1","0","0","0","0","0","0","1","0","0","1","1","0","0","0","0","1"
"Győr","47.68333","17.63512","1","0","0","0","0","0","0","1","0","0","1","0","1","1","0","0","0","1","0","0","1","0","0","1"
"Gyumri","40.7942","43.84528","1","0","0","0","0","0","0","1","0","0","0","1","1","0","1","0","0","1","1","0","0","0","0","1"
"Haaften","51.81583","5.21111","1","0","0","0","0","0","0","1","0","0","0","0","0","0","1","0","0","1","1","0","0","0","0","1"
"Haarlem","52.38084","4.63683","3","0","0","0","0","0","0","3","0","0","1","0","1","1","1","1","0","3","1","1","1","0","0","3"
"Habboûch","33.40729","35.48169","1","0","0","0","0","0","0","1","1","0","0","0","1","0","1","0","0","1","0","0","1","0","0","1"
"Hackensack","40.88593","-74.04347","1","0","0","0","0","0","0","1","1","0","0","0","1","0","0","1","0","1","0","0","1","0","0","1"
"Hackney","51.55","-0.05","2","0","0","1","0","0","1","4","1","0","1","0","2","2","0","2","0","4","0","1","3","0","0","4"
"Hackney","-34.9139","138.6164","2","0","0","1","0","0","1","4","1","0","1","0","2","2","0","2","0","4","0","1","3","0","0","4"
"Haddington","55.95612","-2.78332","3","0","0","0","0","0","0","3","1","0","2","0","3","1","1","1","0","3","0","1","2","0","0","3"
"Hadera","32.44192","34.9039","4","0","0","0","0","0","0","4","0","3","0","0","3","0","1","3","0","4","2","0","2","0","0","4"
"Hafar Al-Batin","28.43279","45.97077","3","0","0","0","0","0","0","3","0","1","0","2","3","2","0","0","1","3","3","0","0","0","0","3"
"Hafnarfjörður","64.0671","-21.93774","1","0","0","0","0","0","0","1","0","0","0","0","0","1","0","0","0","1","0","0","1","0","0","1"
"Hāgere Hiywet","8.98333","37.85","1","0","0","0","0","0","0","1","0","0","0","1","1","1","0","0","0","1","1","0","0","0","0","1"
"Hagley","52.4262","-2.12819","2","0","0","0","0","0","0","2","1","1","0","0","2","0","1","1","0","2","1","0","1","0","0","2"
"Haifa","32.81841","34.9885","2","0","0","0","2","0","0","4","2","1","0","0","3","1","2","1","0","4","2","2","0","0","0","4"
"Ha'il","27.52188","41.69073","4","0","0","0","0","0","0","4","1","2","0","0","3","0","1","3","0","4","1","2","0","0","1","4"
"Hailsham","50.8622","0.25775","4","0","0","0","1","0","2","7","0","2","1","2","5","1","1","4","1","7","4","0","3","0","0","7"
"Halba","34.54278","36.07972","4","1","0","0","0","0","0","5","1","3","0","0","4","4","1","0","0","5","4","0","1","0","0","5"
"Hale","53.33333","-2.8","2","0","0","0","0","0","0","2","0","0","1","0","1","1","0","1","0","2","0","0","2","0","0","2"
"Hale","53.37831","-2.33271","2","0","0","0","0","0","0","2","0","0","1","0","1","1","0","1","0","2","0","0","2","0","0","2"
"Hale","51.22946","-0.78908","2","0","0","0","0","0","0","2","0","0","1","0","1","1","0","1","0","2","0","0","2","0","0","2"
"Hale","41.21861","111.6755","2","0","0","0","0","0","0","2","0","0","1","0","1","1","0","1","0","2","0","0","2","0","0","2"
"Halesowen","52.44859","-2.04938","12","0","0","1","1","0","2","16","3","3","9","0","15","3","2","11","0","16","3","6","7","0","0","16"
"Halesworth","52.3464","1.5029","1","0","0","0","1","0","0","2","0","2","0","0","2","1","0","1","0","2","1","1","0","0","0","2"
"Half Moon Bay","37.46355","-122.42859","1","0","0","0","0","0","0","1","1","0","0","0","1","1","0","0","0","1","0","0","1","0","0","1"
"Half Way Tree","18.01248","-76.79928","1","0","0","0","0","0","0","1","0","1","0","0","1","1","0","0","0","1","0","0","1","0","0","1"
"Halifax","36.76597","-78.92834","26","1","0","0","3","0","0","30","4","10","13","0","27","9","4","17","0","30","6","10","13","1","0","30"
"Halifax","36.32849","-77.58942","26","1","0","0","3","0","0","30","4","10","13","0","27","9","4","17","0","30","6","10","13","1","0","30"
"Halifax","40.46814","-76.93192","26","1","0","0","3","0","0","30","4","10","13","0","27","9","4","17","0","30","6","10","13","1","0","30"
"Halifax","41.99121","-70.86199","26","1","0","0","3","0","0","30","4","10","13","0","27","9","4","17","0","30","6","10","13","1","0","30"
"Halifax","44.6464","-63.57291","26","1","0","0","3","0","0","30","4","10","13","0","27","9","4","17","0","30","6","10","13","1","0","30"
"Halifax","53.71667","-1.85","26","1","0","0","3","0","0","30","4","10","13","0","27","9","4","17","0","30","6","10","13","1","0","30"
"Halkyn","53.22556","-3.19016","0","0","0","0","0","0","1","1","1","0","0","0","1","1","0","0","0","1","0","1","0","0","0","1"
"Halle","50.73385","4.23454","2","0","0","0","0","0","0","2","0","1","0","1","2","2","0","0","0","2","0","0","2","0","0","2"
"Halle","51.98917","6.42917","2","0","0","0","0","0","0","2","0","1","0","1","2","2","0","0","0","2","0","0","2","0","0","2"
"Halle","52.06007","8.36083","2","0","0","0","0","0","0","2","0","1","0","1","2","2","0","0","0","2","0","0","2","0","0","2"
"Halle","52.42222","8.92127","2","0","0","0","0","0","0","2","0","1","0","1","2","2","0","0","0","2","0","0","2","0","0","2"
"Halle","51.99122","9.56532","2","0","0","0","0","0","0","2","0","1","0","1","2","2","0","0","0","2","0","0","2","0","0","2"
"Hamble-le-Rice","50.85966","-1.32432","2","0","0","0","0","0","0","2","0","1","0","0","1","1","1","0","0","2","0","1","0","0","1","2"
"Hamburg","40.60445","-95.65777","5","0","0","0","0","0","0","5","1","1","1","0","3","3","2","0","0","5","1","1","2","0","1","5"
"Hamburg","44.7333","-93.96719","5","0","0","0","0","0","0","5","1","1","1","0","3","3","2","0","0","5","1","1","2","0","1","5"
"Hamburg","33.22818","-91.79763","5","0","0","0","0","0","0","5","1","1","1","0","3","3","2","0","0","5","1","1","2","0","1","5"
"Hamburg","42.71589","-78.82948","5","0","0","0","0","0","0","5","1","1","1","0","3","3","2","0","0","5","1","1","2","0","1","5"
"Hamburg","40.55565","-75.98188","5","0","0","0","0","0","0","5","1","1","1","0","3","3","2","0","0","5","1","1","2","0","1","5"
"Hamburg","41.15343","-74.57627","5","0","0","0","0","0","0","5","1","1","1","0","3","3","2","0","0","5","1","1","2","0","1","5"
"Hamburg","53.55073","9.99302","5","0","0","0","0","0","0","5","1","1","1","0","3","3","2","0","0","5","1","1","2","0","1","5"
"Hamburg-Mitte","53.55","10.01667","1","0","0","0","0","0","0","1","0","0","1","0","1","0","0","1","0","1","0","0","0","0","1","1"
"Hamburg-Nord","53.58935","9.984","0","0","0","1","0","0","0","1","1","0","0","0","1","0","0","1","0","1","0","0","0","1","0","1"
"Hamilton","46.24687","-114.16037","19","1","0","0","0","0","1","21","4","7","7","0","18","9","3","8","0","20","6","6","9","0","0","21"
"Hamilton","31.70377","-98.12392","19","1","0","0","0","0","1","21","4","7","7","0","18","9","3","8","0","20","6","6","9","0","0","21"
"Hamilton","39.74362","-93.99827","19","1","0","0","0","0","1","21","4","7","7","0","18","9","3","8","0","20","6","6","9","0","0","21"
"Hamilton","40.39643","-91.33904","19","1","0","0","0","0","1","21","4","7","7","0","18","9","3","8","0","20","6","6","9","0","0","21"
"Hamilton","34.14232","-87.98864","19","1","0","0","0","0","1","21","4","7","7","0","18","9","3","8","0","20","6","6","9","0","0","21"
"Hamilton","41.53366","-84.91274","19","1","0","0","0","0","1","21","4","7","7","0","18","9","3","8","0","20","6","6","9","0","0","21"
"Hamilton","32.75791","-84.87493","19","1","0","0","0","0","1","21","4","7","7","0","18","9","3","8","0","20","6","6","9","0","0","21"
"Hamilton","39.3995","-84.56134","19","1","0","0","0","0","1","21","4","7","7","0","18","9","3","8","0","20","6","6","9","0","0","21"
"Hamilton","43.25011","-79.84963","19","1","0","0","0","0","1","21","4","7","7","0","18","9","3","8","0","20","6","6","9","0","0","21"
"Hamilton","39.13427","-77.66249","19","1","0","0","0","0","1","21","4","7","7","0","18","9","3","8","0","20","6","6","9","0","0","21"
"Hamilton","42.82701","-75.54462","19","1","0","0","0","0","1","21","4","7","7","0","18","9","3","8","0","20","6","6","9","0","0","21"
"Hamilton","32.2949","-64.78303","19","1","0","0","0","0","1","21","4","7","7","0","18","9","3","8","0","20","6","6","9","0","0","21"
"Hamilton","55.76667","-4.03333","19","1","0","0","0","0","1","21","4","7","7","0","18","9","3","8","0","20","6","6","9","0","0","21"
"Hamilton","-37.74425","142.02202","19","1","0","0","0","0","1","21","4","7","7","0","18","9","3","8","0","20","6","6","9","0","0","21"
"Hamilton","-32.92207","151.74711","19","1","0","0","0","0","1","21","4","7","7","0","18","9","3","8","0","20","6","6","9","0","0","21"
"Hamilton","-27.43896","153.06287","19","1","0","0","0","0","1","21","4","7","7","0","18","9","3","8","0","20","6","6","9","0","0","21"
"Hamilton","-37.78333","175.28333","19","1","0","0","0","0","1","21","4","7","7","0","18","9","3","8","0","20","6","6","9","0","0","21"
"Hamm","50.01667","6.41667","1","0","0","0","0","0","0","1","1","0","0","0","1","0","0","1","0","1","0","0","1","0","0","1"
"Hamm","50.76531","7.67761","1","0","0","0","0","0","0","1","1","0","0","0","1","0","0","1","0","1","0","0","1","0","0","1"
"Hamm","51.68033","7.82089","1","0","0","0","0","0","0","1","1","0","0","0","1","0","0","1","0","1","0","0","1","0","0","1"
"Hammam Sousse","35.8609","10.60313","1","0","0","0","0","0","0","1","1","0","0","0","1","0","0","1","0","1","0","0","1","0","0","1"
"Hammerfest","70.66336","23.68209","1","0","0","0","0","0","0","1","0","0","0","0","0","0","1","0","0","1","0","0","1","0","0","1"
"Hammersmith","51.49384","-0.22882","0","0","0","1","0","0","0","1","1","0","0","0","1","0","0","1","0","1","0","0","1","0","0","1"
"Hampton","42.74192","-93.20242","5","0","0","0","1","0","0","6","0","2","3","0","5","1","0","5","0","6","0","1","4","0","1","6"
"Hampton","44.61024","-93.00216","5","0","0","0","1","0","0","6","0","2","3","0","5","1","0","5","0","6","0","1","4","0","1","6"
"Hampton","33.53789","-92.46988","5","0","0","0","1","0","0","6","0","2","3","0","5","1","0","5","0","6","0","1","4","0","1","6"
"Hampton","41.55587","-90.4093","5","0","0","0","1","0","0","6","0","2","3","0","5","1","0","5","0","6","0","1","4","0","1","6"
"Hampton","33.38706","-84.28298","5","0","0","0","1","0","0","6","0","2","3","0","5","1","0","5","0","6","0","1","4","0","1","6"
"Hampton","32.87794","-81.12761","5","0","0","0","1","0","0","6","0","2","3","0","5","1","0","5","0","6","0","1","4","0","1","6"
"Hampton","39.92954","-77.05831","5","0","0","0","1","0","0","6","0","2","3","0","5","1","0","5","0","6","0","1","4","0","1","6"
"Hampton","39.42288","-76.58469","5","0","0","0","1","0","0","6","0","2","3","0","5","1","0","5","0","6","0","1","4","0","1","6"
"Hampton","37.02987","-76.34522","5","0","0","0","1","0","0","6","0","2","3","0","5","1","0","5","0","6","0","1","4","0","1","6"
"Hampton","40.70704","-74.956","5","0","0","0","1","0","0","6","0","2","3","0","5","1","0","5","0","6","0","1","4","0","1","6"
"Hampton","43.52479","-73.25178","5","0","0","0","1","0","0","6","0","2","3","0","5","1","0","5","0","6","0","1","4","0","1","6"
"Hampton","42.93759","-70.83894","5","0","0","0","1","0","0","6","0","2","3","0","5","1","0","5","0","6","0","1","4","0","1","6"
"Hampton","45.52876","-65.85354","5","0","0","0","1","0","0","6","0","2","3","0","5","1","0","5","0","6","0","1","4","0","1","6"
"Hampton","52.46667","-2.38333","5","0","0","0","1","0","0","6","0","2","3","0","5","1","0","5","0","6","0","1","4","0","1","6"
"Hampton","51.41334","-0.36701","5","0","0","0","1","0","0","6","0","2","3","0","5","1","0","5","0","6","0","1","4","0","1","6"
"Hampton","-37.95","145","5","0","0","0","1","0","0","6","0","2","3","0","5","1","0","5","0","6","0","1","4","0","1","6"
"Hanau am Main","50.13423","8.91418","1","0","0","0","0","0","0","1","0","0","0","0","0","1","0","0","0","1","1","0","0","0","0","1"
"Hancock","45.49746","-95.79671","2","0","0","0","0","0","0","2","0","0","0","0","0","0","2","0","0","2","0","2","0","0","0","2"
"Hancock","47.12687","-88.58096","2","0","0","0","0","0","0","2","0","0","0","0","0","0","2","0","0","2","0","2","0","0","0","2"
"Hancock","39.69898","-78.17973","2","0","0","0","0","0","0","2","0","0","0","0","0","0","2","0","0","2","0","2","0","0","0","2"
"Hancock","41.95398","-75.28045","2","0","0","0","0","0","0","2","0","0","0","0","0","0","2","0","0","2","0","2","0","0","0","2"
"Hancock","42.54314","-73.32372","2","0","0","0","0","0","0","2","0","0","0","0","0","0","2","0","0","2","0","2","0","0","0","2"
"Hancock","44.52924","-68.25363","2","0","0","0","0","0","0","2","0","0","0","0","0","0","2","0","0","2","0","2","0","0","0","2"
"Hangu","47.05","26.03333","1","0","0","0","0","0","0","1","0","0","0","1","1","1","0","0","0","1","0","1","0","0","0","1"
"Hangu","33.53198","71.0595","1","0","0","0","0","0","0","1","0","0","0","1","1","1","0","0","0","1","0","1","0","0","0","1"
"Hangu","39.24889","117.78917","1","0","0","0","0","0","0","1","0","0","0","1","1","1","0","0","0","1","0","1","0","0","0","1"
"Hanley Swan","52.08373","-2.27383","1","0","0","0","0","0","0","1","0","0","1","0","1","0","1","0","0","1","0","0","1","0","0","1"
"Hannover","52.37052","9.73322","3","1","0","0","0","0","1","5","1","2","2","0","5","2","0","3","0","5","0","0","4","1","0","5"
"Hanoi","21.0245","105.84117","8","2","0","0","0","0","0","10","4","3","0","0","7","6","3","1","0","10","0","1","6","0","3","10"
"Hanover","39.89389","-96.87947","1","0","0","0","0","0","0","1","0","0","0","0","0","1","0","0","0","1","1","0","0","0","0","1"
"Hanover","45.1558","-93.66635","1","0","0","0","0","0","0","1","0","0","0","0","0","1","0","0","0","1","1","0","0","0","0","1"
"Hanover","42.25641","-90.27957","1","0","0","0","0","0","0","1","0","0","0","0","0","1","0","0","0","1","1","0","0","0","0","1"
"Hanover","38.71423","-85.47357","1","0","0","0","0","0","0","1","0","0","0","0","0","1","0","0","0","1","1","0","0","0","0","1"
"Hanover","40.07979","-82.26098","1","0","0","0","0","0","0","1","0","0","0","0","0","1","0","0","0","1","1","0","0","0","0","1"
"Hanover","44.15009","-81.03303","1","0","0","0","0","0","0","1","0","0","0","0","0","1","0","0","0","1","1","0","0","0","0","1"
"Hanover","37.76653","-77.37026","1","0","0","0","0","0","0","1","0","0","0","0","0","1","0","0","0","1","1","0","0","0","0","1"
"Hanover","39.80066","-76.98304","1","0","0","0","0","0","0","1","0","0","0","0","0","1","0","0","0","1","1","0","0","0","0","1"
"Hanover","39.19289","-76.72414","1","0","0","0","0","0","0","1","0","0","0","0","0","1","0","0","0","1","1","0","0","0","0","1"
"Hanover","40.80454","-74.36682","1","0","0","0","0","0","0","1","0","0","0","0","0","1","0","0","0","1","1","0","0","0","0","1"
"Hanover","43.70229","-72.28954","1","0","0","0","0","0","0","1","0","0","0","0","0","1","0","0","0","1","1","0","0","0","0","1"
"Hanover","42.11316","-70.81199","1","0","0","0","0","0","0","1","0","0","0","0","0","1","0","0","0","1","1","0","0","0","0","1"
"Hanwell","52.09124","-1.36763","1","0","0","0","0","0","0","1","0","0","1","0","1","0","0","1","0","1","0","0","1","0","0","1"
"Harar","9.31387","42.11815","1","2","0","0","0","0","0","3","1","1","1","0","3","1","2","0","0","3","0","0","3","0","0","3"
"Harare","-17.82772","31.05337","9","0","0","0","1","0","1","11","0","5","3","2","10","4","2","5","0","11","6","0","2","2","1","11"
"Harbury","52.23537","-1.45706","0","0","0","0","1","0","0","1","0","1","0","0","1","0","0","1","0","1","1","0","0","0","0","1"
"Hardenberg","52.57583","6.61944","1","0","0","0","0","0","0","1","0","0","1","0","1","0","0","1","0","1","0","1","0","0","0","1"
"Hardheim","49.61194","9.47194","1","0","0","0","0","0","0","1","0","0","1","0","1","0","1","0","0","1","0","0","1","0","0","1"
"Hargeysa","9.56","44.065","19","0","0","0","0","0","0","19","2","7","5","5","19","11","2","1","5","19","7","1","9","0","2","19"
"Haripur","33.99783","72.93493","7","0","0","0","0","0","0","7","2","4","0","0","6","2","4","1","0","7","1","0","3","0","3","7"
"Haripur","22.93611","88.23194","7","0","0","0","0","0","0","7","2","4","0","0","6","2","4","1","0","7","1","0","3","0","3","7"
"Harker Heights","31.08351","-97.65974","0","0","0","0","1","0","0","1","0","1","0","0","1","0","0","1","0","1","0","0","1","0","0","1"
"Harleston","52.40302","1.29664","2","0","0","0","0","0","0","2","1","0","1","0","2","1","0","1","0","2","0","2","0","0","0","2"
"Harlow","51.77655","0.11158","8","2","0","0","1","0","0","11","2","4","3","1","10","3","0","7","1","11","2","2","7","0","0","11"
"Harnai","30.10077","67.93824","1","0","0","0","0","0","0","1","0","0","1","0","1","0","1","0","0","1","1","0","0","0","0","1"
"Harnai","17.8134","73.09668","1","0","0","0","0","0","0","1","0","0","1","0","1","0","1","0","0","1","1","0","0","0","0","1"
"Harold Wood","51.59462","0.23294","1","0","0","0","0","0","1","2","0","1","0","1","2","1","0","1","0","2","0","0","2","0","0","2"
"Harpenden","51.81684","-0.35706","14","0","0","0","1","0","0","15","2","2","5","0","9","8","0","7","0","15","3","4","8","0","0","15"
"Harper","30.29992","-99.24421","1","0","0","0","0","0","0","1","0","0","0","0","0","0","1","0","0","1","0","0","0","0","1","1"
"Harper","37.28669","-98.02589","1","0","0","0","0","0","0","1","0","0","0","0","0","0","1","0","0","1","0","0","0","0","1","1"
"Harper","4.3782","-7.71081","1","0","0","0","0","0","0","1","0","0","0","0","0","0","1","0","0","1","0","0","0","0","1","1"
"Harrah","46.40429","-120.54423","1","0","0","0","0","0","0","1","0","1","0","0","1","0","1","0","0","1","1","0","0","0","0","1"
"Harrah","35.48951","-97.16364","1","0","0","0","0","0","0","1","0","1","0","0","1","0","1","0","0","1","1","0","0","0","0","1"
"Harrietsham","51.24252","0.6706","1","0","0","0","0","0","0","1","0","0","1","0","1","0","0","1","0","1","0","0","1","0","0","1"
"Harrisdale","-32.11084","115.93563","1","0","0","0","0","0","0","1","1","0","0","0","1","0","0","1","0","1","0","1","0","0","0","1"
"Harrisonburg","31.77211","-91.82152","1","0","0","0","0","0","0","1","0","1","0","0","1","1","0","0","0","1","0","0","1","0","0","1"
"Harrisonburg","38.44957","-78.86892","1","0","0","0","0","0","0","1","0","1","0","0","1","1","0","0","0","1","0","0","1","0","0","1"
"Harrogate","36.5823","-83.65686","42","1","0","0","1","0","4","48","7","12","25","0","44","19","7","21","0","47","6","14","26","0","2","48"
"Harrogate","53.99078","-1.5373","42","1","0","0","1","0","4","48","7","12","25","0","44","19","7","21","0","47","6","14","26","0","2","48"
"Harrold","52.20127","-0.61038","1","0","0","0","0","0","0","1","0","0","1","0","1","0","1","0","0","1","0","0","1","0","0","1"
"Harrow","51.57835","-0.33208","19","0","0","1","1","0","0","21","6","3","5","1","15","4","5","11","1","21","3","5","11","2","0","21"
"Harrow on the Hill","51.57142","-0.33371","1","0","0","0","1","0","0","2","1","0","0","0","1","1","0","0","1","2","0","0","2","0","0","2"
"Hartlepool","54.68554","-1.21028","15","0","0","0","1","0","0","16","1","10","3","1","15","4","6","6","0","16","9","2","5","0","0","16"
"Hartley Wintney","51.30379","-0.90019","3","0","0","0","0","0","0","3","0","0","3","0","3","0","0","3","0","3","0","0","3","0","0","3"
"Hartsville","36.39088","-86.16721","1","0","0","0","0","0","0","1","0","1","0","0","1","0","1","0","0","1","1","0","0","0","0","1"
"Hartsville","34.37404","-80.0734","1","0","0","0","0","0","0","1","0","1","0","0","1","0","1","0","0","1","1","0","0","0","0","1"
"Harunabad","29.61206","73.13802","1","0","0","0","0","0","0","1","1","0","0","0","1","0","0","1","0","1","0","0","1","0","0","1"
"Harwell","51.59947","-1.29175","1","0","0","0","0","0","0","1","0","0","0","0","0","0","0","1","0","1","1","0","0","0","0","1"
"Harwich","41.68622","-70.07585","1","0","0","0","0","0","1","2","0","2","0","0","2","0","0","2","0","2","1","0","1","0","0","2"
"Harwich","51.94194","1.28437","1","0","0","0","0","0","1","2","0","2","0","0","2","0","0","2","0","2","1","0","1","0","0","2"
"Hasilpur","29.69221","72.54566","2","1","0","0","0","0","0","3","2","1","0","0","3","0","0","3","0","3","0","0","3","0","0","3"
"Haslemere","51.09015","-0.70785","21","1","0","1","2","0","2","27","6","2","3","0","11","10","4","13","0","27","2","10","15","0","0","27"
"Haslingden","53.70326","-2.32382","0","0","0","0","0","0","1","1","1","0","0","0","1","1","0","0","0","1","0","0","1","0","0","1"
"Hassi Messaoud","31.68041","6.07286","2","0","0","0","0","0","0","2","0","2","0","0","2","0","0","2","0","2","1","1","0","0","0","2"
"Hassocks","50.92814","-0.16617","5","0","0","2","0","0","0","7","2","0","1","0","3","2","0","5","0","7","0","2","5","0","0","7"
"Hastings","40.58612","-98.38839","34","2","0","2","8","0","3","49","13","16","16","0","45","17","10","22","0","49","13","21","15","0","0","49"
"Hastings","44.7433","-92.85243","34","2","0","2","8","0","3","49","13","16","16","0","45","17","10","22","0","49","13","21","15","0","0","49"
"Hastings","42.64587","-85.29084","34","2","0","2","8","0","3","49","13","16","16","0","45","17","10","22","0","49","13","21","15","0","0","49"
"Hastings","29.71802","-81.50813","34","2","0","2","8","0","3","49","13","16","16","0","45","17","10","22","0","49","13","21","15","0","0","49"
"Hastings","40.66507","-78.71225","34","2","0","2","8","0","3","49","13","16","16","0","45","17","10","22","0","49","13","21","15","0","0","49"
"Hastings","8.37994","-13.13693","34","2","0","2","8","0","3","49","13","16","16","0","45","17","10","22","0","49","13","21","15","0","0","49"
"Hastings","50.85519","0.57292","34","2","0","2","8","0","3","49","13","16","16","0","45","17","10","22","0","49","13","21","15","0","0","49"
"Hastings","-38.3","145.18333","34","2","0","2","8","0","3","49","13","16","16","0","45","17","10","22","0","49","13","21","15","0","0","49"
"Hastings","-39.6381","176.84918","34","2","0","2","8","0","3","49","13","16","16","0","45","17","10","22","0","49","13","21","15","0","0","49"
"Hatfield","37.90255","-87.22417","13","0","0","1","0","0","1","15","2","3","5","0","10","5","5","5","0","15","2","0","13","0","0","15"
"Hatfield","40.27983","-75.29934","13","0","0","1","0","0","1","15","2","3","5","0","10","5","5","5","0","15","2","0","13","0","0","15"
"Hatfield","42.37092","-72.59814","13","0","0","1","0","0","1","15","2","3","5","0","10","5","5","5","0","15","2","0","13","0","0","15"
"Hatfield","53.57788","-0.99924","13","0","0","1","0","0","1","15","2","3","5","0","10","5","5","5","0","15","2","0","13","0","0","15"
"Hatfield","51.76338","-0.22419","13","0","0","1","0","0","1","15","2","3","5","0","10","5","5","5","0","15","2","0","13","0","0","15"
"Hatfield Heath","51.81233","0.21243","1","0","0","0","0","0","0","1","0","0","0","0","0","1","0","0","0","1","1","0","0","0","0","1"
"Hatton","47.63971","-97.45342","1","0","0","0","1","0","0","2","2","0","0","0","2","0","1","0","1","2","0","1","1","0","0","2"
"Hatton","57.42434","-1.92218","1","0","0","0","1","0","0","2","2","0","0","0","2","0","1","0","1","2","0","1","1","0","0","2"
"Hatton","52.30007","-1.6326","1","0","0","0","1","0","0","2","2","0","0","0","2","0","1","0","1","2","0","1","1","0","0","2"
"Hatton","6.8916","80.5955","1","0","0","0","1","0","0","2","2","0","0","0","2","0","1","0","1","2","0","1","1","0","0","2"
"Havana","40.30004","-90.06095","1","0","0","0","0","0","0","1","1","0","0","0","1","1","0","0","0","1","0","0","1","0","0","1"
"Havana","30.62381","-84.41463","1","0","0","0","0","0","0","1","1","0","0","0","1","1","0","0","0","1","0","0","1","0","0","1"
"Havana","23.13302","-82.38304","1","0","0","0","0","0","0","1","1","0","0","0","1","1","0","0","0","1","0","0","1","0","0","1"
"Havant","50.8567","-0.98559","6","0","0","0","0","0","0","6","1","2","3","0","6","3","2","1","0","6","2","1","3","0","0","6"
"Haveluloto","-21.15216","-175.21333","1","0","0","0","0","0","0","1","0","1","0","0","1","1","0","0","0","1","1","0","0","0","0","1"
"Haverfordwest","51.80169","-4.96914","83","0","0","1","8","0","2","94","19","20","14","1","54","27","9","58","0","94","24","42","24","0","4","94"
"Haverhill","26.69118","-80.12004","4","0","0","1","1","0","0","6","1","2","3","0","6","2","2","2","0","6","2","2","2","0","0","6"
"Haverhill","44.03451","-72.06398","4","0","0","1","1","0","0","6","1","2","3","0","6","2","2","2","0","6","2","2","2","0","0","6"
"Haverhill","42.7762","-71.07728","4","0","0","1","1","0","0","6","1","2","3","0","6","2","2","2","0","6","2","2","2","0","0","6"
"Haverhill","52.08226","0.43891","4","0","0","1","1","0","0","6","1","2","3","0","6","2","2","2","0","6","2","2","2","0","0","6"
"Ḩawallī","29.33278","48.02861","2","0","0","0","0","0","0","2","1","0","1","0","2","0","1","1","0","2","0","1","1","0","0","2"
"Hawassa","7.06205","38.47635","1","0","0","0","0","0","0","1","0","0","0","0","0","0","1","0","0","1","0","0","0","1","0","1"
"Hawick","55.42273","-2.78666","1","0","0","0","0","0","0","1","0","0","1","0","1","0","0","1","0","1","0","0","1","0","0","1"
"Hawkhurst","51.0479","0.51095","1","0","0","0","0","0","0","1","1","0","0","0","1","0","0","1","0","1","0","0","1","0","0","1"
"Hawthorn","54.8","-1.35","1","0","0","0","0","0","0","1","0","1","0","0","1","1","0","0","0","1","0","0","1","0","0","1"
"Hawthorn","-34.97384","138.60738","1","0","0","0","0","0","0","1","0","1","0","0","1","1","0","0","0","1","0","0","1","0","0","1"
"Hawthorn","-37.81992","145.0358","1","0","0","0","0","0","0","1","0","1","0","0","1","1","0","0","0","1","0","0","1","0","0","1"
"Haydock","53.46723","-2.68166","1","0","0","0","0","0","0","1","0","1","0","0","1","1","0","0","0","1","1","0","0","0","0","1"
"Hayes","30.10882","-92.92015","2","1","0","0","0","0","0","3","3","0","0","0","3","2","0","1","0","3","0","1","2","0","0","3"
"Hayes","17.87569","-77.23711","2","1","0","0","0","0","0","3","3","0","0","0","3","2","0","1","0","3","0","1","2","0","0","3"
"Hayes","51.51579","-0.4234","2","1","0","0","0","0","0","3","3","0","0","0","3","2","0","1","0","3","0","1","2","0","0","3"
"Hayfield","43.89052","-92.84769","1","0","0","0","0","0","0","1","0","0","1","0","1","1","0","0","0","1","0","0","1","0","0","1"
"Hayfield","38.75178","-77.13581","1","0","0","0","0","0","0","1","0","0","1","0","1","1","0","0","0","1","0","0","1","0","0","1"
"Hayfield","53.37893","-1.94544","1","0","0","0","0","0","0","1","0","0","1","0","1","1","0","0","0","1","0","0","1","0","0","1"
"Hayle","50.18392","-5.42137","1","1","0","0","0","0","0","2","0","0","2","0","2","1","0","1","0","2","0","2","0","0","0","2"
"Hayling Island","50.7838","-0.96869","2","0","0","0","2","0","0","4","2","0","0","0","2","1","0","3","0","4","1","0","3","0","0","4"
"Haymā’","19.95931","56.27575","1","0","0","0","0","0","0","1","0","1","0","0","1","1","0","0","0","1","0","0","1","0","0","1"
"Haywards Heath","50.99769","-0.10313","15","1","0","0","1","0","2","19","6","4","5","0","15","8","2","9","0","19","2","4","13","0","0","19"
"Hazel Grove","53.38333","-2.11667","1","0","0","0","0","0","0","1","0","1","0","0","1","1","0","0","0","1","0","0","1","0","0","1"
"Hazleton","42.62082","-91.90017","1","0","0","0","0","0","0","1","1","0","0","0","1","0","1","0","0","1","0","0","1","0","0","1"
"Hazleton","40.95842","-75.97465","1","0","0","0","0","0","0","1","1","0","0","0","1","0","1","0","0","1","0","0","1","0","0","1"
"Headcorn","51.16966","0.62433","2","0","0","0","2","0","0","4","0","1","1","0","2","1","0","3","0","4","0","1","3","0","0","4"
"Heathfield","50.96718","0.25612","2","1","0","0","0","0","1","4","0","1","3","0","4","0","1","3","0","4","1","1","2","0","0","4"
"Heathfield","-35.02834","138.71724","2","1","0","0","0","0","1","4","0","1","3","0","4","0","1","3","0","4","1","1","2","0","0","4"
"Heaton Chapel","53.43015","-2.17538","1","0","0","0","0","0","0","1","0","0","0","0","0","0","1","0","0","1","0","0","1","0","0","1"
"Hebburn","54.97302","-1.51546","2","0","0","0","1","0","0","3","0","2","1","0","3","2","0","1","0","3","1","0","2","0","0","3"
"Hebden Bridge","53.74093","-2.01337","3","0","0","0","1","0","0","4","0","2","1","0","3","2","0","2","0","4","0","1","3","0","0","4"
"Hebron","46.90056","-102.04544","7","0","1","0","1","0","0","9","3","1","2","0","6","2","3","4","0","9","5","0","3","0","0","8"
"Hebron","40.16639","-97.58588","7","0","1","0","1","0","0","9","3","1","2","0","6","2","3","4","0","9","5","0","3","0","0","8"
"Hebron","42.47169","-88.43232","7","0","1","0","1","0","0","9","3","1","2","0","6","2","3","4","0","9","5","0","3","0","0","8"
"Hebron","41.31865","-87.20031","7","0","1","0","1","0","0","9","3","1","2","0","6","2","3","4","0","9","5","0","3","0","0","8"
"Hebron","39.06589","-84.70106","7","0","1","0","1","0","0","9","3","1","2","0","6","2","3","4","0","9","5","0","3","0","0","8"
"Hebron","39.96173","-82.49127","7","0","1","0","1","0","0","9","3","1","2","0","6","2","3","4","0","9","5","0","3","0","0","8"
"Hebron","40.33898","-76.3994","7","0","1","0","1","0","0","9","3","1","2","0","6","2","3","4","0","9","5","0","3","0","0","8"
"Hebron","38.42012","-75.68771","7","0","1","0","1","0","0","9","3","1","2","0","6","2","3","4","0","9","5","0","3","0","0","8"
"Hebron","41.65788","-72.36592","7","0","1","0","1","0","0","9","3","1","2","0","6","2","3","4","0","9","5","0","3","0","0","8"
"Hebron","44.19813","-70.40645","7","0","1","0","1","0","0","9","3","1","2","0","6","2","3","4","0","9","5","0","3","0","0","8"
"Hebron","55.18333","-1.68333","7","0","1","0","1","0","0","9","3","1","2","0","6","2","3","4","0","9","5","0","3","0","0","8"
"Hebron","31.52935","35.0938","7","0","1","0","1","0","0","9","3","1","2","0","6","2","3","4","0","9","5","0","3","0","0","8"
"Heidelberg","26.19702","-97.88028","3","0","0","0","0","0","0","3","0","1","1","0","2","0","1","2","0","3","0","0","1","0","2","3"
"Heidelberg","31.88682","-88.98394","3","0","0","0","0","0","0","3","0","1","1","0","2","0","1","2","0","3","0","0","1","0","2","3"
"Heidelberg","40.39229","-80.09089","3","0","0","0","0","0","0","3","0","1","1","0","2","0","1","2","0","3","0","0","1","0","2","3"
"Heidelberg","49.40768","8.69079","3","0","0","0","0","0","0","3","0","1","1","0","2","0","1","2","0","3","0","0","1","0","2","3"
"Heidelberg","-26.50476","28.35921","3","0","0","0","0","0","0","3","0","1","1","0","2","0","1","2","0","3","0","0","1","0","2","3"
"Heidelberg","-37.75","145.06667","3","0","0","0","0","0","0","3","0","1","1","0","2","0","1","2","0","3","0","0","1","0","2","3"
"Helensburgh","56.00614","-4.72648","6","1","0","0","0","0","1","8","3","0","5","0","8","1","2","5","0","8","0","2","6","0","0","8"
"Helensburgh","-34.17836","150.99522","6","1","0","0","0","0","1","8","3","0","5","0","8","1","2","5","0","8","0","2","6","0","0","8"
"Hellifield","54.00486","-2.22302","1","0","0","0","0","0","0","1","0","1","0","0","1","0","1","0","0","1","0","0","1","0","0","1"
"Helmond","51.48167","5.66111","1","0","0","0","0","0","0","1","0","0","0","1","1","0","0","1","0","1","0","0","0","1","0","1"
"Helsby","53.27396","-2.76905","1","0","0","0","0","0","0","1","0","1","0","0","1","1","0","0","0","1","1","0","0","0","0","1"
"Helsinki","60.16952","24.93545","4","0","0","0","0","0","1","5","1","2","0","0","3","5","0","0","0","5","2","0","3","0","0","5"
"Helston","50.10319","-5.27045","1","0","0","0","0","0","0","1","1","0","0","0","1","0","0","1","0","1","0","0","1","0","0","1"
"Hemel Hempstead","51.75368","-0.44975","21","1","0","1","4","0","1","28","6","6","8","1","21","10","2","16","0","28","3","8","15","2","0","28"
"Hemingford Abbots","52.32275","-0.11939","1","0","0","0","0","0","0","1","0","0","1","0","1","1","0","0","0","1","0","1","0","0","0","1"
"Hemyock","50.91234","-3.22807","1","0","0","0","0","0","0","1","0","0","1","0","1","1","0","0","0","1","0","0","1","0","0","1"
"Henderson","36.0397","-114.98194","1","0","0","0","0","0","0","1","0","0","0","0","0","1","0","0","0","1","1","0","0","0","0","1"
"Henderson","40.77973","-97.81227","1","0","0","0","0","0","0","1","0","0","0","0","0","1","0","0","0","1","1","0","0","0","0","1"
"Henderson","32.15322","-94.79938","1","0","0","0","0","0","0","1","0","0","0","0","0","1","0","0","0","1","1","0","0","0","0","1"
"Henderson","44.5283","-93.90774","1","0","0","0","0","0","0","1","0","0","0","0","0","1","0","0","0","1","1","0","0","0","0","1"
"Henderson","30.31325","-91.79039","1","0","0","0","0","0","0","1","0","0","0","0","0","1","0","0","0","1","1","0","0","0","0","1"
"Henderson","35.43924","-88.64144","1","0","0","0","0","0","0","1","0","0","0","0","0","1","0","0","0","1","1","0","0","0","0","1"
"Henderson","37.83615","-87.59001","1","0","0","0","0","0","0","1","0","0","0","0","0","1","0","0","0","1","1","0","0","0","0","1"
"Henderson","32.00813","-81.25887","1","0","0","0","0","0","0","1","0","0","0","0","0","1","0","0","0","1","1","0","0","0","0","1"
"Henderson","36.32959","-78.39916","1","0","0","0","0","0","0","1","0","0","0","0","0","1","0","0","0","1","1","0","0","0","0","1"
"Henderson","-36.3","-61.71667","1","0","0","0","0","0","0","1","0","0","0","0","0","1","0","0","0","1","1","0","0","0","0","1"
"Henfield","50.92995","-0.27071","4","0","0","0","0","0","0","4","1","1","1","0","3","3","0","1","0","4","1","0","3","0","0","4"
"Hengelo","52.05083","6.30972","1","0","0","0","0","0","0","1","0","0","0","0","0","0","0","1","0","1","0","0","1","0","0","1"
"Hengelo","52.26583","6.79306","1","0","0","0","0","0","0","1","0","0","0","0","0","0","0","1","0","1","0","0","1","0","0","1"
"Hengoed","51.65083","-3.23167","2","0","0","0","1","0","0","3","1","1","1","0","3","0","0","3","0","3","1","0","2","0","0","3"
"Henley","52.11802","1.15026","3","0","0","0","0","0","0","3","1","1","1","0","3","0","0","3","0","3","1","2","0","0","0","3"
"Henley-on-Thames","51.53333","-0.9","4","0","0","0","0","0","0","4","1","1","0","0","2","3","0","1","0","4","0","0","4","0","0","4"
"Henlow","52.03021","-0.28599","6","0","0","0","0","0","0","6","1","3","1","0","5","3","1","2","0","6","1","0","3","0","2","6"
"Hennepin","41.2542","-89.34231","0","0","0","0","1","0","0","1","0","0","1","0","1","0","0","1","0","1","0","0","1","0","0","1"
"Herāt","34.34817","62.19967","4","0","0","1","0","0","0","5","0","0","3","0","3","2","0","1","0","3","0","1","2","0","1","4"
"Herbrandston","51.72639","-5.08667","1","0","0","0","0","0","0","1","0","1","0","0","1","0","0","1","0","1","0","0","1","0","0","1"
"Heredia","10.00236","-84.11651","1","1","0","0","0","0","0","2","1","0","0","0","1","0","2","0","0","2","0","0","2","0","0","2"
"Hereford","34.81521","-102.39932","32","1","0","1","3","0","1","38","6","13","14","1","34","20","4","15","0","39","7","12","16","1","3","39"
"Hereford","40.44926","-75.55213","32","1","0","1","3","0","1","38","6","13","14","1","34","20","4","15","0","39","7","12","16","1","3","39"
"Hereford","52.05684","-2.71482","32","1","0","1","3","0","1","38","6","13","14","1","34","20","4","15","0","39","7","12","16","1","3","39"
"Herent","50.90861","4.67056","1","0","0","0","0","0","0","1","0","0","0","0","0","0","0","1","0","1","0","0","1","0","0","1"
"Hermance","46.30141","6.24332","1","0","0","0","0","0","0","1","1","0","0","0","1","0","0","1","0","1","0","0","1","0","0","1"
"Hermann","38.70421","-91.43738","3","0","0","0","0","0","0","3","1","0","2","0","3","1","1","1","0","3","0","2","1","0","0","3"
"Herndon","38.96955","-77.3861","1","0","0","0","0","0","0","1","0","1","0","0","1","0","1","0","0","1","0","0","1","0","0","1"
"Herne Bay","51.373","1.12857","3","0","0","0","0","0","0","3","0","1","1","0","2","0","2","1","0","3","1","1","1","0","0","3"
"Herre","59.10351","9.56195","0","0","0","0","1","0","0","1","1","0","0","0","1","0","1","0","0","1","0","0","1","0","0","1"
"Hertford","36.19016","-76.46605","17","3","0","1","2","0","0","23","5","5","6","0","16","9","4","10","0","23","5","1","17","0","0","23"
"Hertford","51.79588","-0.07854","17","3","0","1","2","0","0","23","5","5","6","0","16","9","4","10","0","23","5","1","17","0","0","23"
"Hessle","53.72454","-0.43842","4","0","0","0","0","0","0","4","0","2","1","0","3","2","0","2","0","4","1","0","1","0","1","3"
"Heswall","53.32733","-3.09648","1","0","0","0","1","0","0","2","0","1","0","1","2","1","0","1","0","2","1","0","1","0","0","2"
"Hetauda","27.42839","85.03219","3","0","0","0","1","0","0","4","1","0","0","0","1","3","1","0","0","4","1","0","1","0","2","4"
"Hetton-Le-Hole","54.81667","-1.45","2","0","0","0","0","0","0","2","0","0","0","0","0","0","2","0","0","2","0","1","1","0","0","2"
"Hexham","54.96986","-2.104","6","0","0","0","1","0","0","7","1","2","3","0","6","3","0","4","0","7","1","1","5","0","0","7"
"Heysham","54.04367","-2.89322","1","0","0","0","0","0","0","1","0","0","1","0","1","0","1","0","0","1","0","0","1","0","0","1"
"Heywood","53.59245","-2.21941","2","0","0","0","0","0","0","2","2","0","0","0","2","0","0","2","0","2","0","2","0","0","0","2"
"Heywood","-38.13294","141.62949","2","0","0","0","0","0","0","2","2","0","0","0","2","0","0","2","0","2","0","2","0","0","0","2"
"High Bentham","54.11823","-2.51199","1","0","0","0","0","0","0","1","0","1","0","0","1","0","1","0","0","1","1","0","0","0","0","1"
"Highbridge","51.21667","-2.98333","1","0","0","0","0","0","0","1","0","0","0","0","0","0","1","0","0","1","1","0","0","0","0","1"
"Highclere","51.3386","-1.37569","1","0","0","0","0","0","0","1","0","0","1","0","1","1","0","0","0","1","0","0","1","0","0","1"
"Highland","46.13152","-119.11418","3","0","0","0","0","0","0","3","0","2","0","0","2","2","0","1","0","3","3","0","0","0","0","3"
"Highland","34.12834","-117.20865","3","0","0","0","0","0","0","3","0","2","0","0","2","2","0","1","0","3","3","0","0","0","0","3"
"Highland","40.42548","-111.79447","3","0","0","0","0","0","0","3","0","2","0","0","2","2","0","1","0","3","3","0","0","0","0","3"
"Highland","39.85972","-95.2697","3","0","0","0","0","0","0","3","0","2","0","0","2","2","0","1","0","3","3","0","0","0","0","3"
"Highland","39.21389","-94.8308","3","0","0","0","0","0","0","3","0","2","0","0","2","2","0","1","0","3","3","0","0","0","0","3"
"Highland","36.2759","-91.52403","3","0","0","0","0","0","0","3","0","2","0","0","2","2","0","1","0","3","3","0","0","0","0","3"
"Highland","43.04666","-90.37985","3","0","0","0","0","0","0","3","0","2","0","0","2","2","0","1","0","3","3","0","0","0","0","3"
"Highland","38.73949","-89.6712","3","0","0","0","0","0","0","3","0","2","0","0","2","2","0","1","0","3","3","0","0","0","0","3"
"Highland","38.03976","-87.57307","3","0","0","0","0","0","0","3","0","2","0","0","2","2","0","1","0","3","3","0","0","0","0","3"
"Highland","41.55365","-87.45198","3","0","0","0","0","0","0","3","0","2","0","0","2","2","0","1","0","3","3","0","0","0","0","3"
"Highland","39.179","-76.95748","3","0","0","0","0","0","0","3","0","2","0","0","2","2","0","1","0","3","3","0","0","0","0","3"
"Highland","41.72093","-73.96014","3","0","0","0","0","0","0","3","0","2","0","0","2","2","0","1","0","3","3","0","0","0","0","3"
"Highland","57.48566","-4.22823","3","0","0","0","0","0","0","3","0","2","0","0","2","2","0","1","0","3","3","0","0","0","0","3"
"Highlands Ranch","39.55388","-104.96943","1","0","0","0","0","0","0","1","0","0","1","0","1","1","0","0","0","1","0","1","0","0","0","1"
"High Peak","53.36797","-1.84536","2","0","0","0","0","0","0","2","0","2","0","0","2","0","0","2","0","2","0","0","2","0","0","2"
"High River","50.58341","-113.86867","1","0","0","0","0","0","0","1","0","0","1","0","1","0","0","1","0","1","0","1","0","0","0","1"
"High Valleyfield","56.06357","-3.59913","0","1","0","0","0","0","0","1","1","0","0","0","1","0","1","0","0","1","0","1","0","0","0","1"
"High Wycombe","51.62907","-0.74934","30","2","0","2","2","0","3","39","3","9","15","2","29","20","4","15","0","39","4","12","23","0","0","39"
"High Wycombe","-31.94444","116.0034","30","2","0","2","2","0","3","39","3","9","15","2","29","20","4","15","0","39","4","12","23","0","0","39"
"Hihyā","30.6713","31.58801","1","0","0","0","0","0","0","1","1","0","0","0","1","1","0","0","0","1","0","0","1","0","0","1"
"Hildenborough","51.22947","0.24358","1","0","0","0","0","0","0","1","0","0","1","0","1","0","1","0","0","1","0","0","1","0","0","1"
"Hillsborough","37.5741","-122.37942","1","0","0","0","0","0","0","1","0","1","0","0","1","0","0","1","0","1","0","0","1","0","0","1"
"Hillsborough","36.07542","-79.09973","1","0","0","0","0","0","0","1","0","1","0","0","1","0","0","1","0","1","0","0","1","0","0","1"
"Hillsborough","43.1141","-71.8992","1","0","0","0","0","0","0","1","0","1","0","0","1","0","0","1","0","1","0","0","1","0","0","1"
"Hillsborough","12.48292","-61.45597","1","0","0","0","0","0","0","1","0","1","0","0","1","0","0","1","0","1","0","0","1","0","0","1"
"Hillsborough","54.46345","-6.07664","1","0","0","0","0","0","0","1","0","1","0","0","1","0","0","1","0","1","0","0","1","0","0","1"
"Hillsborough","-32.96553","151.67235","1","0","0","0","0","0","0","1","0","1","0","0","1","0","0","1","0","1","0","0","1","0","0","1"
"Hillsdale","38.68338","-90.284","1","0","0","0","0","0","0","1","0","0","1","0","1","0","0","1","0","1","0","0","1","0","0","1"
"Hillsdale","41.61364","-90.1729","1","0","0","0","0","0","0","1","0","0","1","0","1","0","0","1","0","1","0","0","1","0","0","1"
"Hillsdale","41.92005","-84.63051","1","0","0","0","0","0","0","1","0","0","1","0","1","0","0","1","0","1","0","0","1","0","0","1"
"Hillsdale","36.00514","-80.4395","1","0","0","0","0","0","0","1","0","0","1","0","1","0","0","1","0","1","0","0","1","0","0","1"
"Hillsdale","41.0026","-74.04042","1","0","0","0","0","0","0","1","0","0","1","0","1","0","0","1","0","1","0","0","1","0","0","1"
"Hillsdale","-33.95151","151.22784","1","0","0","0","0","0","0","1","0","0","1","0","1","0","0","1","0","1","0","0","1","0","0","1"
"Hilton Head","32.21632","-80.75261","1","0","0","0","0","0","0","1","0","1","0","0","1","1","0","0","0","1","0","0","1","0","0","1"
"Hilversum","52.22333","5.17639","1","0","0","0","0","0","1","2","1","0","0","0","1","1","0","1","0","2","0","0","2","0","0","2"
"Himatnagar","23.59893","72.96602","1","0","0","0","0","0","0","1","1","0","0","0","1","0","1","0","0","1","0","0","1","0","0","1"
"Hinckley","39.32496","-112.67106","3","0","0","1","0","0","0","4","0","2","2","0","4","1","1","2","0","4","1","2","1","0","0","4"
"Hinckley","46.01134","-92.94437","3","0","0","1","0","0","0","4","0","2","2","0","4","1","1","2","0","4","1","2","1","0","0","4"
"Hinckley","41.76892","-88.64091","3","0","0","1","0","0","0","4","0","2","2","0","4","1","1","2","0","4","1","2","1","0","0","4"
"Hinckley","52.5389","-1.37613","3","0","0","1","0","0","0","4","0","2","2","0","4","1","1","2","0","4","1","2","1","0","0","4"
"Hindhead","51.11381","-0.73351","3","0","0","0","0","0","1","4","1","1","0","0","2","1","1","2","0","4","2","0","2","0","0","4"
"Hinsdale","41.80086","-87.93701","1","0","0","0","0","0","0","1","0","0","0","0","0","0","0","1","0","1","0","0","1","0","0","1"
"Hinsdale","42.4387","-73.12538","1","0","0","0","0","0","0","1","0","0","0","0","0","0","0","1","0","1","0","0","1","0","0","1"
"Hinsdale","42.78619","-72.48648","1","0","0","0","0","0","0","1","0","0","0","0","0","0","0","1","0","1","0","0","1","0","0","1"
"Hinton Charterhouse","51.32377","-2.32841","1","0","0","0","0","0","0","1","1","0","0","0","1","0","1","0","0","1","0","0","1","0","0","1"
"Hisar","37.60094","41.22799","5","0","0","0","0","0","0","5","2","2","0","0","4","1","0","4","0","5","0","0","4","0","1","5"
"Hisar","29.15394","75.72294","5","0","0","0","0","0","0","5","2","2","0","0","4","1","0","4","0","5","0","0","4","0","1","5"
"Histon","52.25166","0.10643","1","0","0","0","0","0","0","1","0","0","1","0","1","1","0","0","0","1","0","0","1","0","0","1"
"Hīt","33.63664","42.82768","1","0","0","0","0","0","0","1","0","1","0","0","1","0","1","0","0","1","0","0","0","0","1","1"
"Hitchin","51.94924","-0.28496","14","1","0","1","2","0","0","18","3","4","6","0","13","4","2","12","0","18","2","3","13","0","0","18"
"Ho","6.60084","0.4713","4","0","0","0","0","0","0","4","1","1","0","0","2","2","2","0","0","4","2","0","2","0","0","4"
"Hobe Sound","27.0595","-80.13643","1","0","0","0","0","0","0","1","1","0","0","0","1","0","0","1","0","1","0","1","0","0","0","1"
"Hobro","56.64306","9.79029","1","0","0","0","0","0","0","1","1","0","0","0","1","1","0","0","0","1","0","1","0","0","0","1"
"Ho Chi Minh City","10.82302","106.62965","7","0","0","0","1","0","0","8","3","0","2","0","5","5","3","0","0","8","0","1","5","0","2","8"
"Hockley","52.5","-1.91667","5","0","0","0","0","0","0","5","1","4","0","0","5","2","0","3","0","5","1","2","2","0","0","5"
"Hoddesdon","51.76148","-0.01144","2","0","0","0","0","0","0","2","0","1","1","0","2","1","0","1","0","2","0","0","2","0","0","2"
"Hod HaSharon","32.15934","34.8932","1","0","0","0","0","0","0","1","1","0","0","0","1","0","0","1","0","1","0","0","1","0","0","1"
"Hoeilaart","50.7673","4.46835","1","0","0","0","0","0","0","1","0","0","1","0","1","0","0","1","0","1","0","0","1","0","0","1"
"Hohoe","7.15181","0.47362","2","0","0","0","0","0","0","2","0","1","0","0","1","2","0","0","0","2","1","0","1","0","0","2"
"Hojāi","26.00281","92.85605","1","0","0","0","0","0","0","1","1","0","0","0","1","1","0","0","0","1","0","0","1","0","0","1"
"Holden","38.71418","-93.99133","0","0","0","0","1","0","0","1","0","0","0","0","0","1","0","0","0","1","0","0","1","0","0","1"
"Holden","37.82427","-82.05957","0","0","0","0","1","0","0","1","0","0","0","0","0","1","0","0","0","1","0","0","1","0","0","1"
"Holden","42.35176","-71.86341","0","0","0","0","1","0","0","1","0","0","0","0","0","1","0","0","0","1","0","0","1","0","0","1"
"Holden","44.75285","-68.67892","0","0","0","0","1","0","0","1","0","0","0","0","0","1","0","0","0","1","0","0","1","0","0","1"
"Holloway","51.55237","-0.12497","0","0","0","0","1","0","0","1","1","0","0","0","1","0","0","1","0","1","0","1","0","0","0","1"
"Holloways Beach","-16.84209","145.73922","1","0","0","0","0","0","0","1","0","0","1","0","1","1","0","0","0","1","0","0","1","0","0","1"
"Holmes Chapel","53.2014","-2.35742","0","1","0","0","0","0","1","2","1","0","1","0","2","0","0","2","0","2","0","1","1","0","0","2"
"Holmfirth","53.56968","-1.78777","3","0","0","0","0","0","0","3","1","0","2","0","3","0","0","3","0","3","0","0","3","0","0","3"
"Hölö","59.01667","17.53333","1","0","0","0","0","0","0","1","0","0","1","0","1","0","0","1","0","1","0","0","0","0","1","1"
"Hölö","59.28333","18.66667","1","0","0","0","0","0","0","1","0","0","1","0","1","0","0","1","0","1","0","0","0","0","1","1"
"Holt","33.23401","-87.48445","4","0","0","0","0","0","0","4","3","0","1","0","4","1","0","3","0","4","0","3","1","0","0","4"
"Holt","42.64059","-84.51525","4","0","0","0","0","0","0","4","3","0","1","0","4","1","0","3","0","4","0","3","1","0","0","4"
"Holt","53.06667","-2.88333","4","0","0","0","0","0","0","4","3","0","1","0","4","1","0","3","0","4","0","3","1","0","0","4"
"Holt","51.35556","-2.19722","4","0","0","0","0","0","0","4","3","0","1","0","4","1","0","3","0","4","0","3","1","0","0","4"
"Holt","52.90591","1.08863","4","0","0","0","0","0","0","4","3","0","1","0","4","1","0","3","0","4","0","3","1","0","0","4"
"Holt","54.81667","9.15","4","0","0","0","0","0","0","4","3","0","1","0","4","1","0","3","0","4","0","3","1","0","0","4"
"Holt","46.57856","26.97499","4","0","0","0","0","0","0","4","3","0","1","0","4","1","0","3","0","4","0","3","1","0","0","4"
"Holt","44.43333","119.2","4","0","0","0","0","0","0","4","3","0","1","0","4","1","0","3","0","4","0","3","1","0","0","4"
"Holt","-35.22441","149.01188","4","0","0","0","0","0","0","4","3","0","1","0","4","1","0","3","0","4","0","3","1","0","0","4"
"Holte","55.81667","12.46667","1","0","0","0","0","0","0","1","0","0","0","0","0","1","0","0","0","1","1","0","0","0","0","1"
"Holyhead","53.30621","-4.63211","1","0","0","0","0","0","1","2","0","1","1","0","2","1","0","1","0","2","0","1","0","0","1","2"
"Holywell","53.27466","-3.22895","7","0","0","0","0","0","0","7","1","2","3","0","6","1","0","6","0","7","1","3","3","0","0","7"
"Holywell Green","53.67406","-1.86682","1","0","0","0","0","0","0","1","0","1","0","0","1","1","0","0","0","1","0","1","0","0","0","1"
"Homa Bay","-0.52731","34.45714","3","0","0","0","0","0","0","3","0","1","0","1","2","1","1","0","1","3","2","0","0","0","2","4"
"Homagama","6.844","80.0024","0","0","0","0","1","0","0","1","0","1","0","0","1","1","0","0","0","1","1","0","0","0","0","1"
"Homs","34.72682","36.72339","1","0","0","0","0","0","0","1","0","0","0","1","1","1","0","0","0","1","0","0","0","1","0","1"
"Hong Kong","22.27832","114.17469","15","1","0","0","0","0","0","16","3","2","9","0","14","6","3","7","0","16","1","0","14","1","0","16"
"Honiton","50.7996","-3.18899","5","0","0","0","1","0","0","6","1","1","4","0","6","3","1","2","0","6","1","2","3","0","0","6"
"Honolulu","21.30694","-157.85833","2","0","1","0","0","0","0","3","1","1","1","0","3","2","0","0","1","3","0","0","3","0","0","3"
"Hoo","51.4205","0.563","1","0","0","0","0","0","0","1","0","1","0","0","1","0","1","0","0","1","1","0","0","0","0","1"
"Hoogstede","52.58333","6.95","1","0","0","0","0","0","0","1","0","0","0","0","0","0","1","0","0","1","0","0","1","0","0","1"
"Hook","51.765","-4.93167","10","1","0","2","0","0","2","15","3","4","6","0","13","6","1","8","0","15","1","0","13","0","1","15"
"Hook","51.28425","-0.95967","10","1","0","2","0","0","2","15","3","4","6","0","13","6","1","8","0","15","1","0","13","0","1","15"
"Hook","53.72132","-0.84891","10","1","0","2","0","0","2","15","3","4","6","0","13","6","1","8","0","15","1","0","13","0","1","15"
"Hook","51.36803","-0.3065","10","1","0","2","0","0","2","15","3","4","6","0","13","6","1","8","0","15","1","0","13","0","1","15"
"Hope Valley","41.5076","-71.71618","1","0","0","0","0","0","1","2","1","0","1","0","2","0","0","2","0","2","0","1","1","0","0","2"
"Hope Valley","53.34819","-1.74485","1","0","0","0","0","0","1","2","1","0","1","0","2","0","0","2","0","2","0","1","1","0","0","2"
"Hope Valley","-34.83333","138.7","1","0","0","0","0","0","1","2","1","0","1","0","2","0","0","2","0","2","0","1","1","0","0","2"
"Hopewell","35.23479","-84.888","0","0","0","1","0","0","0","1","1","0","0","0","1","0","0","1","0","1","0","0","1","0","0","1"
"Hopewell","37.30432","-77.2872","0","0","0","1","0","0","0","1","1","0","0","0","1","0","0","1","0","1","0","0","1","0","0","1"
"Hopewell","40.38927","-74.76183","0","0","0","1","0","0","0","1","1","0","0","0","1","0","0","1","0","1","0","0","1","0","0","1"
"Hopkins","44.92496","-93.46273","1","0","0","0","0","0","0","1","1","0","0","0","1","1","0","0","0","1","0","0","1","0","0","1"
"Hopkins","42.62364","-85.7603","1","0","0","0","0","0","0","1","1","0","0","0","1","1","0","0","0","1","0","0","1","0","0","1"
"Hopkins","33.90432","-80.87703","1","0","0","0","0","0","0","1","1","0","0","0","1","1","0","0","0","1","0","0","1","0","0","1"
"Hopton","52.37293","0.92689","1","0","0","0","0","0","0","1","0","0","1","0","1","0","0","1","0","1","0","1","0","0","0","1"
"Horley","51.17423","-0.15919","10","0","0","0","2","0","1","13","1","3","6","0","10","5","1","7","0","13","2","3","8","0","0","13"
"Hornchurch","51.55685","0.21664","20","2","0","0","1","0","0","23","8","6","7","0","21","7","3","13","0","23","3","5","15","0","0","23"
"Hornsea","53.91041","-0.16806","1","0","0","0","0","0","0","1","0","0","1","0","1","0","0","1","0","1","0","0","1","0","0","1"
"Horsham","40.17844","-75.12851","17","1","0","0","2","0","2","22","3","4","10","1","18","8","2","12","0","22","0","11","11","0","0","22"
"Horsham","51.06314","-0.32757","17","1","0","0","2","0","2","22","3","4","10","1","18","8","2","12","0","22","0","11","11","0","0","22"
"Horsham","-36.71131","142.19981","17","1","0","0","2","0","2","22","3","4","10","1","18","8","2","12","0","22","0","11","11","0","0","22"
"Horwich","53.60126","-2.54975","2","0","0","0","0","0","0","2","0","1","0","0","1","0","1","1","0","2","0","0","2","0","0","2"
"Hosa’ina","7.54978","37.85374","1","0","0","0","0","0","0","1","0","1","0","0","1","1","0","0","0","1","0","0","0","0","1","1"
"Hoshangābād","22.74747","77.72736","1","0","0","0","0","0","0","1","1","0","0","0","1","0","1","0","0","1","0","0","1","0","0","1"
"Hot Springs","47.6091","-114.66874","0","0","0","0","1","0","0","1","0","0","0","0","0","1","0","0","0","1","0","0","1","0","0","1"
"Hot Springs","43.43165","-103.47436","0","0","0","0","1","0","0","1","0","0","0","0","0","1","0","0","0","1","0","0","1","0","0","1"
"Hot Springs","34.5037","-93.05518","0","0","0","0","1","0","0","1","0","0","0","0","0","1","0","0","0","1","0","0","1","0","0","1"
"Hot Springs","35.89263","-82.83112","0","0","0","0","1","0","0","1","0","0","0","0","0","1","0","0","0","1","0","0","1","0","0","1"
"Hot Springs","37.99957","-79.83172","0","0","0","0","1","0","0","1","0","0","0","0","0","1","0","0","0","1","0","0","1","0","0","1"
"Houghton","47.12187","-88.56901","1","0","0","0","0","0","0","1","0","1","0","0","1","0","0","1","0","1","0","1","0","0","0","1"
"Houghton","42.4234","-78.15723","1","0","0","0","0","0","0","1","0","1","0","0","1","0","0","1","0","1","0","1","0","0","0","1"
"Houghton","52.33282","-0.12068","1","0","0","0","0","0","0","1","0","1","0","0","1","0","0","1","0","1","0","1","0","0","0","1"
"Houghton-Le-Spring","54.84034","-1.46427","2","0","0","0","0","0","0","2","0","1","1","0","2","1","0","1","0","2","1","1","0","0","0","2"
"Houma","29.59577","-90.71953","1","0","0","0","0","0","0","1","0","0","0","1","1","1","0","0","0","1","1","0","0","0","0","1"
"Hounslow","51.46839","-0.36092","7","1","0","1","3","0","0","12","4","1","2","0","7","5","0","7","0","12","2","3","7","0","0","12"
"Houston","61.63028","-149.81806","15","0","0","1","1","0","0","17","6","2","3","0","11","2","5","10","0","17","1","3","12","0","1","17"
"Houston","54.39976","-126.67008","15","0","0","1","1","0","0","17","6","2","3","0","11","2","5","10","0","17","1","3","12","0","1","17"
"Houston","29.76328","-95.36327","15","0","0","1","1","0","0","17","6","2","3","0","11","2","5","10","0","17","1","3","12","0","1","17"
"Houston","37.32616","-91.95599","15","0","0","1","1","0","0","17","6","2","3","0","11","2","5","10","0","17","1","3","12","0","1","17"
"Houston","43.7633","-91.56848","15","0","0","1","1","0","0","17","6","2","3","0","11","2","5","10","0","17","1","3","12","0","1","17"
"Houston","33.89845","-88.99923","15","0","0","1","1","0","0","17","6","2","3","0","11","2","5","10","0","17","1","3","12","0","1","17"
"Houston","40.24646","-80.21145","15","0","0","1","1","0","0","17","6","2","3","0","11","2","5","10","0","17","1","3","12","0","1","17"
"Houston","55.86859","-4.55201","15","0","0","1","1","0","0","17","6","2","3","0","11","2","5","10","0","17","1","3","12","0","1","17"
"Houston Acres","38.21424","-85.61385","0","1","0","0","0","0","0","1","1","0","0","0","1","0","1","0","0","1","0","0","1","0","0","1"
"Hove","50.83088","-0.1672","24","0","0","2","0","0","4","30","2","6","15","1","24","11","2","17","0","30","3","9","17","0","1","30"
"Hove","51.15446","4.4707","24","0","0","2","0","0","4","30","2","6","15","1","24","11","2","17","0","30","3","9","17","0","1","30"
"Hove","-35.00814","138.5212","24","0","0","2","0","0","4","30","2","6","15","1","24","11","2","17","0","30","3","9","17","0","1","30"
"Howick","-29.47795","30.23057","1","0","0","0","0","0","0","1","1","0","0","0","1","0","0","1","0","1","1","0","0","0","0","1"
"Hrajel","34.01722","35.79244","5","0","0","0","0","0","0","5","5","0","0","0","5","0","0","5","0","5","0","0","5","0","0","5"
"Hrodna","53.6884","23.8258","1","0","0","0","0","0","0","1","0","0","0","1","1","1","0","0","0","1","1","0","0","0","0","1"
"Huangshi","31.00015","108.71859","1","0","0","0","0","0","0","1","1","0","0","0","1","0","0","1","0","1","0","0","1","0","0","1"
"Huangshi","29.18226","111.19515","1","0","0","0","0","0","0","1","1","0","0","0","1","0","0","1","0","1","0","0","1","0","0","1"
"Huangshi","23.20969","113.26328","1","0","0","0","0","0","0","1","1","0","0","0","1","0","0","1","0","1","0","0","1","0","0","1"
"Huangshi","30.24706","115.04814","1","0","0","0","0","0","0","1","1","0","0","0","1","0","0","1","0","1","0","0","1","0","0","1"
"Huangshi","24.34011","115.26246","1","0","0","0","0","0","0","1","1","0","0","0","1","0","0","1","0","1","0","0","1","0","0","1"
"Huangshi","26.24163","115.93431","1","0","0","0","0","0","0","1","1","0","0","0","1","0","0","1","0","1","0","0","1","0","0","1"
"Huangshi","25.37786","119.07242","1","0","0","0","0","0","0","1","1","0","0","0","1","0","0","1","0","1","0","0","1","0","0","1"
"Hubli","15.34776","75.13378","3","0","0","1","0","0","0","4","4","0","0","0","4","1","1","1","0","3","0","1","3","0","0","4"
"Hucknall","53.03333","-1.2","1","0","0","0","0","0","0","1","0","0","0","0","0","0","0","1","0","1","1","0","0","0","0","1"
"Huddersfield","53.64904","-1.78416","32","4","0","0","2","0","1","39","4","19","11","0","34","16","8","15","0","39","7","12","19","0","1","39"
"Huddinge","59.23705","17.98192","1","0","0","0","0","0","0","1","0","0","0","1","1","0","0","0","1","1","1","0","0","0","0","1"
"Hudiksvall","61.72744","17.10558","1","1","0","0","0","0","0","2","0","0","2","0","2","1","0","1","0","2","0","1","1","0","0","2"
"Hudson","40.07359","-104.64302","0","0","0","0","0","0","0","0","0","0","1","0","1","1","0","0","0","1","0","0","1","0","0","1"
"Hudson","29.90245","-95.50244","0","0","0","0","0","0","0","0","0","0","1","0","1","1","0","0","0","1","0","0","1","0","0","1"
"Hudson","31.32268","-94.77826","0","0","0","0","0","0","0","0","0","0","1","0","1","1","0","0","0","1","0","0","1","0","0","1"
"Hudson","44.97469","-92.75687","0","0","0","0","0","0","0","0","0","0","1","0","1","1","0","0","0","1","0","0","1","0","0","1"
"Hudson","42.40665","-92.45547","0","0","0","0","0","0","0","0","0","0","1","0","1","1","0","0","0","1","0","0","1","0","0","1"
"Hudson","40.60587","-88.9873","0","0","0","0","0","0","0","0","0","0","1","0","1","1","0","0","0","1","0","0","1","0","0","1"
"Hudson","41.53283","-85.08108","0","0","0","0","0","0","0","0","0","0","1","0","1","1","0","0","0","1","0","0","1","0","0","1"
"Hudson","41.85505","-84.35384","0","0","0","0","0","0","0","0","0","0","1","0","1","1","0","0","0","1","0","0","1","0","0","1"
"Hudson","28.36445","-82.69343","0","0","0","0","0","0","0","0","0","0","1","0","1","1","0","0","0","1","0","0","1","0","0","1"
"Hudson","35.84846","-81.49593","0","0","0","0","0","0","0","0","0","0","1","0","1","1","0","0","0","1","0","0","1","0","0","1"
"Hudson","41.24006","-81.44067","0","0","0","0","0","0","0","0","0","0","1","0","1","1","0","0","0","1","0","0","1","0","0","1"
"Hudson","41.2748","-75.83603","0","0","0","0","0","0","0","0","0","0","1","0","1","1","0","0","0","1","0","0","1","0","0","1"
"Hudson","45.45008","-74.14922","0","0","0","0","0","0","0","0","0","0","1","0","1","1","0","0","0","1","0","0","1","0","0","1"
"Hudson","42.25286","-73.79096","0","0","0","0","0","0","0","0","0","0","1","0","1","1","0","0","0","1","0","0","1","0","0","1"
"Hudson","42.39176","-71.56618","0","0","0","0","0","0","0","0","0","0","1","0","1","1","0","0","0","1","0","0","1","0","0","1"
"Hudson","42.76481","-71.43979","0","0","0","0","0","0","0","0","0","0","1","0","1","1","0","0","0","1","0","0","1","0","0","1"
"Hudson","45.00118","-68.88059","0","0","0","0","0","0","0","0","0","0","1","0","1","1","0","0","0","1","0","0","1","0","0","1"
"Huelva","37.26638","-6.94004","0","0","0","0","1","0","0","1","1","0","0","0","1","0","0","1","0","1","0","0","1","0","0","1"
"Huizhou","23.11147","114.41523","1","0","0","0","0","0","0","1","1","0","0","0","1","1","0","0","0","1","1","0","0","0","0","1"
"Hullavington","51.53778","-2.15163","2","0","0","1","0","0","0","3","0","2","1","0","3","0","2","1","0","3","1","1","1","0","0","3"
"Humber","52.2","-2.66667","4","0","0","0","1","0","0","5","0","4","1","0","5","2","1","2","0","5","2","3","0","0","0","5"
"Hundon","52.10988","0.53644","1","0","0","0","0","0","0","1","1","0","0","0","1","0","0","1","0","1","0","1","0","0","0","1"
"Hungerford","51.41513","-1.51556","2","0","0","0","0","0","0","2","0","0","1","0","1","0","0","2","0","2","0","0","2","0","0","2"
"Huntingdon","36.00062","-88.42811","6","0","0","1","0","0","0","7","1","2","3","0","6","3","0","4","0","7","2","1","4","0","0","7"
"Huntingdon","40.4848","-78.01028","6","0","0","1","0","0","0","7","1","2","3","0","6","3","0","4","0","7","2","1","4","0","0","7"
"Huntingdon","45.08339","-74.16593","6","0","0","1","0","0","0","7","1","2","3","0","6","3","0","4","0","7","2","1","4","0","0","7"
"Huntingdon","52.33049","-0.18651","6","0","0","1","0","0","0","7","1","2","3","0","6","3","0","4","0","7","2","1","4","0","0","7"
"Huntly","57.44741","-2.78608","1","0","0","0","0","0","0","1","0","0","1","0","1","0","0","1","0","1","0","0","1","0","0","1"
"Huntly","-36.66451","144.33382","1","0","0","0","0","0","0","1","0","0","1","0","1","0","0","1","0","1","0","0","1","0","0","1"
"Hurst","32.82346","-97.17057","1","0","0","0","0","0","0","1","0","0","1","0","1","0","0","1","0","1","0","1","0","0","0","1"
"Hurst","37.83311","-89.14286","1","0","0","0","0","0","0","1","0","0","1","0","1","0","0","1","0","1","0","1","0","0","0","1"
"Hurst","51.45791","-0.85196","1","0","0","0","0","0","0","1","0","0","1","0","1","0","0","1","0","1","0","1","0","0","0","1"
"Husbands Bosworth","52.45232","-1.05557","1","0","0","0","0","0","0","1","0","1","0","0","1","0","0","1","0","1","0","0","1","0","0","1"
"Husum","54.4858","9.05239","1","0","0","0","0","0","0","1","0","1","0","0","1","0","1","0","0","1","0","0","1","0","0","1"
"Husum","52.56667","9.25","1","0","0","0","0","0","0","1","0","1","0","0","1","0","1","0","0","1","0","0","1","0","0","1"
"Husum","63.33333","19.16667","1","0","0","0","0","0","0","1","0","1","0","0","1","0","1","0","0","1","0","0","1","0","0","1"
"Hutton","51.32417","-2.93028","1","0","0","0","0","0","0","1","0","0","0","0","0","0","0","1","0","1","1","0","0","0","0","1"
"Hutton","53.96667","-0.43333","1","0","0","0","0","0","0","1","0","0","0","0","0","0","0","1","0","1","1","0","0","0","0","1"
"Hvar","43.1725","16.44278","1","0","0","0","0","0","0","1","0","0","1","0","1","1","0","0","0","1","0","1","0","0","0","1"
"Hyde","41.00256","-78.46252","7","0","0","0","1","0","1","9","5","1","3","0","9","1","0","8","0","9","0","5","4","0","0","9"
"Hyde","53.45131","-2.07943","7","0","0","0","1","0","1","9","5","1","3","0","9","1","0","8","0","9","0","5","4","0","0","9"
"Hyderabad","25.39242","68.37366","52","3","0","0","1","0","1","57","34","5","5","2","46","23","13","22","0","58","6","4","36","2","10","58"
"Hyderabad","17.38405","78.45636","52","3","0","0","1","0","1","57","34","5","5","2","46","23","13","22","0","58","6","4","36","2","10","58"
"Hythe","50.86004","-1.40162","2","0","0","0","0","0","0","2","0","1","1","0","2","1","0","1","0","2","0","1","1","0","0","2"
"Hythe","51.0715","1.08421","2","0","0","0","0","0","0","2","0","1","1","0","2","1","0","1","0","2","0","1","1","0","0","2"
"Iaşi","47.16667","27.6","4","0","0","0","0","0","0","4","1","2","1","0","4","0","0","4","0","4","1","0","3","0","0","4"
"Iași-Gorj","44.99334","23.24821","2","0","0","0","0","0","0","2","0","1","0","0","1","0","1","1","0","2","0","0","2","0","0","2"
"Ibadan","7.37756","3.90591","14","1","0","0","1","0","0","16","6","4","3","0","13","11","2","2","0","15","4","2","9","0","1","16"
"Ibagué","4.43889","-75.23222","2","0","0","0","0","0","0","2","0","0","1","0","1","1","0","0","0","1","0","0","2","0","0","2"
"Ibb","13.96667","44.18333","4","0","0","0","0","0","0","4","0","2","1","2","5","1","1","1","0","3","1","0","1","2","0","4"
"Ibiza","38.90883","1.43296","1","0","0","0","0","0","0","1","0","0","0","0","0","0","0","1","0","1","1","0","0","0","0","1"
"Ibshawāy","29.35896","30.68061","1","0","0","0","0","0","0","1","0","1","0","0","1","1","0","0","0","1","0","0","0","0","1","1"
"Iganga","0.60917","33.46861","2","0","0","0","0","0","0","2","0","1","0","0","1","2","0","0","0","2","0","0","0","0","2","2"
"Igunga","-4.28333","33.88333","1","0","0","0","0","0","0","1","0","0","0","1","1","1","0","0","0","1","1","0","0","0","0","1"
"Ikare","7.52591","5.75342","1","0","0","0","0","0","0","1","0","0","0","0","0","1","0","0","0","1","0","0","0","0","1","1"
"Ikeja","6.59651","3.34205","0","0","0","0","0","0","0","0","0","0","0","0","0","0","0","0","0","0","0","0","0","0","0","0"
"Ilaro","6.88901","3.01416","1","0","0","0","0","0","0","1","0","1","0","0","1","0","1","0","0","1","0","0","0","1","0","1"
"Ile-Ife","7.4824","4.56032","4","0","0","0","0","0","0","4","0","3","0","1","4","1","2","0","0","3","1","0","2","0","0","3"
"Ilford","51.55765","0.07278","5","0","0","1","0","0","0","6","2","1","1","0","4","4","0","2","0","6","1","0","5","0","0","6"
"Ilfracombe","51.2093","-4.11344","2","0","0","0","0","0","0","2","0","2","0","0","2","0","1","1","0","2","2","0","0","0","0","2"
"Ilidža","43.82939","18.30003","1","0","0","0","0","0","0","1","0","1","0","0","1","0","0","1","0","1","1","0","0","0","0","1"
"Iligan City","8.25","124.4","1","0","0","0","0","0","0","1","1","0","0","0","1","0","1","0","0","1","0","1","0","0","0","1"
"Ilijaš","43.95128","18.27128","1","0","0","0","0","0","0","1","0","0","1","0","1","0","0","1","0","1","0","0","1","0","0","1"
"Ilirska Bistrica","45.56757","14.24571","1","0","0","0","0","0","0","1","0","1","0","0","1","1","0","0","0","1","1","0","0","0","0","1"
"Ilkeston","52.97055","-1.30951","4","0","0","0","0","0","1","5","0","2","3","0","5","0","2","3","0","5","1","2","2","0","0","5"
"Ilkley","53.92449","-1.82326","9","0","0","0","1","0","0","10","2","0","3","0","5","5","1","4","0","10","2","3","5","0","0","10"
"Ilkley","-26.73101","152.99766","9","0","0","0","1","0","0","10","2","0","3","0","5","5","1","4","0","10","2","3","5","0","0","10"
"Ilminster","50.92684","-2.91009","6","0","0","0","0","0","0","6","1","0","3","0","4","4","0","2","0","6","0","5","1","0","0","6"
"Iloilo","10.69694","122.56444","3","0","0","0","0","0","0","3","0","2","1","0","3","2","1","0","0","3","2","1","0","0","0","3"
"Ilorin","8.49664","4.54214","4","0","0","0","0","0","0","4","2","2","0","0","4","4","1","0","0","5","1","0","4","0","0","5"
"Immingham","53.6142","-0.21579","0","0","0","0","0","0","1","1","0","0","0","1","1","1","0","0","0","1","0","0","0","1","0","1"
"Imola","44.35916","11.7132","0","1","0","0","0","0","0","1","1","0","0","0","1","0","0","1","0","1","1","0","0","0","0","1"
"Imperia","43.88917","8.03933","0","0","0","1","0","0","0","1","1","0","0","0","1","0","0","1","0","1","0","1","0","0","0","1"
"Imphal","24.80805","93.9442","7","0","0","0","0","0","0","7","3","0","0","1","4","2","1","4","0","7","1","1","4","0","1","7"
"Imsida","35.8925","14.48278","1","0","0","0","0","0","0","1","0","1","0","0","1","1","0","0","0","1","0","0","0","0","1","1"
"Inaruwa","26.60675","87.1478","2","0","0","0","0","0","0","2","0","0","1","0","1","1","0","1","0","2","0","1","1","0","0","2"
"Inchture","56.44551","-3.16956","0","0","0","0","1","0","0","1","0","1","0","0","1","0","1","0","0","1","1","0","0","0","0","1"
"Indianapolis","39.76838","-86.15804","2","0","0","0","0","0","1","3","0","1","0","0","1","2","0","1","0","3","1","1","1","0","0","3"
"Indian Harbour Beach","28.1489","-80.58839","1","0","0","0","0","0","0","1","0","0","0","0","0","0","0","1","0","1","1","0","0","0","0","1"
"Indore","22.71792","75.8333","2","0","0","0","0","0","0","2","2","0","0","0","2","0","0","2","0","2","0","0","1","0","1","2"
"Ineu","46.43372","21.84048","1","0","0","0","0","0","0","1","0","1","0","0","1","1","0","0","0","1","0","1","0","0","0","1"
"Ineu","47.08333","22.11667","1","0","0","0","0","0","0","1","0","1","0","0","1","1","0","0","0","1","0","1","0","0","0","1"
"Ineu","46.5453","25.76357","1","0","0","0","0","0","0","1","0","1","0","0","1","1","0","0","0","1","0","1","0","0","0","1"
"Inglewood","33.96168","-118.35313","0","0","0","0","0","0","1","1","0","0","1","0","1","0","0","1","0","1","0","1","0","0","0","1"
"Inglewood","-31.91663","115.8798","0","0","0","0","0","0","1","1","0","0","1","0","1","0","0","1","0","1","0","1","0","0","0","1"
"Inglewood","-36.57504","143.8683","0","0","0","0","0","0","1","1","0","0","1","0","1","0","0","1","0","1","0","1","0","0","0","1"
"Inglewood","-28.41592","151.08066","0","0","0","0","0","0","1","1","0","0","1","0","1","0","0","1","0","1","0","1","0","0","0","1"
"Ingolstadt","48.76508","11.42372","1","0","0","0","0","0","0","1","0","0","0","0","0","0","1","0","0","1","0","0","0","0","1","1"
"Ingrandes","47.405","-0.92336","1","0","0","0","0","0","0","1","1","0","0","0","1","0","0","1","0","1","0","0","1","0","0","1"
"Innsbruck","47.26266","11.39454","1","0","0","0","0","0","0","1","0","1","0","0","1","0","1","0","0","1","1","0","0","0","0","1"
"Invergordon","57.6886","-4.16745","0","0","0","1","0","0","0","1","1","0","0","0","1","0","0","1","0","1","0","1","0","0","0","1"
"Invergordon","-36.16667","145.58333","0","0","0","1","0","0","0","1","1","0","0","0","1","0","0","1","0","1","0","1","0","0","0","1"
"Inverness","38.10103","-122.85694","6","0","0","1","2","0","1","10","2","4","3","0","9","4","0","6","0","10","2","3","4","0","1","10"
"Inverness","39.57738","-104.86135","6","0","0","1","2","0","1","10","2","4","3","0","9","4","0","6","0","10","2","3","4","0","1","10"
"Inverness","33.35373","-90.59259","6","0","0","1","2","0","1","10","2","4","3","0","9","4","0","6","0","10","2","3","4","0","1","10"
"Inverness","42.11808","-88.09619","6","0","0","1","2","0","1","10","2","4","3","0","9","4","0","6","0","10","2","3","4","0","1","10"
"Inverness","32.01488","-85.74606","6","0","0","1","2","0","1","10","2","4","3","0","9","4","0","6","0","10","2","3","4","0","1","10"
"Inverness","28.83582","-82.33037","6","0","0","1","2","0","1","10","2","4","3","0","9","4","0","6","0","10","2","3","4","0","1","10"
"Inverness","57.47908","-4.22398","6","0","0","1","2","0","1","10","2","4","3","0","9","4","0","6","0","10","2","3","4","0","1","10"
"Inverness","-23.11582","150.72306","6","0","0","1","2","0","1","10","2","4","3","0","9","4","0","6","0","10","2","3","4","0","1","10"
"Inverurie","57.28446","-2.37736","1","0","0","0","0","0","0","1","0","0","0","0","0","1","0","0","0","1","1","0","0","0","0","1"
"Ioánnina","39.66486","20.85189","3","0","0","0","0","0","0","3","0","3","0","0","3","0","1","2","0","3","3","0","0","0","0","3"
"Iowa City","41.66113","-91.53017","1","0","0","0","0","0","0","1","0","0","0","0","0","0","1","0","0","1","1","0","0","0","0","1"
"Ipoh","4.5841","101.0829","3","0","0","0","0","0","0","3","0","2","0","0","2","2","1","0","0","3","2","0","1","0","0","3"
"Ipoteşti","47.61667","26.28333","0","1","0","0","0","0","0","1","0","1","0","0","1","1","0","0","0","1","1","0","0","0","0","1"
"Ipswich","45.44442","-99.02928","43","1","0","1","5","0","4","54","10","14","23","1","48","17","7","30","0","54","7","19","23","2","3","54"
"Ipswich","42.67926","-70.84116","43","1","0","1","5","0","4","54","10","14","23","1","48","17","7","30","0","54","7","19","23","2","3","54"
"Ipswich","52.05917","1.15545","43","1","0","1","5","0","4","54","10","14","23","1","48","17","7","30","0","54","7","19","23","2","3","54"
"Ipswich","-27.62343","152.76067","43","1","0","1","5","0","4","54","10","14","23","1","48","17","7","30","0","54","7","19","23","2","3","54"
"Irákleion","35.32787","25.14341","2","0","0","0","0","0","0","2","0","1","0","0","1","0","2","0","0","2","0","0","1","0","1","2"
"Irbid","32.55556","35.85","13","0","0","0","0","0","0","13","8","2","1","0","11","2","4","6","0","12","1","3","8","1","0","13"
"Iringa","-7.76667","35.7","1","0","0","0","0","0","0","1","0","1","0","0","1","1","0","0","0","1","0","0","0","0","1","1"
"Irkutsk","52.29778","104.29639","1","0","0","0","0","0","0","1","1","0","0","0","1","0","0","0","1","1","0","0","1","0","0","1"
"Irpin","50.52175","30.25055","1","0","0","0","0","0","0","1","1","0","0","0","1","0","0","1","0","1","0","0","1","0","0","1"
"Irvine","33.66946","-117.82311","13","0","0","1","0","0","1","15","5","6","7","0","18","7","0","13","0","20","5","5","10","0","0","20"
"Irvine","37.70064","-83.97381","13","0","0","1","0","0","1","15","5","6","7","0","18","7","0","13","0","20","5","5","10","0","0","20"
"Irvine","55.6194","-4.65508","13","0","0","1","0","0","1","15","5","6","7","0","18","7","0","13","0","20","5","5","10","0","0","20"
"Isabela","18.50078","-67.02435","1","1","0","0","0","0","0","2","1","0","0","0","1","1","1","0","0","2","1","0","1","0","0","2"
"Isabela","10.2048","122.9888","1","1","0","0","0","0","0","2","1","0","0","0","1","1","1","0","0","2","1","0","1","0","0","2"
"Isfahan","32.65246","51.67462","1","0","0","0","0","0","0","1","1","0","0","0","1","0","0","1","0","1","0","0","1","0","0","1"
"Isiolo","0.35462","37.58218","3","0","0","0","0","0","0","3","0","2","1","0","3","2","1","0","0","3","1","0","2","0","0","3"
"İskenderun","36.58718","36.17347","2","0","0","0","0","0","0","2","0","2","0","0","2","2","0","0","0","2","2","0","0","0","0","2"
"Islamabad","33.72148","73.04329","60","6","0","1","1","0","0","68","22","14","12","7","55","26","18","20","2","66","27","4","32","0","5","68"
"Islāmpur","25.14075","85.20587","1","0","0","0","0","0","0","1","1","0","0","0","1","0","0","1","0","1","0","0","1","0","0","1"
"Islāmpur","26.26541","88.18982","1","0","0","0","0","0","0","1","1","0","0","0","1","0","0","1","0","1","0","0","1","0","0","1"
"Isle of Islay","55.78526","-6.23886","1","0","0","0","0","0","0","1","0","1","0","0","1","0","1","0","0","1","1","0","0","0","0","1"
"Isle Of Mull","56.44703","-5.77404","1","0","0","0","0","0","0","1","0","0","1","0","1","1","0","0","0","1","0","0","1","0","0","1"
"Isles of Scilly","49.92515","-6.29894","1","0","0","0","0","0","0","1","0","1","0","0","1","0","0","1","0","1","1","0","0","0","0","1"
"Isleworth","51.47518","-0.34246","13","1","0","1","0","0","0","15","4","1","9","0","14","2","2","10","1","15","1","4","10","0","0","15"
"Islington","18.30922","-76.85482","1","0","0","0","0","0","0","1","0","0","0","0","0","0","0","1","0","1","0","0","1","0","0","1"
"Islington","51.53622","-0.10304","1","0","0","0","0","0","0","1","0","0","0","0","0","0","0","1","0","1","0","0","1","0","0","1"
"Islington","-32.91388","151.74739","1","0","0","0","0","0","0","1","0","0","0","0","0","0","0","1","0","1","0","0","1","0","0","1"
"Ismailia","30.60427","32.27225","4","0","0","0","0","0","1","5","1","0","0","0","1","0","4","1","0","5","4","0","1","0","0","5"
"Isoka","-10.16062","32.63353","1","0","0","0","0","0","0","1","0","1","0","0","1","1","0","0","0","1","0","0","0","0","1","1"
"Isparta","37.76444","30.55222","1","0","0","0","0","0","0","1","0","0","0","0","0","1","0","0","0","1","1","0","0","0","0","1"
"Istanbul","41.01384","28.94966","55","3","0","1","4","0","2","65","18","11","9","3","41","22","10","30","2","64","21","11","26","2","5","65"
"Istok","42.78083","20.4875","1","0","0","0","0","0","0","1","0","1","0","0","1","1","0","0","0","1","1","0","0","0","0","1"
"Istok","56.79086","60.77889","1","0","0","0","0","0","0","1","0","1","0","0","1","1","0","0","0","1","1","0","0","0","0","1"
"Istok","52.09528","106.2475","1","0","0","0","0","0","0","1","0","1","0","0","1","1","0","0","0","1","1","0","0","0","0","1"
"Itasca","32.15959","-97.15001","1","0","0","0","0","0","0","1","0","0","1","0","1","0","0","1","0","1","0","0","1","0","0","1"
"Itasca","41.97503","-88.00729","1","0","0","0","0","0","0","1","0","0","1","0","1","0","0","1","0","1","0","0","1","0","0","1"
"Iten","0.67028","35.50806","1","0","0","0","0","0","0","1","0","0","1","0","1","1","0","0","0","1","0","0","1","0","0","1"
"Itu","-23.26417","-47.29917","1","0","0","0","0","0","0","1","1","0","0","0","1","0","1","0","0","1","0","0","1","0","0","1"
"Itu","5.46395","7.33078","1","0","0","0","0","0","0","1","1","0","0","0","1","0","1","0","0","1","0","0","1","0","0","1"
"Itu","5.20131","7.98373","1","0","0","0","0","0","0","1","1","0","0","0","1","0","1","0","0","1","0","0","1","0","0","1"
"Ivano-Frankivsk","48.9215","24.70972","5","0","0","0","0","0","0","5","2","1","2","0","5","4","1","0","0","5","0","3","2","0","0","5"
"Iver Heath","51.53642","-0.5179","0","0","0","0","0","0","1","1","0","1","0","0","1","0","0","1","0","1","0","0","1","0","0","1"
"Ivrea","45.46723","7.87617","1","0","0","0","0","0","0","1","0","1","0","0","1","0","0","1","0","1","0","1","0","0","0","1"
"Ivybridge","50.39039","-3.91914","2","0","0","0","0","0","0","2","0","0","2","0","2","0","1","1","0","2","0","0","2","0","0","2"
"İzmir","38.41273","27.13838","8","0","0","0","0","0","0","8","1","6","0","0","7","0","2","6","0","8","0","1","1","0","6","8"
"Jabalpur","23.16697","79.95006","4","0","0","0","0","0","0","4","0","2","0","2","4","1","0","1","3","5","0","0","2","0","2","4"
"Jabālyā","31.5272","34.48347","1","0","0","0","0","0","0","1","0","0","0","1","1","0","0","0","1","1","0","0","0","0","1","1"
"Jablanica","43.66028","17.76167","1","0","0","0","0","0","0","1","1","0","0","0","1","0","1","0","0","1","0","1","0","0","0","1"
"Jacobabad","28.28187","68.43761","3","0","0","0","0","0","0","3","0","1","1","0","2","2","0","1","0","3","2","0","1","0","0","3"
"Ja Ela","7.0744","79.8919","1","0","0","0","0","0","0","1","1","0","0","0","1","0","0","1","0","1","0","0","1","0","0","1"
"Jaffna","9.66845","80.00742","3","1","0","0","0","0","0","4","3","0","1","0","4","0","1","3","0","4","0","0","4","0","0","4"
"Jagatsinghapur","20.2557","86.17112","0","0","0","0","0","0","0","0","1","0","0","0","1","0","0","0","0","0","0","0","1","0","0","1"
"Jagdalpur","19.08136","82.02131","1","0","0","1","0","0","0","2","2","0","0","0","2","1","0","1","0","2","0","0","2","0","0","2"
"Jagodina","43.97713","21.26121","3","0","0","0","0","0","0","3","0","2","1","0","3","0","2","1","0","3","1","0","2","0","0","3"
"Jagtiāl","18.79473","78.91661","5","0","0","0","0","0","0","5","5","0","0","0","5","0","0","5","0","5","0","0","5","0","0","5"
"Jaipur","26.91962","75.78781","11","2","0","0","0","0","0","13","9","1","1","0","11","6","1","6","0","13","1","0","12","0","0","13"
"Jaisalmer","26.91763","70.90387","2","0","0","0","0","0","0","2","0","1","0","1","2","1","1","0","0","2","0","0","1","0","1","2"
"Jakarta","-6.21462","106.84513","13","3","0","0","0","0","0","16","6","3","1","0","10","7","4","5","0","16","4","2","8","1","1","16"
"Jalal-Abad","40.93333","73","3","0","0","0","0","0","0","3","1","2","0","0","3","3","0","0","0","3","0","0","3","0","0","3"
"Jalālābād","34.42647","70.45153","5","1","0","0","1","0","0","7","0","5","0","2","7","3","1","2","1","7","1","0","2","2","2","7"
"Jalālābād","30.60622","74.25727","5","1","0","0","1","0","0","7","0","5","0","2","7","3","1","2","1","7","1","0","2","2","2","7"
"Jalālābād","27.72625","79.65523","5","1","0","0","1","0","0","7","0","5","0","2","7","3","1","2","1","7","1","0","2","2","2","7"
"Jalandhar","31.32556","75.57917","3","0","0","0","0","0","0","3","3","0","0","0","3","0","0","3","0","3","0","0","3","0","0","3"
"Jaleshwar","26.64921","85.80017","1","0","0","0","0","0","0","1","0","1","0","0","1","0","0","1","0","1","0","0","1","0","0","1"
"Jaleshwar","21.80176","87.2225","1","0","0","0","0","0","0","1","0","1","0","0","1","0","0","1","0","1","0","0","1","0","0","1"
"Jalgaon","17.74026","73.19087","2","0","0","0","0","0","0","2","1","0","1","0","2","0","0","2","0","2","0","0","1","0","1","2"
"Jalgaon","21.00292","75.56602","2","0","0","0","0","0","0","2","1","0","1","0","2","0","0","2","0","2","0","0","1","0","1","2"
"Jalingo","8.89367","11.3596","2","0","0","0","0","0","0","2","1","0","0","0","1","1","1","0","0","2","0","1","0","0","1","2"
"Jalisco","25.21578","-103.4413","1","0","0","0","0","0","0","1","0","1","0","0","1","0","1","0","0","1","0","0","1","0","0","1"
"Jalisco","16.43033","-91.97499","1","0","0","0","0","0","0","1","0","1","0","0","1","0","1","0","0","1","0","0","1","0","0","1"
"Jamālpur","25.31258","86.48888","0","0","0","0","2","0","0","2","2","0","0","0","2","0","2","0","0","2","0","0","0","0","2","2"
"Jamālpur","24.91965","89.94812","0","0","0","0","2","0","0","2","2","0","0","0","2","0","2","0","0","2","0","0","0","0","2","2"
"Jameston","51.65642","-4.81304","3","0","0","0","0","0","0","3","3","0","0","0","3","1","0","2","0","3","0","2","1","0","0","3"
"Jammu","32.73569","74.86911","6","0","0","0","0","0","0","6","6","0","0","0","6","2","2","2","1","7","1","0","5","0","1","7"
"Jamnagar","22.47292","70.06673","1","0","0","0","0","0","0","1","1","0","0","0","1","0","0","1","0","1","0","0","1","0","0","1"
"Jampur","29.64235","70.59518","1","0","0","0","0","0","0","1","0","0","0","0","0","1","0","0","0","1","0","0","1","0","0","1"
"Jamshedpur","22.80278","86.18545","2","0","0","0","0","0","0","2","2","0","0","0","2","1","0","1","0","2","0","0","2","0","0","2"
"Jamshoro","25.43608","68.28017","3","0","0","0","0","0","0","3","1","0","1","0","2","1","1","2","0","4","0","2","1","0","0","3"
"Janakpur","26.72882","85.92628","12","0","0","0","0","0","0","12","6","3","0","1","10","4","5","3","0","12","1","1","7","0","3","12"
"Janīn","32.45943","35.30086","2","0","0","0","0","0","0","2","2","0","0","0","2","0","0","1","0","1","0","0","2","0","0","2"
"Janūb as Surrah","29.26917","47.97806","1","0","0","0","0","0","0","1","0","1","0","0","1","0","1","0","0","1","1","0","0","0","0","1"
"Jaranwala","31.3332","73.41868","2","0","0","0","0","0","0","2","0","2","0","0","2","0","2","0","0","2","0","0","0","0","2","2"
"Jarash","32.28082","35.89929","1","0","0","0","0","0","0","1","0","1","0","0","1","0","1","0","0","1","1","0","0","0","0","1"
"Jarrow","54.98036","-1.48423","3","0","0","0","0","0","0","3","1","0","1","0","2","3","0","0","0","3","0","0","3","0","0","3"
"Jatoi Shimali","29.51827","70.84474","1","0","0","0","0","0","0","1","0","0","0","0","0","0","0","0","1","1","0","0","1","0","0","1"
"Jauharabad","32.29016","72.28182","1","0","0","0","0","0","0","1","0","0","0","0","0","0","1","0","0","1","1","0","0","0","0","1"
"Jaunpur","25.75356","82.68689","1","0","0","0","0","0","0","1","1","0","0","0","1","1","0","0","0","1","0","0","1","0","0","1"
"Jawhar","2.78087","45.50048","1","0","0","0","0","0","0","1","1","0","0","0","1","0","1","0","0","1","0","0","1","0","0","1"
"Jbaïl","34.12111","35.64806","3","0","0","0","0","0","0","3","3","0","0","0","3","0","1","2","0","3","0","0","3","0","0","3"
"Jdaidet el Matn","33.89056","35.56639","5","0","0","0","0","0","0","5","0","1","3","0","4","1","3","1","0","5","3","0","2","0","0","5"
"Jeddah","21.49012","39.18624","29","1","0","1","2","0","1","34","5","10","7","7","29","11","9","9","5","34","19","4","4","1","6","34"
"Jefferson","44.71957","-123.01037","1","0","0","0","0","0","0","1","1","0","0","0","1","0","0","1","0","1","0","0","1","0","0","1"
"Jefferson","42.6025","-96.5592","1","0","0","0","0","0","0","1","1","0","0","0","1","0","0","1","0","1","0","0","1","0","0","1"
"Jefferson","42.01526","-94.37747","1","0","0","0","0","0","0","1","1","0","0","0","1","0","0","1","0","1","0","0","1","0","0","1"
"Jefferson","32.75736","-94.34519","1","0","0","0","0","0","0","1","1","0","0","0","1","0","0","1","0","1","0","0","1","0","0","1"
"Jefferson","29.96604","-90.15313","1","0","0","0","0","0","0","1","1","0","0","0","1","0","0","1","0","1","0","0","1","0","0","1"
"Jefferson","43.00556","-88.80733","1","0","0","0","0","0","0","1","1","0","0","0","1","0","0","1","0","1","0","0","1","0","0","1"
"Jefferson","34.11705","-83.57239","1","0","0","0","0","0","0","1","1","0","0","0","1","0","0","1","0","1","0","0","1","0","0","1"
"Jefferson","33.4493","-83.31155","1","0","0","0","0","0","0","1","1","0","0","0","1","0","0","1","0","1","0","0","1","0","0","1"
"Jefferson","38.37537","-81.78041","1","0","0","0","0","0","0","1","1","0","0","0","1","0","0","1","0","1","0","0","1","0","0","1"
"Jefferson","36.4204","-81.47344","1","0","0","0","0","0","0","1","1","0","0","0","1","0","0","1","0","1","0","0","1","0","0","1"
"Jefferson","41.73867","-80.76981","1","0","0","0","0","0","0","1","1","0","0","0","1","0","0","1","0","1","0","0","1","0","0","1"
"Jefferson","34.65015","-80.38896","1","0","0","0","0","0","0","1","1","0","0","0","1","0","0","1","0","1","0","0","1","0","0","1"
"Jefferson","39.36205","-77.53165","1","0","0","0","0","0","0","1","1","0","0","0","1","0","0","1","0","1","0","0","1","0","0","1"
"Jefferson","39.81732","-76.84164","1","0","0","0","0","0","0","1","1","0","0","0","1","0","0","1","0","1","0","0","1","0","0","1"
"Jefferson","44.41895","-71.47453","1","0","0","0","0","0","0","1","1","0","0","0","1","0","0","1","0","1","0","0","1","0","0","1"
"Jefferson","44.20674","-69.45254","1","0","0","0","0","0","0","1","1","0","0","0","1","0","0","1","0","1","0","0","1","0","0","1"
"Jelah","44.654","17.95897","1","0","0","0","0","0","0","1","0","1","0","0","1","1","0","0","0","1","1","0","0","0","0","1"
"Jember","-8.17211","113.69953","1","0","0","0","0","0","0","1","0","0","0","0","0","1","0","0","0","1","0","0","0","0","1","1"
"Jersey City","40.72816","-74.07764","1","0","0","1","0","0","0","2","1","1","0","0","2","0","1","1","0","2","0","0","2","0","0","2"
"Jerusalem","31.76904","35.21633","7","0","0","1","0","0","0","8","1","3","0","1","5","2","4","2","0","8","5","0","2","1","0","8"
"Jesenice","50.09703","13.46948","1","0","0","0","0","0","0","1","0","0","0","0","0","1","0","0","0","1","0","0","1","0","0","1"
"Jesenice","46.43056","14.06694","1","0","0","0","0","0","0","1","0","0","0","0","0","1","0","0","0","1","0","0","1","0","0","1"
"Jesenice","49.60774","14.47813","1","0","0","0","0","0","0","1","0","0","0","0","0","1","0","0","0","1","0","0","1","0","0","1"
"Jesenice","49.96814","14.5135","1","0","0","0","0","0","0","1","0","0","0","0","0","1","0","0","0","1","0","0","1","0","0","1"
"Jesenice","44.23","15.5775","1","0","0","0","0","0","0","1","0","0","0","0","0","1","0","0","0","1","0","0","1","0","0","1"
"Jesenice","43.46158","16.60197","1","0","0","0","0","0","0","1","0","0","0","0","0","1","0","0","0","1","0","0","1","0","0","1"
"Jesi","43.52142","13.24368","1","0","0","0","0","0","0","1","1","0","0","0","1","0","1","0","0","1","0","0","1","0","0","1"
"Jessore","23.16971","89.21371","8","0","0","0","0","0","0","8","3","2","2","0","7","3","1","4","0","8","0","0","7","0","1","8"
"Jezzîne","33.54167","35.58444","2","0","0","0","0","0","0","2","2","0","0","0","2","1","0","1","0","2","0","0","2","0","0","2"
"Jhang Sadr","31.26981","72.31687","2","0","0","0","0","0","0","2","0","0","2","1","3","3","0","0","0","3","0","0","3","0","0","3"
"Jhelum","32.93448","73.73102","6","0","0","0","0","0","0","6","5","0","0","0","5","2","1","4","0","7","1","0","5","0","0","6"
"Jhingergācha","23.11134","89.09061","1","0","0","0","0","0","0","1","0","0","0","0","0","0","0","1","0","1","1","0","0","0","0","1"
"Jhunjhunūn","28.12559","75.39797","1","0","0","0","0","0","0","1","1","0","0","0","1","0","0","1","0","1","0","0","1","0","0","1"
"Jiangxi","33.99934","105.19994","1","0","0","0","0","0","0","1","0","0","0","1","1","1","0","0","0","1","0","0","1","0","0","1"
"Jidd Ḩafş","26.21861","50.54778","3","0","0","0","0","0","0","3","1","1","0","0","2","1","1","0","1","3","2","0","1","0","0","3"
"Jijiga","9.35","42.8","1","0","0","0","0","0","0","1","0","1","0","0","1","1","0","0","0","1","0","0","1","0","0","1"
"Jimeta","9.27949","12.45819","1","0","0","0","0","0","0","1","0","1","0","0","1","1","0","0","0","1","0","0","0","0","1","1"
"Jimma","7.67344","36.83441","1","0","0","0","0","0","0","1","0","0","0","1","1","1","0","0","0","1","0","0","1","0","0","1"
"Jinan","30.44738","112.20031","1","0","0","0","0","0","0","1","0","1","0","0","1","1","0","0","0","1","0","0","1","0","0","1"
"Jinan","36.66833","116.99722","1","0","0","0","0","0","0","1","0","1","0","0","1","1","0","0","0","1","0","0","1","0","0","1"
"Jindalee","-31.64938","115.69496","0","2","0","0","0","0","0","2","2","0","0","0","2","1","0","1","0","2","0","0","2","0","0","2"
"Jindalee","-27.53446","152.93843","0","2","0","0","0","0","0","2","2","0","0","0","2","1","0","1","0","2","0","0","2","0","0","2"
"Jindřichův Hradec","49.14404","15.00301","2","0","0","0","0","0","0","2","0","0","0","0","0","0","2","0","0","2","0","0","1","0","1","2"
"Jinja","0.43902","33.20317","1","0","0","0","0","0","0","1","0","1","0","0","1","1","0","0","0","1","0","0","0","0","1","1"
"Jizan","16.88917","42.55111","5","1","0","0","0","0","0","6","2","2","1","1","6","2","1","3","0","6","2","1","2","0","1","6"
"Jodhpur","21.90174","70.0327","3","0","0","0","0","0","0","3","0","1","0","0","1","0","1","2","0","3","0","0","2","0","1","3"
"Jodhpur","26.26841","73.00594","3","0","0","0","0","0","0","3","0","1","0","0","1","0","1","2","0","3","0","0","2","0","1","3"
"Johannesburg","-26.20227","28.04363","19","2","0","1","1","0","0","23","9","2","5","7","23","5","2","11","5","23","4","2","17","0","0","23"
"Johnston","41.67304","-93.69772","2","0","0","0","1","0","0","3","0","0","0","0","0","2","1","0","0","3","3","0","0","0","0","3"
"Johnston","33.83208","-81.80094","2","0","0","0","1","0","0","3","0","0","0","0","0","2","1","0","0","3","3","0","0","0","0","3"
"Johnston","41.82186","-71.50675","2","0","0","0","1","0","0","3","0","0","0","0","0","2","1","0","0","3","3","0","0","0","0","3"
"Johnston","51.75556","-4.99667","2","0","0","0","1","0","0","3","0","0","0","0","0","2","1","0","0","3","3","0","0","0","0","3"
"Johnston","-12.48764","131.01169","2","0","0","0","1","0","0","3","0","0","0","0","0","2","1","0","0","3","3","0","0","0","0","3"
"Johnstone","55.82906","-4.51605","3","0","0","0","0","0","0","3","1","1","0","0","2","1","0","2","0","3","1","1","1","0","0","3"
"Johor Bahru","1.4655","103.7578","4","1","0","0","0","0","0","5","1","2","0","1","4","2","3","0","0","5","4","0","1","0","0","5"
"Jombang","-7.54595","112.23307","0","1","0","0","0","0","0","1","0","1","0","0","1","0","1","0","0","1","1","0","0","0","0","1"
"Jombang","-8.2329","113.3026","0","1","0","0","0","0","0","1","0","1","0","0","1","0","1","0","0","1","1","0","0","0","0","1"
"Jonesville","31.62656","-91.81818","1","0","0","0","0","0","0","1","0","0","1","0","1","0","0","1","0","1","0","1","0","0","0","1"
"Jonesville","41.98421","-84.6619","1","0","0","0","0","0","0","1","0","0","1","0","1","0","0","1","0","1","0","1","0","0","0","1"
"Jonesville","36.68898","-83.111","1","0","0","0","0","0","0","1","0","0","1","0","1","0","0","1","0","1","0","1","0","0","0","1"
"Jonesville","34.83597","-81.68093","1","0","0","0","0","0","0","1","0","0","1","0","1","0","0","1","0","1","0","1","0","0","0","1"
"Jonesville","36.2393","-80.84452","1","0","0","0","0","0","0","1","0","0","1","0","1","0","0","1","0","1","0","1","0","0","0","1"
"Joondalup","-31.74445","115.76835","1","0","0","0","0","0","0","1","0","1","0","0","1","1","0","0","0","1","1","0","0","0","0","1"
"Jos","9.92849","8.89212","2","0","0","0","0","0","0","2","1","0","0","0","1","0","2","0","0","2","0","0","2","0","0","2"
"Jounieh","33.98083","35.61778","3","0","0","0","0","0","0","3","0","0","0","1","1","0","0","2","1","3","1","1","1","0","0","3"
"Joypur Hāt","25.10147","89.02734","1","0","0","0","0","0","0","1","0","0","1","0","1","0","1","0","0","1","0","0","0","0","1","1"
"Juba","4.85165","31.58247","5","0","0","0","0","0","0","5","0","2","2","0","4","1","2","1","0","4","1","0","3","0","0","4"
"Juigalpa","12.10629","-85.36452","1","0","0","0","0","0","0","1","0","1","0","0","1","1","0","0","0","1","1","0","0","0","0","1"
"Juiz de Fora","-21.76417","-43.35028","1","0","0","0","0","0","0","1","1","0","0","0","1","0","0","1","0","1","0","0","1","0","0","1"
"Jupiter","26.93422","-80.09421","1","0","0","0","0","0","0","1","0","0","0","0","0","1","0","0","0","1","1","0","0","0","0","1"
"Jutiapa","14.29167","-89.89583","1","0","0","0","0","0","0","1","1","0","0","0","1","0","0","1","0","1","0","0","1","0","0","1"
"Jutiapa","15.76667","-86.51667","1","0","0","0","0","0","0","1","1","0","0","0","1","0","0","1","0","1","0","0","1","0","0","1"
"Jutiapa","13.98333","-86.4","1","0","0","0","0","0","0","1","1","0","0","0","1","0","0","1","0","1","0","0","1","0","0","1"
"Juticalpa","14.66667","-86.21944","1","0","0","0","0","0","0","1","0","1","0","0","1","0","1","0","0","1","1","0","0","0","0","1"
"Jwaneng","-24.60167","24.72806","0","0","0","0","0","0","0","0","0","0","0","0","0","0","0","0","0","0","0","0","0","0","0","0"
"Kabala","9.58893","-11.55256","1","0","0","0","0","0","0","1","0","1","0","0","1","1","0","0","0","1","0","0","0","0","1","1"
"Kabala","37.34585","40.80059","1","0","0","0","0","0","0","1","0","1","0","0","1","1","0","0","0","1","0","0","0","0","1","1"
"Kabanga","-2.63861","30.46778","1","0","0","0","0","0","0","1","0","0","0","0","0","0","1","0","0","1","0","0","1","0","0","1"
"Kabarnet","0.49194","35.74303","1","0","0","0","0","0","0","1","0","0","1","0","1","1","0","0","0","1","0","0","1","0","0","1"
"Kabirwala","30.40472","71.86269","1","0","0","0","0","0","0","1","0","0","0","0","0","1","0","0","0","1","0","0","0","0","1","1"
"Kabul","34.52813","69.17233","44","0","0","0","1","0","0","45","11","12","7","10","40","21","14","7","3","45","14","3","17","4","3","41"
"Kabwe","-14.4469","28.44644","4","0","0","0","0","0","0","4","0","0","1","1","2","3","0","1","0","4","1","0","2","0","1","4"
"Kaduna","10.52641","7.43879","14","1","0","0","0","1","0","16","4","2","4","3","13","7","4","5","0","16","3","3","7","0","3","16"
"Kaédi","16.15027","-13.5037","1","0","0","0","0","0","0","1","0","0","1","0","1","0","1","0","0","1","0","0","1","0","0","1"
"Kafr Abīl","32.41752","35.66305","1","0","0","0","0","0","0","1","0","0","0","0","0","1","0","0","0","1","1","0","0","0","0","1"
"Kafr ad Dawwār","31.13379","30.12969","5","0","0","0","0","0","0","5","1","4","0","0","5","4","1","0","0","5","1","0","1","3","0","5"
"Kafr ash Shaykh","31.11174","30.93991","8","1","0","0","0","0","0","9","4","2","1","0","7","3","3","3","0","9","2","0","5","1","1","9"
"Kafr Şaqr","30.79336","31.62575","2","0","0","0","0","0","0","2","1","0","0","0","1","1","1","0","0","2","1","0","1","0","0","2"
"Kahama","-3.83333","32.6","1","0","0","0","0","0","0","1","1","0","0","0","1","1","0","0","0","1","0","1","0","0","0","1"
"Kahramanmaraş","37.5847","36.92641","1","0","0","0","0","0","0","1","1","0","0","0","1","0","0","1","0","1","0","1","0","0","0","1"
"Kahror Pakka","29.6243","71.91437","1","0","0","0","0","0","0","1","0","0","1","0","1","0","1","0","0","1","0","0","0","0","1","1"
"Kairouan","35.6781","10.09633","3","0","0","0","0","0","0","3","1","2","0","0","3","2","0","1","0","3","0","0","3","0","0","3"
"Kaithal","29.80153","76.39959","2","0","0","0","0","0","0","2","1","0","0","1","2","0","1","1","0","2","0","0","2","0","0","2"
"Kakamega","0.28422","34.75229","3","0","0","0","0","0","0","3","1","2","0","0","3","2","0","0","0","2","0","0","2","0","1","3"
"Kakopetriá","34.98768","32.90468","1","0","0","0","0","0","0","1","0","0","0","0","0","0","0","1","0","1","0","1","0","0","0","1"
"Kalamata","37.03913","22.11265","4","0","0","0","0","0","0","4","1","2","0","0","3","2","0","2","0","4","2","1","1","0","0","4"
"Kalesija","44.43765","18.90713","1","0","0","0","0","0","0","1","0","1","0","0","1","0","1","0","0","1","1","0","0","0","0","1"
"Kalmunai","7.40902","81.83472","2","0","0","0","0","0","0","2","1","1","0","0","2","0","0","2","0","2","1","0","1","0","0","2"
"Kalulushi","-12.84151","28.09479","1","0","0","0","0","0","0","1","0","1","0","0","1","1","0","0","0","1","0","0","0","1","0","1"
"Kalutara","6.5831","79.9593","3","0","0","0","0","0","0","3","3","0","0","0","3","0","2","1","0","3","0","1","2","0","0","3"
"Kampala","0.31628","32.58219","21","1","0","1","1","0","1","25","8","10","5","3","26","18","4","4","1","27","9","2","12","1","3","27"
"Kampala Central Division","0.32467","32.5747","7","1","0","0","0","0","0","8","2","2","3","1","8","6","1","1","0","8","3","1","2","1","1","8"
"Kamp-Lintfort","51.50467","6.54587","1","0","0","0","0","0","0","1","0","1","0","0","1","0","0","1","0","1","0","1","0","0","0","1"
"Kampong Cham","11.99339","105.4635","0","0","0","0","1","0","0","1","0","0","0","0","0","0","1","0","0","1","0","1","0","0","0","1"
"Kanchipuram","12.83515","79.70006","2","0","0","0","0","0","0","2","1","0","1","0","2","1","1","0","0","2","0","0","2","0","0","2"
"Kandahār","31.61332","65.71013","6","0","0","0","0","0","0","6","2","4","0","0","6","3","1","3","0","7","0","0","5","1","1","7"
"Kandy","7.2906","80.6336","3","0","0","0","0","0","0","3","1","1","0","1","3","2","0","0","1","3","1","0","2","0","0","3"
"Kangayam","11.00599","77.5609","1","0","0","0","0","0","0","1","1","0","0","0","1","0","0","1","0","1","0","0","0","0","1","1"
"Kangema","-0.68553","36.96463","1","0","0","0","0","0","0","1","0","1","0","0","1","1","0","0","0","1","0","0","1","0","0","1"
"Kannapolis","35.48736","-80.62173","2","0","0","0","0","0","0","2","2","0","0","0","2","0","0","2","0","2","0","2","0","0","0","2"
"Kannur","11.86752","75.35763","3","0","0","0","0","0","0","3","3","0","0","0","3","1","1","1","0","3","0","2","1","0","0","3"
"Kano","12.00012","8.51672","15","0","0","0","0","0","0","15","1","5","2","3","11","7","5","2","0","14","4","0","5","3","3","15"
"Kanpur","26.46523","80.34975","1","0","0","0","1","0","0","2","1","0","1","0","2","0","2","0","0","2","0","0","1","0","1","2"
"Kansanshi","-12.09514","26.42727","1","0","0","0","0","0","0","1","0","1","0","0","1","0","0","0","1","1","0","0","0","1","0","1"
"Kansas City","39.11417","-94.62746","4","0","0","0","0","0","1","5","2","1","0","0","3","0","2","3","0","5","1","0","4","0","0","5"
"Kansas City","39.09973","-94.57857","4","0","0","0","0","0","1","5","2","1","0","0","3","0","2","3","0","5","1","0","4","0","0","5"
"Kant","42.89106","74.85077","1","1","0","0","0","0","0","2","2","0","0","0","2","1","0","1","0","2","0","0","2","0","0","2"
"Kaohsiung","22.61626","120.31333","0","1","0","0","0","0","0","1","1","0","0","0","1","1","0","0","0","1","0","1","0","0","0","1"
"Kapiri Mposhi","-13.97147","28.66985","1","0","0","0","0","0","0","1","0","0","0","0","0","1","0","0","0","1","1","0","0","0","0","1"
"Karachi","24.8608","67.0104","160","14","0","3","7","0","1","185","91","38","23","8","160","80","41","56","6","183","39","22","99","5","20","185"
"Karak","33.11633","71.09354","1","0","0","0","5","0","0","6","0","1","0","5","6","0","6","0","0","6","5","0","1","0","0","6"
"Karak City","31.16368","35.76204","3","0","0","0","0","0","0","3","2","1","1","0","4","0","1","2","0","3","1","0","3","0","0","4"
"Karbala","32.61603","44.02488","7","0","0","0","0","0","0","7","3","3","1","0","7","2","4","2","0","8","4","0","3","0","1","8"
"Kariba","-16.51667","28.8","0","0","0","0","0","0","0","0","0","1","0","0","1","1","0","0","0","1","0","0","1","0","0","1"
"Karlovac","45.49167","15.55","1","0","0","0","0","0","0","1","0","0","1","0","1","0","1","0","0","1","1","0","0","0","0","1"
"Karmāla","18.4077","75.19386","1","0","0","0","0","0","0","1","0","0","0","1","1","1","0","0","0","1","0","0","1","0","0","1"
"Karmi’el","32.91708","35.30501","2","0","0","0","0","0","0","2","0","1","0","1","2","0","1","0","1","2","1","0","1","0","0","2"
"Karur","10.95771","78.08095","1","0","0","0","0","0","0","1","1","0","0","0","1","0","0","1","0","1","0","1","0","0","0","1"
"Kasama","-10.21289","31.18084","3","0","0","0","0","0","0","3","0","3","0","0","3","3","0","0","0","3","0","0","1","0","2","3"
"Kasama","36.38333","140.26667","3","0","0","0","0","0","0","3","0","3","0","0","3","3","0","0","0","3","0","0","1","0","2","3"
"Kasane","-17.80165","25.16024","0","0","0","0","0","0","0","0","0","0","0","0","0","0","0","0","0","0","0","0","0","0","0","0"
"Kasempa","-13.45836","25.8338","2","0","0","0","0","0","0","2","0","2","0","0","2","0","1","1","0","2","1","0","0","0","1","2"
"Kasese","0.18333","30.08333","4","0","0","0","0","0","0","4","1","2","0","0","3","3","1","0","0","4","0","0","0","0","4","4"
"Kasoa","5.53449","-0.41679","0","0","0","0","0","0","0","0","0","0","0","0","0","0","0","0","0","0","0","0","0","0","0","0"
"Kassel","51.31667","9.5","1","0","0","0","1","0","0","2","0","1","1","0","2","0","0","2","0","2","0","0","0","0","2","2"
"Kastamonu","41.37805","33.77528","1","0","0","0","0","0","0","1","0","1","0","0","1","0","1","0","0","1","1","0","0","0","0","1"
"Kastoria","40.52165","21.26341","2","0","0","0","0","0","0","2","0","1","0","0","1","0","0","1","1","2","1","0","0","0","1","2"
"Kasur","31.11866","74.45025","5","0","0","0","0","0","0","5","3","0","2","0","5","0","0","5","0","5","1","0","4","0","0","5"
"Kataragama","6.4134","81.3346","1","0","0","0","0","0","0","1","0","0","1","0","1","1","0","0","0","1","0","0","0","0","1","1"
"Kateríni","40.26956","22.50608","1","0","0","0","0","0","0","1","0","1","0","0","1","0","0","0","0","0","1","0","0","0","0","1"
"Kathmandu","27.70169","85.3206","125","7","0","0","3","0","0","135","72","24","10","7","113","52","29","49","4","134","11","11","84","2","19","127"
"Katima Mulilo","-17.5","24.26667","1","0","0","0","0","0","0","1","0","0","1","0","1","0","0","0","1","1","0","0","1","0","0","1"
"Katonah","41.25898","-73.68541","1","0","0","0","0","0","0","1","0","0","0","0","0","0","0","1","0","1","0","0","1","0","0","1"
"Katowice","50.25841","19.02754","1","0","0","0","1","0","0","2","1","0","1","0","2","1","0","1","0","2","0","1","1","0","0","2"
"Katsina","12.99082","7.60177","11","0","0","0","0","0","0","11","2","4","1","4","11","5","2","3","1","11","2","0","6","1","2","11"
"Katunayaka","7.16992","79.88837","2","1","0","0","0","0","0","3","2","0","0","0","2","2","0","1","0","3","1","0","2","0","0","3"
"Kaunas","54.90272","23.90961","11","0","0","0","0","0","0","11","0","2","3","0","5","7","1","3","0","11","3","2","6","0","0","11"
"Kavajë","41.18556","19.55694","3","0","0","0","0","0","0","3","1","1","0","0","2","0","3","0","0","3","2","0","1","0","0","3"
"Kavála","40.93959","24.40687","1","0","0","0","0","0","0","1","1","0","0","0","1","0","0","1","0","1","0","0","1","0","0","1"
"Kavieng","-2.57337","150.79516","1","0","0","0","0","0","0","1","0","0","0","0","0","1","0","0","0","1","1","0","0","0","0","1"
"Kawm Ḩamādah","30.76128","30.69972","1","0","0","0","0","0","0","1","1","0","0","0","1","0","1","0","0","1","0","0","1","0","0","1"
"Kayseri","38.73222","35.48528","6","0","0","0","0","0","0","6","3","1","0","0","4","3","1","2","0","6","2","1","3","0","0","6"
"Kazan","40.23167","32.68389","3","0","0","0","0","0","0","3","0","1","1","1","3","1","2","0","0","3","1","0","2","0","0","3"
"Kazan","55.78874","49.12214","3","0","0","0","0","0","0","3","0","1","1","1","3","1","2","0","0","3","1","0","2","0","0","3"
"Kecskemét","46.90618","19.69128","1","0","0","0","0","0","0","1","0","1","0","0","1","0","0","1","0","1","1","0","0","0","0","1"
"Keelung","25.12825","121.7419","1","0","0","0","0","0","0","1","0","0","0","1","1","1","0","0","0","1","1","0","0","0","0","1"
"Keffi","8.84651","7.87354","2","0","0","0","0","0","0","2","0","2","0","0","2","1","1","0","0","2","0","0","0","0","2","2"
"Kehra","59.33611","25.32111","1","0","0","0","0","0","0","1","0","1","0","0","1","1","0","0","0","1","0","0","0","0","1","1"
"Keighley","53.86791","-1.90664","7","0","0","0","0","0","0","7","0","2","4","0","6","2","2","3","0","7","1","3","3","0","0","7"
"Keila","50.63738","11.66182","1","0","0","0","0","0","0","1","0","0","0","0","0","1","0","0","0","1","0","0","1","0","0","1"
"Keila","59.30361","24.41306","1","0","0","0","0","0","0","1","0","0","0","0","0","1","0","0","0","1","0","0","1","0","0","1"
"Keith","57.53633","-2.94811","1","0","0","0","0","0","0","1","0","1","0","0","1","1","0","0","0","1","0","1","0","0","0","1"
"Keith","-36.0991","140.35315","1","0","0","0","0","0","0","1","0","1","0","0","1","1","0","0","0","1","0","1","0","0","0","1"
"Kelar","34.62805","45.31852","5","0","0","0","0","0","0","5","3","1","1","0","5","2","2","1","0","5","1","2","2","0","0","5"
"Kélibia","36.84757","11.09386","1","0","0","0","0","0","0","1","0","1","0","0","1","0","1","0","0","1","0","0","1","0","0","1"
"Kelloe","54.71894","-1.47495","1","0","0","0","0","0","0","1","0","0","1","0","1","0","0","1","0","1","0","1","0","0","0","1"
"Kells","53.72639","-6.87917","2","0","0","0","0","0","0","2","0","0","2","0","2","0","0","2","0","2","0","0","2","0","0","2"
"Kelmscott","-32.12434","116.0259","0","0","0","0","1","0","0","1","0","1","0","0","1","1","0","0","0","1","1","0","0","0","0","1"
"Kelowna","49.88307","-119.48568","2","0","0","0","0","0","0","2","0","1","0","0","1","1","1","0","0","2","1","0","1","0","0","2"
"Kelsall","53.20775","-2.71242","1","0","0","0","0","0","0","1","0","0","1","0","1","0","0","1","0","1","0","0","1","0","0","1"
"Kelso","46.14678","-122.90844","6","0","0","0","2","0","1","9","0","2","6","0","8","2","0","6","1","9","1","5","2","0","1","9"
"Kelso","37.19061","-89.54953","6","0","0","0","2","0","1","9","0","2","6","0","8","2","0","6","1","9","1","5","2","0","1","9"
"Kelso","55.59814","-2.43382","6","0","0","0","2","0","1","9","0","2","6","0","8","2","0","6","1","9","1","5","2","0","1","9"
"Kelso","-19.38932","146.71912","6","0","0","0","2","0","1","9","0","2","6","0","8","2","0","6","1","9","1","5","2","0","1","9"
"Kelso","-33.41667","149.6","6","0","0","0","2","0","1","9","0","2","6","0","8","2","0","6","1","9","1","5","2","0","1","9"
"Kelvedon","51.84007","0.7057","1","0","0","0","0","0","0","1","0","1","0","0","1","0","0","1","0","1","0","1","0","0","0","1"
"Kendal","54.32681","-2.74757","7","0","0","0","2","0","0","9","1","4","3","0","8","3","3","3","0","9","2","4","2","0","1","9"
"Kendal","-6.9213","110.2022","7","0","0","0","2","0","0","9","1","4","3","0","8","3","3","3","0","9","2","4","2","0","1","9"
"Kendal","-8.1099","111.8483","7","0","0","0","2","0","0","9","1","4","3","0","8","3","3","3","0","9","2","4","2","0","1","9"
"Kendal","-7.0436","113.5874","7","0","0","0","2","0","0","9","1","4","3","0","8","3","3","3","0","9","2","4","2","0","1","9"
"Kenilworth","42.08586","-87.71756","4","0","0","0","1","0","0","5","1","3","1","0","5","0","0","5","0","5","1","2","2","0","0","5"
"Kenilworth","40.23149","-75.63408","4","0","0","0","1","0","0","5","1","3","1","0","5","0","0","5","0","5","1","2","2","0","0","5"
"Kenilworth","40.67649","-74.2907","4","0","0","0","1","0","0","5","1","3","1","0","5","0","0","5","0","5","1","2","2","0","0","5"
"Kenilworth","52.34958","-1.58276","4","0","0","0","1","0","0","5","1","3","1","0","5","0","0","5","0","5","1","2","2","0","0","5"
"Kenilworth","-26.59662","152.72807","4","0","0","0","1","0","0","5","1","3","1","0","5","0","0","5","0","5","1","2","2","0","0","5"
"Kenitra","34.26101","-6.5802","1","1","0","0","0","0","0","2","1","1","0","0","2","0","1","1","0","2","0","1","0","0","1","2"
"Kenley","52.6","-2.63333","1","1","0","0","0","0","1","3","2","1","0","0","3","0","0","3","0","3","1","1","1","0","0","3"
"Kenmore","47.75732","-122.24401","0","0","0","0","0","0","1","1","0","0","1","0","1","1","0","0","0","1","1","0","0","0","0","1"
"Kenmore","42.96589","-78.87004","0","0","0","0","0","0","1","1","0","0","1","0","1","1","0","0","0","1","1","0","0","0","0","1"
"Kenmore","-27.50759","152.93879","0","0","0","0","0","0","1","1","0","0","1","0","1","1","0","0","0","1","1","0","0","0","0","1"
"Kensington","37.91048","-122.28025","2","0","0","0","0","0","0","2","0","1","1","0","2","0","1","1","0","2","1","0","1","0","0","2"
"Kensington","39.02567","-77.07637","2","0","0","0","0","0","0","2","0","1","1","0","2","0","1","1","0","2","1","0","1","0","0","2"
"Kensington","40.64621","-73.97069","2","0","0","0","0","0","0","2","0","1","1","0","2","0","1","1","0","2","1","0","1","0","0","2"
"Kensington","40.79343","-73.72208","2","0","0","0","0","0","0","2","0","1","1","0","2","0","1","1","0","2","1","0","1","0","0","2"
"Kensington","41.63538","-72.76871","2","0","0","0","0","0","0","2","0","1","1","0","2","0","1","1","0","2","1","0","1","0","0","2"
"Kensington","42.92703","-70.94394","2","0","0","0","0","0","0","2","0","1","1","0","2","0","1","1","0","2","1","0","1","0","0","2"
"Kensington","46.43343","-63.64871","2","0","0","0","0","0","0","2","0","1","1","0","2","0","1","1","0","2","1","0","1","0","0","2"
"Kensington","51.50094","-0.19175","2","0","0","0","0","0","0","2","0","1","1","0","2","0","1","1","0","2","1","0","1","0","0","2"
"Kensington","-37.79188","144.93114","2","0","0","0","0","0","0","2","0","1","1","0","2","0","1","1","0","2","1","0","1","0","0","2"
"Kensington","-33.92019","151.22241","2","0","0","0","0","0","0","2","0","1","1","0","2","0","1","1","0","2","1","0","1","0","0","2"
"Kensington","-24.91711","152.31822","2","0","0","0","0","0","0","2","0","1","1","0","2","0","1","1","0","2","1","0","1","0","0","2"
"Kenthurst","-33.65527","151.00503","1","0","0","0","0","0","0","1","0","0","0","0","0","0","0","1","0","1","0","0","1","0","0","1"
"Kenton","45.58178","-122.68149","1","0","0","0","0","0","0","1","1","0","0","0","1","0","0","1","0","1","0","1","0","0","0","1"
"Kenton","36.20229","-89.01229","1","0","0","0","0","0","0","1","1","0","0","0","1","0","0","1","0","1","0","1","0","0","0","1"
"Kenton","40.647","-83.60965","1","0","0","0","0","0","0","1","1","0","0","0","1","0","0","1","0","1","0","1","0","0","0","1"
"Kenton","50.63978","-3.47151","1","0","0","0","0","0","0","1","1","0","0","0","1","0","0","1","0","1","0","1","0","0","0","1"
"Kericho","-0.36774","35.28314","4","0","0","0","0","0","0","4","0","2","0","0","2","1","0","1","0","2","0","0","0","0","2","2"
"Keroka","-0.77612","34.94678","1","0","0","0","0","0","0","1","0","0","1","0","1","1","0","0","0","1","0","1","0","0","0","1"
"Keswick","44.25011","-79.46632","1","0","0","0","0","0","1","2","1","0","1","0","2","0","1","1","0","2","0","2","0","0","0","2"
"Keswick","54.59947","-3.13256","1","0","0","0","0","0","1","2","1","0","1","0","2","0","1","1","0","2","0","2","0","0","0","2"
"Keswick","-34.94178","138.57459","1","0","0","0","0","0","1","2","1","0","1","0","2","0","1","1","0","2","0","2","0","0","0","2"
"Keta","5.91793","0.98789","2","0","0","0","0","0","0","2","1","0","0","1","2","2","0","0","0","2","0","0","2","0","0","2"
"Kettering","39.6895","-84.16883","14","1","0","0","5","0","0","20","2","7","2","2","13","10","3","7","0","20","6","2","11","0","1","20"
"Kettering","38.88456","-76.81469","14","1","0","0","5","0","0","20","2","7","2","2","13","10","3","7","0","20","6","2","11","0","1","20"
"Kettering","52.39836","-0.72571","14","1","0","0","5","0","0","20","2","7","2","2","13","10","3","7","0","20","6","2","11","0","1","20"
"Kettering","-43.12623","147.24641","14","1","0","0","5","0","0","20","2","7","2","2","13","10","3","7","0","20","6","2","11","0","1","20"
"Kewdale","-31.97886","115.95159","1","0","0","0","0","0","0","1","0","0","1","0","1","1","0","0","0","1","0","0","1","0","0","1"
"Keynsham","51.41387","-2.4978","3","0","0","0","0","0","0","3","0","0","2","0","2","1","0","2","0","3","0","1","2","0","0","3"
"Key West","24.55524","-81.78163","0","0","0","0","0","0","2","2","1","0","0","0","1","1","1","0","0","2","2","0","0","0","0","2"
"Kfar Saba","32.175","34.90694","2","0","0","0","0","0","0","2","0","1","0","0","1","1","0","1","0","2","2","0","0","0","0","2"
"Kfar Yasif","32.95451","35.1623","1","0","0","0","0","0","0","1","0","1","0","0","1","0","1","0","0","1","1","0","0","0","0","1"
"Khairpur Mir’s","27.52948","68.75915","1","0","0","0","0","0","0","1","0","0","0","0","0","1","0","0","0","1","1","0","0","0","0","1"
"Khamis Mushait","18.3","42.73333","3","0","0","0","0","0","0","3","1","1","0","0","2","1","1","1","0","3","1","0","1","1","0","3"
"Khammam","17.24767","80.14368","1","0","0","0","0","0","0","1","1","0","0","0","1","0","0","1","0","1","0","0","1","0","0","1"
"Khandwa","21.82427","76.35086","2","1","0","0","0","0","0","3","2","0","0","0","2","0","0","3","0","3","0","0","1","0","2","3"
"Khanewal","30.30173","71.93212","5","0","0","0","0","0","0","5","2","1","1","0","4","0","2","3","0","5","0","1","4","0","0","5"
"Khanpur","28.64739","70.65694","2","0","0","0","0","0","0","2","1","1","0","0","2","1","0","1","0","2","1","0","1","0","0","2"
"Khargone","21.82292","75.61394","0","1","0","0","0","0","0","1","1","0","0","0","1","0","0","1","0","1","0","0","1","0","0","1"
"Kharian","32.81612","73.88697","1","1","0","0","1","0","0","3","2","0","0","1","3","1","0","2","0","3","1","0","2","0","0","3"
"Kharkiv","49.98081","36.25272","9","2","0","0","2","0","0","13","2","3","4","0","9","6","2","5","0","13","3","0","7","1","2","13"
"Khartoum","15.55177","32.53241","9","0","0","1","0","0","0","10","3","2","1","0","6","2","4","4","0","10","2","1","3","1","3","10"
"Khed","17.71888","73.39693","1","0","0","0","0","0","0","1","0","1","0","0","1","1","0","0","0","1","0","0","0","0","1","1"
"Khed","18.33811","73.84677","1","0","0","0","0","0","0","1","0","1","0","0","1","1","0","0","0","1","0","0","0","0","1","1"
"Khemisset","33.82404","-6.06627","0","0","0","0","1","0","0","1","1","0","0","0","1","0","0","0","1","1","0","0","1","0","0","1"
"Kherson","46.65581","32.6178","1","0","0","0","0","0","0","1","0","0","0","0","0","0","1","0","0","1","1","0","0","0","0","1"
"Khlong San","13.73086","100.50903","1","0","0","0","0","0","0","1","0","1","0","0","1","1","0","0","0","1","1","0","0","0","0","1"
"Khobar","26.27944","50.20833","7","0","0","0","0","0","0","7","1","4","1","0","6","3","1","3","0","7","3","2","2","0","0","7"
"Khulna","22.80979","89.56439","10","1","0","0","1","0","0","12","9","2","1","0","12","7","0","4","0","11","1","0","10","0","2","13"
"Kiambu","-1.17139","36.83556","4","0","0","0","0","0","0","4","0","2","1","1","4","1","2","1","0","4","1","0","1","2","0","4"
"Kibaha","-6.76667","38.91667","1","0","0","0","0","0","0","1","0","1","0","0","1","0","1","0","0","1","0","0","0","0","1","1"
"Kidderminster","52.38819","-2.25","24","1","0","1","2","0","0","28","5","5","17","0","27","7","3","18","0","28","6","9","13","0","0","28"
"Kidlington","51.82166","-1.2886","5","1","0","0","0","0","0","6","1","2","3","0","6","2","1","3","0","6","0","2","3","1","0","6"
"Kidsgrove","53.08691","-2.23777","2","0","0","0","0","0","0","2","0","2","0","0","2","0","1","1","0","2","1","0","1","0","0","2"
"Kidwelly","51.73639","-4.30333","1","0","0","0","0","0","0","1","0","1","0","0","1","0","0","1","0","1","1","0","0","0","0","1"
"Kifisiá","38.07438","23.81106","2","0","0","0","0","0","0","2","1","0","1","0","2","0","0","2","0","2","0","1","1","0","0","2"
"Kigali","-1.94995","30.05885","9","0","0","0","0","0","1","10","3","3","1","0","7","6","2","2","0","10","4","1","2","2","1","10"
"Kigoma","-4.87694","29.62667","1","0","0","0","0","0","0","1","0","1","0","0","1","1","0","0","0","1","0","0","0","0","1","1"
"Kihancha","-1.19347","34.61967","0","1","0","0","0","0","0","1","0","1","0","0","1","0","1","0","0","1","0","0","0","0","1","1"
"Kilchberg","47.32438","8.54548","1","0","0","0","0","0","0","1","0","0","0","0","0","1","0","0","0","1","0","0","1","0","0","1"
"Kildare","53.15611","-6.91444","2","0","0","0","1","0","0","3","0","1","2","0","3","1","1","1","0","3","1","0","2","0","0","3"
"Kilgetty","51.73203","-4.71983","5","0","0","0","1","0","0","6","1","0","1","0","2","2","1","3","0","6","0","3","3","0","0","6"
"Kilifi","-3.63045","39.84992","2","0","0","0","0","0","0","2","1","1","0","0","2","1","1","0","0","2","0","0","2","0","0","2"
"Kilindoni","-7.91446","39.66204","1","0","0","0","0","0","0","1","0","1","0","0","1","1","0","0","0","1","0","1","0","0","0","1"
"Kilis","36.71611","37.115","1","0","0","0","0","0","0","1","0","0","1","0","1","0","1","0","0","1","0","0","1","0","0","1"
"Kilkenny","52.65417","-7.25222","3","0","0","0","1","0","0","4","2","1","0","1","4","0","1","2","1","4","1","0","2","0","1","4"
"Kilkenny","-34.87914","138.5529","3","0","0","0","1","0","0","4","2","1","0","1","4","0","1","2","1","4","1","0","2","0","1","4"
"Killaloe","52.80667","-8.44361","1","0","0","0","0","0","0","1","0","1","0","0","1","1","0","0","0","1","0","0","1","0","0","1"
"Killamarsh","53.32395","-1.31688","1","0","0","0","0","0","0","1","0","0","1","0","1","0","0","1","0","1","0","0","1","0","0","1"
"Kilmarnock","37.71041","-76.37967","16","2","0","0","1","0","1","20","3","11","6","0","20","6","5","9","0","20","4","7","9","0","0","20"
"Kilmarnock","55.61171","-4.49581","16","2","0","0","1","0","1","20","3","11","6","0","20","6","5","9","0","20","4","7","9","0","0","20"
"Kilwinning","55.65333","-4.70666","2","0","0","0","1","0","0","3","1","2","0","0","3","2","0","1","0","3","2","1","0","0","0","3"
"Kimbe","-5.55085","150.13766","0","1","0","0","0","0","0","1","0","1","0","0","1","1","0","0","0","1","1","0","0","0","0","1"
"Kindia","10.05692","-12.86576","1","0","0","0","0","0","0","1","0","0","0","1","1","1","0","0","0","1","0","0","0","0","1","1"
"Kingsbridge","50.28451","-3.77638","1","0","0","0","0","0","0","1","0","0","1","0","1","0","1","0","0","1","0","1","0","0","0","1"
"Kingsbury Episcopi","50.98853","-2.80662","0","0","0","0","1","0","0","1","1","0","0","0","1","1","0","0","0","1","0","1","0","0","0","1"
"Kingsclere","51.32487","-1.24339","1","0","0","0","0","0","0","1","0","0","0","0","0","1","0","0","0","1","0","0","1","0","0","1"
"Kings Hill","51.27437","0.40237","0","0","0","0","0","0","1","1","0","0","1","0","1","0","1","0","0","1","0","0","1","0","0","1"
"Kings Langley","51.71395","-0.45044","2","0","0","0","0","0","1","3","1","1","0","0","2","1","1","1","0","3","1","1","1","0","0","3"
"Kings Langley","-33.75005","150.93542","2","0","0","0","0","0","1","3","1","1","0","0","2","1","1","1","0","3","1","1","1","0","0","3"
"King's Lynn","52.75172","0.39516","3","0","0","0","1","0","1","5","2","1","0","0","3","1","1","3","0","5","0","2","2","0","1","5"
"Kingston upon Hull","53.7446","-0.33525","26","1","0","0","6","0","3","36","7","11","14","1","33","11","7","18","0","36","7","10","18","0","1","36"
"Kingston upon Thames","51.41259","-0.2974","16","2","0","6","2","0","5","31","12","6","9","1","28","9","6","16","0","31","2","14","14","0","1","31"
"Kingstown","35.35124","-81.61232","2","0","0","0","1","0","0","3","0","1","1","0","2","2","0","1","0","3","0","0","3","0","0","3"
"Kingstown","39.20483","-76.05133","2","0","0","0","1","0","0","3","0","1","1","0","2","2","0","1","0","3","0","0","3","0","0","3"
"Kingstown","13.15527","-61.22742","2","0","0","0","1","0","0","3","0","1","1","0","2","2","0","1","0","3","0","0","3","0","0","3"
"Kingswinford","52.49755","-2.16889","6","1","0","0","0","0","0","7","3","2","2","0","7","5","0","2","0","7","1","0","6","0","0","7"
"Kinloss","57.63494","-3.57012","1","0","0","0","0","0","0","1","0","1","0","0","1","0","0","1","0","1","0","1","0","0","0","1"
"Kinross","56.20466","-3.42138","1","0","0","0","0","0","1","2","0","0","1","0","1","1","1","0","0","2","0","0","2","0","0","2"
"Kinross","-31.71868","115.73839","1","0","0","0","0","0","1","2","0","0","1","0","1","1","1","0","0","2","0","0","2","0","0","2"
"Kinsale","51.7075","-8.53056","1","0","0","0","0","0","0","1","0","0","1","0","1","0","0","1","0","1","0","0","1","0","0","1"
"Kinshasa","-4.32758","15.31357","6","0","0","0","0","0","0","6","0","3","0","1","4","2","3","0","1","6","5","0","0","1","0","6"
"Kintampo","8.05627","-1.73058","2","0","0","0","0","0","0","2","0","0","0","0","0","1","1","0","0","2","0","0","2","0","0","2"
"Kireka","0.3475","32.64917","2","0","0","0","0","0","0","2","0","1","1","0","2","2","0","0","0","2","0","0","1","0","1","2"
"Kirkby Lonsdale","54.20259","-2.59827","2","0","0","0","0","0","0","2","0","1","1","0","2","0","0","2","0","2","0","1","1","0","0","2"
"Kirkcaldy","56.11683","-3.15999","7","0","0","0","0","0","0","7","0","3","4","0","7","1","2","4","0","7","2","2","3","0","0","7"
"Kirkham","53.78244","-2.87189","0","0","0","0","0","0","0","0","0","0","1","0","1","1","0","0","0","1","0","0","1","0","0","1"
"Kirkham","-34.03878","150.7111","0","0","0","0","0","0","0","0","0","0","1","0","1","1","0","0","0","1","0","0","1","0","0","1"
"Kirkliston","55.95364","-3.40288","1","0","0","0","0","0","0","1","0","1","0","0","1","0","0","1","0","1","0","0","1","0","0","1"
"Kirkuk","35.46806","44.39222","6","0","0","0","1","0","1","8","4","6","1","0","11","0","3","6","1","10","3","2","6","0","0","11"
"Kirkwall","58.98479","-2.95873","4","0","0","0","0","0","0","4","0","0","1","0","1","1","0","3","0","4","1","2","0","0","1","4"
"Kirriemuir","56.67398","-3.00343","2","0","0","0","0","0","0","2","0","1","1","0","2","1","0","1","0","2","0","2","0","0","0","2"
"Kırşehir","39.14583","34.16389","1","0","0","0","0","0","0","1","0","1","0","0","1","0","0","1","0","1","1","0","0","0","0","1"
"Kirton","52.92774","-0.06008","1","0","0","0","0","0","0","1","0","0","0","0","0","0","0","1","0","1","1","0","0","0","0","1"
"Kiseljak","43.94295","18.08132","1","0","0","0","0","0","0","1","0","1","0","0","1","0","1","0","0","1","1","0","0","0","0","1"
"Kiseljak","44.48904","18.56982","1","0","0","0","0","0","0","1","0","1","0","0","1","0","1","0","0","1","1","0","0","0","0","1"
"Kishanganj","26.10224","87.95534","6","0","0","0","0","0","0","6","6","0","0","0","6","0","0","6","0","6","0","0","6","0","0","6"
"Kishorganj","24.43944","90.78291","8","0","0","0","0","0","0","8","1","0","6","1","8","2","0","6","0","8","0","1","6","0","1","8"
"Kisii","-0.68174","34.76666","3","0","0","0","0","0","0","3","1","1","1","0","3","0","2","0","1","3","0","0","2","0","1","3"
"Kissimmee","28.30468","-81.41667","4","0","0","0","0","0","0","4","2","0","1","0","3","2","1","1","0","4","1","0","3","0","0","4"
"Kistler","37.75622","-81.86012","1","0","0","0","0","0","0","1","0","0","0","0","0","1","0","0","0","1","1","0","0","0","0","1"
"Kisumu","-0.10221","34.76171","7","0","0","0","2","0","0","9","0","4","1","2","7","7","0","2","0","9","1","2","3","0","3","9"
"Kitale","1.01572","35.00622","5","0","0","0","0","0","0","5","0","2","0","2","4","1","2","1","1","5","1","0","2","1","1","5"
"Kitangari","-10.65","39.33333","1","0","0","0","0","0","0","1","0","0","0","1","1","0","0","1","0","1","0","0","0","0","1","1"
"Kitchener","43.42537","-80.5112","2","0","0","0","0","0","0","2","1","0","1","0","2","2","0","0","0","2","1","0","1","0","0","2"
"Kitgum","3.27833","32.88667","0","1","0","0","0","0","0","1","0","0","1","0","1","1","0","0","0","1","0","0","0","0","1","1"
"Kitui","-1.36696","38.01055","3","0","1","0","0","0","0","4","1","1","0","0","2","3","0","1","0","4","1","0","1","0","2","4"
"Kitwe","-12.80243","28.21323","6","0","0","0","0","0","0","6","0","4","1","1","6","4","2","1","0","7","1","0","4","1","0","6"
"Kivsharivka","49.63096","37.68821","1","0","0","0","0","0","0","1","0","1","0","0","1","1","0","0","0","1","1","0","0","0","0","1"
"Klaipėda","55.7068","21.13912","4","0","0","0","0","0","0","4","0","2","1","0","3","3","0","1","0","4","0","2","0","0","2","4"
"Klang","3.03667","101.44333","1","0","0","0","0","0","0","1","0","1","0","0","1","0","0","1","0","1","1","0","0","0","0","1"
"Klenje","44.80794","19.43508","1","0","0","0","0","0","0","1","1","0","0","0","1","0","1","0","0","1","0","1","0","0","0","1"
"Knaresborough","54.0091","-1.46851","10","0","0","1","1","0","0","12","3","2","5","0","10","3","2","7","0","12","0","3","9","0","0","12"
"Knebworth","51.86674","-0.18394","0","0","0","1","0","0","0","1","1","0","0","0","1","0","0","1","0","1","0","0","1","0","0","1"
"Knighton","52.34251","-3.04708","1","0","0","0","0","0","0","1","0","0","1","0","1","1","0","0","0","1","0","1","0","0","0","1"
"Knottingley","53.70778","-1.25639","7","2","0","0","0","0","1","10","1","7","2","0","10","0","7","3","0","10","2","0","2","0","6","10"
"Knoxville","35.38203","-93.36435","1","0","0","0","0","0","0","1","1","0","0","0","1","0","0","1","0","1","0","0","1","0","0","1"
"Knoxville","41.32083","-93.10937","1","0","0","0","0","0","0","1","1","0","0","0","1","0","0","1","0","1","0","0","1","0","0","1"
"Knoxville","40.90837","-90.28485","1","0","0","0","0","0","0","1","1","0","0","0","1","0","0","1","0","1","0","0","1","0","0","1"
"Knoxville","32.72431","-83.99769","1","0","0","0","0","0","0","1","1","0","0","0","1","0","0","1","0","1","0","0","1","0","0","1"
"Knoxville","35.96064","-83.92074","1","0","0","0","0","0","0","1","1","0","0","0","1","0","0","1","0","1","0","0","1","0","0","1"
"Knoxville","41.95729","-77.43887","1","0","0","0","0","0","0","1","1","0","0","0","1","0","0","1","0","1","0","0","1","0","0","1"
"Knutsford","53.30289","-2.37482","3","0","0","0","1","0","0","4","0","2","2","0","4","1","0","3","0","4","0","1","3","0","0","4"
"Koblenz","50.35357","7.57883","1","0","0","0","0","0","0","1","1","0","0","0","1","1","0","0","0","1","0","0","1","0","0","1"
"Koblenz","47.60972","8.2375","1","0","0","0","0","0","0","1","1","0","0","0","1","1","0","0","0","1","0","0","1","0","0","1"
"Kohat","33.58196","71.44929","2","0","0","0","0","0","0","2","1","0","0","1","2","2","0","1","0","3","0","0","2","0","1","3"
"Kokrajhar","26.40107","90.27286","1","0","0","0","0","0","0","1","1","0","0","0","1","0","0","1","0","1","0","0","1","0","0","1"
"Kolanukonda","16.45392","80.61046","1","0","0","0","0","0","0","1","1","0","0","0","1","0","0","1","0","1","0","0","1","0","0","1"
"Kolhāpur","16.69563","74.23167","1","0","0","0","0","0","0","1","1","0","0","0","1","0","0","1","0","1","0","0","1","0","0","1"
"Kolkata","22.56263","88.36304","19","1","0","0","2","0","0","22","8","6","3","1","18","10","4","8","0","22","3","2","14","1","2","22"
"Kollam","8.88113","76.58469","3","0","0","0","0","0","0","3","0","0","1","1","2","1","1","1","0","3","3","0","0","0","0","3"
"Kollbrunn","47.45793","8.78295","1","0","0","0","0","0","0","1","0","0","0","0","0","0","1","0","0","1","0","1","0","0","0","1"
"Köln","50.93333","6.95","3","0","0","0","0","0","0","3","0","0","2","0","2","0","1","2","0","3","0","1","1","1","0","3"
"Kolomyia","48.53115","25.03649","1","0","0","0","0","0","0","1","0","1","0","0","1","1","0","0","0","1","1","0","0","0","0","1"
"Kolossi","34.66865","32.93375","2","0","0","0","0","0","0","2","2","0","0","0","2","2","0","0","0","2","0","0","0","0","0","0"
"Kolwezi","-10.71484","25.46674","2","0","0","0","0","0","0","2","0","2","0","0","2","0","1","1","0","2","2","0","0","0","0","2"
"Komárno","47.76356","18.12263","2","0","0","0","0","0","0","2","0","0","1","1","2","0","1","0","1","2","0","0","1","0","1","2"
"Komárno","48.11667","18.31667","2","0","0","0","0","0","0","2","0","0","1","1","2","0","1","0","1","2","0","0","1","0","1","2"
"Kondagaon","19.59083","81.664","2","0","0","0","0","0","0","2","1","0","1","0","2","1","1","0","0","2","0","0","2","0","0","2"
"Konya","37.87135","32.48464","2","0","0","0","1","0","0","3","2","0","1","0","3","2","0","1","0","3","0","1","2","0","0","3"
"Koplik","42.21361","19.43639","0","1","0","0","0","0","0","1","1","0","0","0","1","0","0","1","0","1","0","0","1","0","0","1"
"Koppa","13.53044","75.36329","1","0","0","0","0","0","0","1","1","0","0","0","1","0","0","1","0","1","0","0","1","0","0","1"
"Koppal","15.34522","76.15478","1","0","0","0","0","0","0","1","0","0","1","0","1","0","0","1","0","1","0","0","1","0","0","1"
"Korba","36.57861","10.85861","1","0","0","0","0","0","0","1","0","0","0","0","0","1","0","0","0","1","1","0","0","0","0","1"
"Korba","22.3458","82.69633","1","0","0","0","0","0","0","1","0","0","0","0","0","1","0","0","0","1","1","0","0","0","0","1"
"Kosamba","21.46202","72.95842","1","0","0","0","0","0","0","1","1","0","0","0","1","1","0","0","0","1","0","0","1","0","0","1"
"Košice","49.32532","14.7514","4","0","0","0","0","0","0","4","1","2","0","0","3","1","2","1","0","4","1","1","2","0","0","4"
"Košice","48.71395","21.25808","4","0","0","0","0","0","0","4","1","2","0","0","3","1","2","1","0","4","1","1","2","0","0","4"
"Kosovo Polje","42.66394","21.09611","1","0","0","0","0","0","0","1","0","0","0","0","0","0","1","0","0","1","1","0","0","0","0","1"
"Kota","25.18254","75.83907","5","1","0","0","1","0","0","7","6","0","0","1","7","2","1","4","0","7","0","0","6","1","0","7"
"Kota","24.44643","83.13063","5","1","0","0","1","0","0","7","6","0","0","1","7","2","1","4","0","7","0","0","6","1","0","7"
"Kota Bharu","6.12361","102.24333","1","0","0","0","0","0","0","1","1","0","0","0","1","1","0","0","0","1","0","0","1","0","0","1"
"Kot Addu","30.46907","70.96699","1","0","0","0","0","0","0","1","0","0","0","0","0","1","0","0","0","1","0","0","1","0","0","1"
"Kota Kinabalu","5.9749","116.0724","3","0","0","0","0","0","0","3","1","1","0","0","2","1","2","0","0","3","2","1","0","0","0","3"
"Kot Ghulam Muhammad","32.33311","74.54694","1","0","0","0","0","0","0","1","1","0","0","0","1","0","1","0","0","1","1","0","0","0","0","1"
"Kotli","33.51836","73.9022","4","1","0","0","0","0","0","5","2","1","1","0","4","2","1","2","0","5","2","1","2","0","0","5"
"Kotor","42.42067","18.76825","2","0","0","0","0","0","0","2","1","0","0","0","1","0","1","0","1","2","1","0","1","0","0","2"
"Kot Sultan","30.7737","70.93125","1","0","0","0","0","0","0","1","1","0","0","0","1","0","1","0","0","1","1","0","0","0","0","1"
"Kottayam","9.58692","76.52132","3","0","0","0","0","0","0","3","3","0","0","0","3","1","0","2","0","3","1","0","2","0","0","3"
"Kousséri","12.07689","15.03063","0","0","0","0","1","0","0","1","0","1","0","0","1","0","1","0","0","1","0","0","0","0","1","1"
"Kowloon","22.31667","114.18333","4","0","0","0","0","0","0","4","3","1","0","0","4","3","0","1","0","4","0","0","4","0","0","4"
"Kozhikode","11.24802","75.7804","3","0","0","0","0","0","0","3","1","1","0","0","2","0","2","0","1","3","0","1","0","0","2","3"
"Kozy","49.84756","19.14891","1","0","0","0","0","0","0","1","0","0","0","0","0","0","0","1","0","1","0","0","1","0","0","1"
"Kraainem","50.86155","4.46946","1","0","0","0","0","0","0","1","0","0","0","0","0","0","1","0","0","1","1","0","0","0","0","1"
"Kragujevac","44.01667","20.91667","5","0","0","0","0","0","0","5","2","1","0","0","3","0","3","2","0","5","1","0","4","0","0","5"
"Kraków","50.06143","19.93658","1","0","0","0","0","0","0","1","0","1","0","0","1","1","0","0","0","1","1","0","0","0","0","1"
"Kranenburg","51.78333","6.01667","1","0","0","0","0","0","0","1","0","1","0","0","1","0","1","0","0","1","1","0","0","0","0","1"
"Kranenburg","53.60651","9.20602","1","0","0","0","0","0","0","1","0","1","0","0","1","0","1","0","0","1","1","0","0","0","0","1"
"Kranj","46.23887","14.35561","1","0","0","0","0","0","0","1","0","0","1","0","1","0","0","1","0","1","0","0","1","0","0","1"
"Kremnica","48.70519","18.91834","1","0","0","0","0","0","0","1","1","0","0","0","1","0","1","0","0","1","0","0","1","0","0","1"
"Krishnagiri","12.51921","78.21382","1","0","0","0","0","0","0","1","1","0","0","0","1","0","0","1","0","1","0","0","1","0","0","1"
"Krishnanagar","23.40576","88.49073","1","0","0","0","0","0","0","1","1","0","0","0","1","0","0","1","0","1","0","0","1","0","0","1"
"Kristianstad","56.03129","14.15242","2","0","0","0","0","0","0","2","0","2","0","0","2","2","0","0","0","2","0","0","0","1","1","2"
"Kropyvnytskyi","48.5132","32.2597","2","0","0","0","0","0","0","2","1","0","1","0","2","2","0","0","0","2","0","0","2","0","0","2"
"Krumpendorf","46.63333","14.21667","1","0","0","0","0","0","0","1","0","1","0","0","1","0","0","1","0","1","0","0","1","0","0","1"
"Kruševac","43.58","21.33389","1","0","0","0","0","0","0","1","0","1","0","0","1","1","0","0","0","1","1","0","0","0","0","1"
"Kuala Belait","4.58361","114.2312","1","0","0","0","0","0","0","1","0","0","0","1","1","1","0","0","0","1","1","0","0","0","0","1"
"Kuala Lumpur","3.1412","101.68653","12","2","0","0","1","0","0","15","7","2","2","0","11","5","4","6","0","15","4","2","6","0","2","14"
"Kuala Selangor","3.35","101.25","0","0","0","0","1","0","0","1","1","0","0","0","1","0","0","1","0","1","0","0","1","0","0","1"
"Kuala Terengganu","5.3302","103.1408","1","0","0","0","1","0","0","2","0","2","0","0","2","1","1","0","0","2","2","0","0","0","0","2"
"Kukës","42.07694","20.42194","1","0","0","0","0","0","0","1","0","0","0","0","0","1","0","0","0","1","0","1","0","0","0","1"
"Kulai","1.6561","103.6032","1","0","0","0","0","0","0","1","0","0","0","0","0","1","0","0","0","1","0","0","1","0","0","1"
"Kulim","5.36499","100.56177","1","0","0","2","0","0","0","3","0","1","2","0","3","1","0","2","0","3","0","0","2","0","1","3"
"Kumanovo","42.13222","21.71444","4","0","0","0","0","0","0","4","1","1","0","1","3","0","2","2","0","4","1","1","2","0","0","4"
"Kumasi","6.68848","-1.62443","26","0","0","0","0","0","0","26","9","12","3","1","25","13","6","6","1","26","5","1","11","8","1","26"
"Kuna","43.49183","-116.42012","1","0","0","0","0","0","0","1","0","1","0","0","1","1","0","0","0","1","0","1","0","0","0","1"
"Kunming","25.03889","102.71833","1","0","0","0","0","0","0","1","0","0","1","0","1","0","0","1","0","1","0","0","1","0","0","1"
"Kunnamkulam","10.64667","76.06695","1","0","0","0","0","0","0","1","1","0","0","0","1","1","0","0","0","1","0","1","0","0","0","1"
"Kurgan","55.45","65.33333","1","0","0","0","0","0","0","1","0","0","0","0","0","0","1","0","0","1","0","0","0","0","1","1"
"Kurnool","15.82887","78.03602","2","0","0","0","0","0","0","2","2","0","0","0","2","0","1","0","0","1","0","0","2","0","0","2"
"Kuršėnai","56.00318","22.93662","0","1","0","0","0","0","0","1","0","1","0","0","1","1","0","0","0","1","0","1","0","0","0","1"
"Kursk","51.73733","36.18735","4","0","0","0","0","0","0","4","1","0","1","0","2","2","0","2","0","4","0","0","4","0","0","4"
"Kurunegala","7.4839","80.3683","4","0","0","0","0","0","0","4","3","0","1","0","4","0","1","3","0","4","0","0","4","0","0","4"
"Kushtia","23.9028","89.11943","2","0","0","0","0","0","0","2","2","0","0","0","2","2","0","0","0","2","0","0","2","0","0","2"
"Kutaisi","42.26791","42.69459","2","0","0","0","0","0","0","2","1","0","0","0","1","1","1","0","0","2","0","0","2","0","0","2"
"Kuwait City","29.36972","47.97833","4","0","0","0","0","0","0","4","1","1","0","0","2","4","0","0","0","4","3","0","1","0","0","4"
"Kyiv","50.45466","30.5238","30","3","0","1","1","0","0","35","8","5","3","1","17","16","9","10","0","35","10","3","16","2","3","34"
"Labasa","-16.4332","179.36451","0","0","0","0","1","0","0","1","0","0","0","0","0","1","0","0","0","1","0","0","0","0","1","1"
"La Bastide-sur-l'Hers","42.95473","1.90814","1","0","0","0","0","0","0","1","1","0","0","0","1","0","0","1","0","1","0","1","0","0","0","1"
"Labin","45.095","14.11972","1","0","0","0","0","0","0","1","0","0","1","0","1","1","0","0","0","1","0","0","1","0","0","1"
"La Cañada Flintridge","34.19917","-118.18785","1","0","0","0","0","0","0","1","0","1","0","0","1","0","0","1","0","1","0","0","1","0","0","1"
"Lacock","51.41528","-2.12194","1","0","0","0","0","0","0","1","0","0","1","0","1","0","0","1","0","1","0","0","1","0","0","1"
"Ladybank","56.27421","-3.1239","0","0","0","1","0","0","0","1","1","0","0","0","1","1","0","0","0","1","0","0","1","0","0","1"
"Ladybrand","-29.19448","27.45739","1","0","0","0","0","0","0","1","0","0","1","0","1","1","0","0","0","1","0","0","1","0","0","1"
"Lae","-6.72333","146.99611","2","0","0","0","0","0","0","2","0","2","0","0","2","1","0","1","0","2","0","0","1","0","1","2"
"Lae","8.92217","166.26344","2","0","0","0","0","0","0","2","0","2","0","0","2","1","0","1","0","2","0","0","1","0","1","2"
"La Entrada","15.05","-88.73333","0","1","0","0","0","0","0","1","0","0","1","0","1","0","0","1","0","1","0","1","0","0","0","1"
"La Entrada","19.55367","-69.90762","0","1","0","0","0","0","0","1","0","0","1","0","1","0","0","1","0","1","0","1","0","0","0","1"
"Lafayette","45.24428","-123.11483","2","0","0","0","0","0","0","2","1","0","0","0","1","0","0","2","0","2","0","0","2","0","0","2"
"Lafayette","37.88576","-122.11802","2","0","0","0","0","0","0","2","1","0","0","0","1","0","0","2","0","2","0","0","2","0","0","2"
"Lafayette","39.9936","-105.08971","2","0","0","0","0","0","0","2","1","0","0","0","1","0","0","2","0","2","0","0","2","0","0","2"
"Lafayette","30.22409","-92.01984","2","0","0","0","0","0","0","2","1","0","0","0","1","0","0","2","0","2","0","0","2","0","0","2"
"Lafayette","40.4167","-86.87529","2","0","0","0","0","0","0","2","1","0","0","0","1","0","0","2","0","2","0","0","2","0","0","2"
"Lafayette","36.52116","-86.02637","2","0","0","0","0","0","0","2","1","0","0","0","1","0","0","2","0","2","0","0","2","0","0","2"
"Lafayette","36.18589","-85.71609","2","0","0","0","0","0","0","2","1","0","0","0","1","0","0","2","0","2","0","0","2","0","0","2"
"Lafayette","32.89985","-85.40106","2","0","0","0","0","0","0","2","1","0","0","0","1","0","0","2","0","2","0","0","2","0","0","2"
"Lafayette Hill","40.09245","-75.2533","1","0","0","0","0","0","0","1","0","0","1","0","1","0","0","1","0","1","0","0","1","0","0","1"
"Lafia","8.4939","8.51532","0","0","0","0","0","0","0","0","0","0","0","0","0","0","1","0","0","1","1","0","0","0","0","1"
"Laghouat","33.8","2.86514","3","1","0","0","0","0","0","4","2","2","0","0","4","1","2","1","0","4","1","1","2","0","0","4"
"Lagos","37.10202","-8.67422","33","3","0","0","2","0","1","39","15","11","7","3","36","19","7","10","4","40","11","4","19","1","3","38"
"Lagos","43.20885","-0.22478","33","3","0","0","2","0","1","39","15","11","7","3","36","19","7","10","4","40","11","4","19","1","3","38"
"Lagos","6.45407","3.39467","33","3","0","0","2","0","1","39","15","11","7","3","36","19","7","10","4","40","11","4","19","1","3","38"
"La Habra","33.93196","-117.94617","1","0","0","0","0","0","0","1","0","0","1","0","1","0","0","1","0","1","0","1","0","0","0","1"
"Lahān","26.72022","86.48258","3","0","0","0","0","0","0","3","2","0","1","0","3","0","2","1","0","3","0","0","2","0","1","3"
"Lahore","31.558","74.35071","126","5","0","2","4","0","0","137","54","32","17","11","114","51","36","46","2","135","36","5","78","2","14","135"
"Lakhdaria","36.56463","3.5933","0","0","0","0","1","0","0","1","1","0","0","0","1","0","1","0","0","1","0","1","0","0","0","1"
"Lakshmīpur","22.9443","90.83005","1","0","0","0","0","0","0","1","0","0","1","0","1","1","0","0","0","1","0","0","0","0","1","1"
"La Laguna","24.21351","-103.1828","1","0","0","0","0","0","0","1","0","0","1","0","1","0","0","1","0","1","0","0","1","0","0","1"
"La Laguna","20.70431","-100.79049","1","0","0","0","0","0","0","1","0","0","1","0","1","0","0","1","0","1","0","0","1","0","0","1"
"La Laguna","21.11864","-100.45993","1","0","0","0","0","0","0","1","0","0","1","0","1","0","0","1","0","1","0","0","1","0","0","1"
"La Laguna","19.73447","-98.49989","1","0","0","0","0","0","0","1","0","0","1","0","1","0","0","1","0","1","0","0","1","0","0","1"
"La Laguna","18.79944","-97.73667","1","0","0","0","0","0","0","1","0","0","1","0","1","0","0","1","0","1","0","0","1","0","0","1"
"La Laguna","20.4425","-97.44306","1","0","0","0","0","0","0","1","0","0","1","0","1","0","0","1","0","1","0","0","1","0","0","1"
"La Laguna","19.48214","-96.93366","1","0","0","0","0","0","0","1","0","0","1","0","1","0","0","1","0","1","0","0","1","0","0","1"
"La Laguna","17.27056","-94.50189","1","0","0","0","0","0","0","1","0","0","1","0","1","0","0","1","0","1","0","0","1","0","0","1"
"La Laguna","16.00222","-93.80639","1","0","0","0","0","0","0","1","0","0","1","0","1","0","0","1","0","1","0","0","1","0","0","1"
"La Laguna","16.69357","-91.94929","1","0","0","0","0","0","0","1","0","0","1","0","1","0","0","1","0","1","0","0","1","0","0","1"
"La Laguna","8.33882","-80.72949","1","0","0","0","0","0","0","1","0","0","1","0","1","0","0","1","0","1","0","0","1","0","0","1"
"La Laguna","8.60409","-80.04716","1","0","0","0","0","0","0","1","0","0","1","0","1","0","0","1","0","1","0","0","1","0","0","1"
"La Laguna","9.04404","-79.84215","1","0","0","0","0","0","0","1","0","0","1","0","1","0","0","1","0","1","0","0","1","0","0","1"
"La Laguna","28.4853","-16.32014","1","0","0","0","0","0","0","1","0","0","1","0","1","0","0","1","0","1","0","0","1","0","0","1"
"La Libertad","29.91313","-112.69179","1","0","0","0","0","0","0","1","1","0","0","0","1","0","1","0","0","1","1","0","0","0","0","1"
"La Libertad","21.59347","-105.17365","1","0","0","0","0","0","0","1","1","0","0","0","1","0","1","0","0","1","1","0","0","0","0","1"
"La Libertad","23.79079","-99.19132","1","0","0","0","0","0","0","1","1","0","0","0","1","0","1","0","0","1","1","0","0","0","0","1"
"La Libertad","17.74571","-98.73928","1","0","0","0","0","0","0","1","1","0","0","0","1","0","1","0","0","1","1","0","0","0","0","1"
"La Libertad","20.45156","-97.69152","1","0","0","0","0","0","0","1","1","0","0","0","1","0","1","0","0","1","1","0","0","0","0","1"
"La Libertad","19.75583","-97.60722","1","0","0","0","0","0","0","1","1","0","0","0","1","0","1","0","0","1","1","0","0","0","0","1"
"La Libertad","20.05345","-96.97314","1","0","0","0","0","0","0","1","1","0","0","0","1","0","1","0","0","1","1","0","0","0","0","1"
"La Libertad","16.78961","-93.20976","1","0","0","0","0","0","0","1","1","0","0","0","1","0","1","0","0","1","1","0","0","0","0","1"
"La Libertad","16.90465","-92.56673","1","0","0","0","0","0","0","1","1","0","0","0","1","0","1","0","0","1","1","0","0","0","0","1"
"La Libertad","16.71617","-92.3508","1","0","0","0","0","0","0","1","1","0","0","0","1","0","1","0","0","1","1","0","0","0","0","1"
"La Libertad","14.59167","-92.19315","1","0","0","0","0","0","0","1","1","0","0","0","1","0","1","0","0","1","1","0","0","0","0","1"
"La Libertad","15.51421","-91.86944","1","0","0","0","0","0","0","1","1","0","0","0","1","0","1","0","0","1","1","0","0","0","0","1"
"La Libertad","17.6874","-91.72071","1","0","0","0","0","0","0","1","1","0","0","0","1","0","1","0","0","1","1","0","0","0","0","1"
"La Libertad","18.57042","-90.51399","1","0","0","0","0","0","0","1","1","0","0","0","1","0","1","0","0","1","1","0","0","0","0","1"
"La Libertad","16.7885","-90.11698","1","0","0","0","0","0","0","1","1","0","0","0","1","0","1","0","0","1","1","0","0","0","0","1"
"La Libertad","13.48833","-89.32222","1","0","0","0","0","0","0","1","1","0","0","0","1","0","1","0","0","1","1","0","0","0","0","1"
"La Libertad","14.8","-88.58333","1","0","0","0","0","0","0","1","1","0","0","0","1","0","1","0","0","1","1","0","0","0","0","1"
"La Libertad","14.75","-87.61667","1","0","0","0","0","0","0","1","1","0","0","0","1","0","1","0","0","1","1","0","0","0","0","1"
"La Libertad","12.21635","-85.16595","1","0","0","0","0","0","0","1","1","0","0","0","1","0","1","0","0","1","1","0","0","0","0","1"
"La Libertad","-2.233","-80.91039","1","0","0","0","0","0","0","1","1","0","0","0","1","0","1","0","0","1","1","0","0","0","0","1"
"La Libertad","10.0266","123.2335","1","0","0","0","0","0","0","1","1","0","0","0","1","0","1","0","0","1","1","0","0","0","0","1"
"La Libertad","7.48028","125.64722","1","0","0","0","0","0","0","1","1","0","0","0","1","0","1","0","0","1","1","0","0","0","0","1"
"La Limouzinière","46.99274","-1.59722","1","0","0","0","0","0","0","1","0","0","1","0","1","0","0","1","0","1","0","0","1","0","0","1"
"Lalmonirhat","25.91719","89.44595","1","0","0","0","0","0","0","1","0","0","0","1","1","1","0","0","0","1","0","1","0","0","0","1"
"La Madeleine","50.64603","3.07585","0","0","0","0","0","0","1","1","1","0","0","0","1","1","0","0","0","1","0","0","1","0","0","1"
"Lambaré","-25.34682","-57.60647","1","0","0","0","0","0","0","1","1","0","0","0","1","1","0","0","0","1","0","0","1","0","0","1"
"Lambeth","51.49635","-0.11152","1","2","0","0","1","0","0","4","3","0","1","0","4","1","0","3","0","4","0","0","3","1","0","4"
"La Mesa","32.76783","-117.02308","2","0","0","0","0","0","0","2","0","1","0","0","1","1","1","0","0","2","1","0","0","0","1","2"
"La Mesa","31.15972","-110.97444","2","0","0","0","0","0","0","2","0","1","0","0","1","1","1","0","0","2","1","0","0","0","1","2"
"La Mesa","32.12204","-106.70778","2","0","0","0","0","0","0","2","0","1","0","0","1","1","1","0","0","2","1","0","0","0","1","2"
"La Mesa","28.7688","-105.96914","2","0","0","0","0","0","0","2","0","1","0","0","1","1","1","0","0","2","1","0","0","0","1","2"
"La Mesa","19.58748","-100.17373","2","0","0","0","0","0","0","2","0","1","0","0","1","1","1","0","0","2","1","0","0","0","1","2"
"La Mesa","19.77444","-100.15028","2","0","0","0","0","0","0","2","0","1","0","0","1","1","1","0","0","2","1","0","0","0","1","2"
"La Mesa","20.08972","-98.22583","2","0","0","0","0","0","0","2","0","1","0","0","1","1","1","0","0","2","1","0","0","0","1","2"
"La Mesa","9.49587","-82.67534","2","0","0","0","0","0","0","2","0","1","0","0","1","1","1","0","0","2","1","0","0","0","1","2"
"La Mesa","8.14707","-81.18114","2","0","0","0","0","0","0","2","0","1","0","0","1","1","1","0","0","2","1","0","0","0","1","2"
"La Mesa","7.6567","-80.61794","2","0","0","0","0","0","0","2","0","1","0","0","1","1","1","0","0","2","1","0","0","0","1","2"
"La Mesa","9.17308","-79.27401","2","0","0","0","0","0","0","2","0","1","0","0","1","1","1","0","0","2","1","0","0","0","1","2"
"La Mesa","5.26667","-73.91667","2","0","0","0","0","0","0","2","0","1","0","0","1","1","1","0","0","2","1","0","0","0","1","2"
"Lampang","18.29232","99.49277","1","0","0","0","0","0","0","1","0","0","1","0","1","0","0","1","0","1","0","0","1","0","0","1"
"Lampeter","39.9901","-76.23968","4","0","0","0","0","0","0","4","0","2","1","0","3","3","1","0","0","4","1","1","2","0","0","4"
"Lampeter","52.11285","-4.08039","4","0","0","0","0","0","0","4","0","2","1","0","3","3","1","0","0","4","1","1","2","0","0","4"
"Lamphey","51.6664","-4.87205","2","0","0","0","0","0","0","2","0","0","0","0","0","1","0","1","0","2","0","1","1","0","0","2"
"Lanaken","50.89318","5.6468","1","0","0","0","0","0","0","1","0","1","0","0","1","0","0","1","0","1","0","0","1","0","0","1"
"Lanark","42.10225","-89.83345","3","0","0","0","0","0","0","3","1","1","1","0","3","1","1","1","0","3","1","0","2","0","0","3"
"Lanark","55.67371","-3.7817","3","0","0","0","0","0","0","3","1","1","1","0","3","1","1","1","0","3","1","0","2","0","0","3"
"Lancaster","34.69804","-118.13674","21","0","0","0","2","0","1","24","8","10","5","0","23","6","3","15","0","24","5","8","8","0","3","24"
"Lancaster","32.59208","-96.75611","21","0","0","0","2","0","1","24","8","10","5","0","23","6","3","15","0","24","5","8","8","0","3","24"
"Lancaster","40.52086","-92.52797","21","0","0","0","2","0","1","24","8","10","5","0","23","6","3","15","0","24","5","8","8","0","3","24"
"Lancaster","42.84749","-90.71068","21","0","0","0","2","0","1","24","8","10","5","0","23","6","3","15","0","24","5","8","8","0","3","24"
"Lancaster","37.61952","-84.578","21","0","0","0","2","0","1","24","8","10","5","0","23","6","3","15","0","24","5","8","8","0","3","24"
"Lancaster","39.71368","-82.59933","21","0","0","0","2","0","1","24","8","10","5","0","23","6","3","15","0","24","5","8","8","0","3","24"
"Lancaster","34.72043","-80.7709","21","0","0","0","2","0","1","24","8","10","5","0","23","6","3","15","0","24","5","8","8","0","3","24"
"Lancaster","42.90061","-78.67031","21","0","0","0","2","0","1","24","8","10","5","0","23","6","3","15","0","24","5","8","8","0","3","24"
"Lancaster","37.76986","-76.46634","21","0","0","0","2","0","1","24","8","10","5","0","23","6","3","15","0","24","5","8","8","0","3","24"
"Lancaster","40.03788","-76.30551","21","0","0","0","2","0","1","24","8","10","5","0","23","6","3","15","0","24","5","8","8","0","3","24"
"Lancaster","42.45565","-71.67312","21","0","0","0","2","0","1","24","8","10","5","0","23","6","3","15","0","24","5","8","8","0","3","24"
"Lancaster","44.48895","-71.56925","21","0","0","0","2","0","1","24","8","10","5","0","23","6","3","15","0","24","5","8","8","0","3","24"
"Lancaster","54.04649","-2.79988","21","0","0","0","2","0","1","24","8","10","5","0","23","6","3","15","0","24","5","8","8","0","3","24"
"Lanchester","54.82108","-1.74256","1","0","0","0","0","0","0","1","0","0","1","0","1","0","0","1","0","1","0","0","1","0","0","1"
"Lancing","50.82882","-0.32247","7","0","0","0","0","0","0","7","0","2","3","0","5","3","0","4","0","7","2","2","3","0","0","7"
"Land O' Lakes","28.2189","-82.45759","1","0","0","0","0","0","0","1","0","1","0","0","1","0","0","1","0","1","1","0","0","0","0","1"
"Langhirano","44.61913","10.26652","1","0","0","0","0","0","0","1","0","0","0","0","0","0","0","1","0","1","0","0","1","0","0","1"
"Langnau am Albis","47.28885","8.5411","1","0","0","0","0","0","0","1","0","1","0","0","1","0","1","0","0","1","0","0","0","0","1","1"
"Langport","51.03778","-2.82806","1","0","0","0","0","0","0","1","0","1","0","0","1","1","0","0","0","1","1","0","0","0","0","1"
"Langtoft","52.69834","-0.3404","0","0","0","0","1","0","0","1","1","0","0","0","1","0","0","1","0","1","0","0","1","0","0","1"
"Lannion","48.73255","-3.45542","1","0","0","0","0","0","0","1","0","1","0","0","1","0","0","1","0","1","0","0","1","0","0","1"
"La Paz","24.14437","-110.3005","4","0","0","0","0","0","0","4","2","1","0","1","4","2","0","2","0","4","2","0","2","0","0","4"
"La Paz","28.20472","-106.47139","4","0","0","0","0","0","0","4","2","1","0","1","4","2","0","2","0","4","2","0","2","0","0","4"
"La Paz","25.5939","-103.35852","4","0","0","0","0","0","0","4","2","1","0","1","4","2","0","2","0","4","2","0","2","0","0","4"
"La Paz","20.54052","-103.05239","4","0","0","0","0","0","0","4","2","1","0","1","4","2","0","2","0","4","2","0","2","0","0","4"
"La Paz","21.81608","-101.76793","4","0","0","0","0","0","0","4","2","1","0","1","4","2","0","2","0","4","2","0","2","0","0","4"
"La Paz","15.78213","-92.63064","4","0","0","0","0","0","0","4","2","1","0","1","4","2","0","2","0","4","2","0","2","0","0","4"
"La Paz","14.31944","-87.67917","4","0","0","0","0","0","0","4","2","1","0","1","4","2","0","2","0","4","2","0","2","0","0","4"
"La Paz","41.45977","-86.30834","4","0","0","0","0","0","0","4","2","1","0","1","4","2","0","2","0","4","2","0","2","0","0","4"
"La Paz","6.17848","-73.58948","4","0","0","0","0","0","0","4","2","1","0","1","4","2","0","2","0","4","2","0","2","0","0","4"
"La Paz","10.38439","-73.17332","4","0","0","0","0","0","0","4","2","1","0","1","4","2","0","2","0","4","2","0","2","0","0","4"
"La Paz","-16.5","-68.15","4","0","0","0","0","0","0","4","2","1","0","1","4","2","0","2","0","4","2","0","2","0","0","4"
"La Paz","-33.46091","-67.54956","4","0","0","0","0","0","0","4","2","1","0","1","4","2","0","2","0","4","2","0","2","0","0","4"
"La Paz","-30.74179","-59.64517","4","0","0","0","0","0","0","4","2","1","0","1","4","2","0","2","0","4","2","0","2","0","0","4"
"La Paz","-34.76031","-56.2259","4","0","0","0","0","0","0","4","2","1","0","1","4","2","0","2","0","4","2","0","2","0","0","4"
"La Paz","17.6746","120.6864","4","0","0","0","0","0","0","4","2","1","0","1","4","2","0","2","0","4","2","0","2","0","0","4"
"La Paz","15.44125","120.72863","4","0","0","0","0","0","0","4","2","1","0","1","4","2","0","2","0","4","2","0","2","0","0","4"
"La Paz","16.91075","121.66824","4","0","0","0","0","0","0","4","2","1","0","1","4","2","0","2","0","4","2","0","2","0","0","4"
"La Paz","10.4131","122.5162","4","0","0","0","0","0","0","4","2","1","0","1","4","2","0","2","0","4","2","0","2","0","0","4"
"La Paz","10.8925","124.95583","4","0","0","0","0","0","0","4","2","1","0","1","4","2","0","2","0","4","2","0","2","0","0","4"
"La Paz","7.31583","125.73333","4","0","0","0","0","0","0","4","2","1","0","1","4","2","0","2","0","4","2","0","2","0","0","4"
"La Paz","8.27083","125.79972","4","0","0","0","0","0","0","4","2","1","0","1","4","2","0","2","0","4","2","0","2","0","0","4"
"La Paz","8.98471","126.26299","4","0","0","0","0","0","0","4","2","1","0","1","4","2","0","2","0","4","2","0","2","0","0","4"
"La Plata","36.92861","-108.19035","1","0","0","0","0","0","0","1","0","0","0","0","0","0","0","1","0","1","0","0","1","0","0","1"
"La Plata","40.02337","-92.49158","1","0","0","0","0","0","0","1","0","0","0","0","0","0","0","1","0","1","0","0","1","0","0","1"
"La Plata","38.52929","-76.97525","1","0","0","0","0","0","0","1","0","0","0","0","0","0","0","1","0","1","0","0","1","0","0","1"
"La Plata","2.39341","-75.89232","1","0","0","0","0","0","0","1","0","0","0","0","0","0","0","1","0","1","0","0","1","0","0","1"
"La Plata","10.32025","-71.2721","1","0","0","0","0","0","0","1","0","0","0","0","0","0","0","1","0","1","0","0","1","0","0","1"
"La Plata","-34.92145","-57.95453","1","0","0","0","0","0","0","1","0","0","0","0","0","0","0","1","0","1","0","0","1","0","0","1"
"Lappeenranta","61.05871","28.18871","1","0","0","0","0","0","0","1","0","0","0","0","0","0","0","1","0","1","0","0","1","0","0","1"
"La Quinta","33.66336","-116.31001","1","0","0","0","0","0","0","1","0","1","0","0","1","0","1","0","0","1","1","0","0","0","0","1"
"Larbert","56.02246","-3.82872","1","0","0","0","1","0","0","2","0","0","1","0","1","1","0","1","0","2","0","1","1","0","0","2"
"Largs","55.79629","-4.86337","4","0","0","0","0","0","0","4","0","2","1","1","4","0","0","3","1","4","2","1","1","0","0","4"
"Largs","-32.7","151.6","4","0","0","0","0","0","0","4","0","2","1","1","4","0","0","3","1","4","2","1","1","0","0","4"
"Lárisa","39.63689","22.41761","1","0","0","0","0","0","0","1","1","0","0","0","1","0","0","1","0","1","0","0","1","0","0","1"
"Larkana","27.55898","68.21204","4","0","0","0","0","0","0","4","1","1","1","0","3","2","1","1","0","4","1","1","2","0","0","4"
"Larkhall","55.73333","-3.96667","1","0","0","1","0","0","0","2","1","0","1","0","2","0","0","2","0","2","0","1","1","0","0","2"
"Larnaca","34.92291","33.6233","2","0","0","0","1","0","0","3","1","1","0","0","2","0","0","3","0","3","1","1","1","0","0","3"
"Las Breñas","-27.08966","-61.08161","1","0","0","0","0","0","0","1","0","1","0","0","1","0","1","0","0","1","1","0","0","0","0","1"
"La Serena","-29.90453","-71.24894","1","0","0","0","0","0","0","1","0","0","0","0","0","0","1","0","0","1","0","0","0","0","1","1"
"Lashio","22.9359","97.7498","1","0","0","0","0","0","0","1","0","0","0","1","1","0","1","0","0","1","0","0","1","0","0","1"
"Las Palmas de Gran Canaria","28.09973","-15.41343","1","0","0","0","0","0","0","1","0","0","0","0","0","0","0","1","0","1","0","0","1","0","0","1"
"Las Piñas","14.45056","120.98278","3","1","0","0","1","0","0","5","3","2","0","0","5","0","1","4","0","5","0","0","5","0","0","5"
"Las Vegas","36.17497","-115.13722","5","0","0","0","0","0","2","7","1","3","2","0","6","5","0","2","0","7","1","1","5","0","0","7"
"Las Vegas","35.59393","-105.2239","5","0","0","0","0","0","2","7","1","3","2","0","6","5","0","2","0","7","1","1","5","0","0","7"
"Las Vegas","15.01667","-87.45","5","0","0","0","0","0","2","7","1","3","2","0","6","5","0","2","0","7","1","1","5","0","0","7"
"Las Vegas","9.53724","-68.63022","5","0","0","0","0","0","2","7","1","3","2","0","6","5","0","2","0","7","1","1","5","0","0","7"
"Latacunga","-0.93521","-78.61554","1","0","0","0","0","0","0","1","1","0","0","0","1","0","1","0","0","1","0","0","1","0","0","1"
"Latakia","35.53168","35.79011","3","1","0","1","2","0","0","7","3","0","2","2","7","1","1","3","2","7","0","1","4","0","2","7"
"Latina","40.38897","-3.74569","2","0","0","0","0","0","0","2","1","0","0","0","1","0","0","2","0","2","1","0","1","0","0","2"
"Latina","41.46614","12.9043","2","0","0","0","0","0","0","2","1","0","0","0","1","0","0","2","0","2","1","0","1","0","0","2"
"Latina","41.28993","14.27261","2","0","0","0","0","0","0","2","1","0","0","0","1","0","0","2","0","2","1","0","1","0","0","2"
"La Trinidad","25.73367","-108.48409","1","0","0","0","0","0","0","1","1","0","0","0","1","1","0","0","0","1","0","0","1","0","0","1"
"La Trinidad","20.67528","-102.48139","1","0","0","0","0","0","0","1","1","0","0","0","1","1","0","0","0","1","0","0","1","0","0","1"
"La Trinidad","20.58389","-101.48694","1","0","0","0","0","0","0","1","1","0","0","0","1","1","0","0","0","1","0","0","1","0","0","1"
"La Trinidad","20.91083","-101.25444","1","0","0","0","0","0","0","1","1","0","0","0","1","1","0","0","0","1","0","0","1","0","0","1"
"La Trinidad","20.56333","-100.78361","1","0","0","0","0","0","0","1","1","0","0","0","1","1","0","0","0","1","0","0","1","0","0","1"
"La Trinidad","20.63333","-100.29472","1","0","0","0","0","0","0","1","1","0","0","0","1","1","0","0","0","1","0","0","1","0","0","1"
"La Trinidad","24.09883","-100.05902","1","0","0","0","0","0","0","1","1","0","0","0","1","1","0","0","0","1","0","0","1","0","0","1"
"La Trinidad","20.5156","-99.96283","1","0","0","0","0","0","0","1","1","0","0","0","1","1","0","0","0","1","0","0","1","0","0","1"
"La Trinidad","18.96639","-99.58083","1","0","0","0","0","0","0","1","1","0","0","0","1","1","0","0","0","1","0","0","1","0","0","1"
"La Trinidad","19.68056","-99.17222","1","0","0","0","0","0","0","1","1","0","0","0","1","1","0","0","0","1","0","0","1","0","0","1"
"La Trinidad","19.95975","-98.70942","1","0","0","0","0","0","0","1","1","0","0","0","1","1","0","0","0","1","0","0","1","0","0","1"
"La Trinidad","17.07363","-98.18437","1","0","0","0","0","0","0","1","1","0","0","0","1","1","0","0","0","1","0","0","1","0","0","1"
"La Trinidad","19.28583","-97.21361","1","0","0","0","0","0","0","1","1","0","0","0","1","1","0","0","0","1","0","0","1","0","0","1"
"La Trinidad","17.43958","-95.54891","1","0","0","0","0","0","0","1","1","0","0","0","1","1","0","0","0","1","0","0","1","0","0","1"
"La Trinidad","18.23694","-93.07333","1","0","0","0","0","0","0","1","1","0","0","0","1","1","0","0","0","1","0","0","1","0","0","1"
"La Trinidad","14.71667","-87.66667","1","0","0","0","0","0","0","1","1","0","0","0","1","1","0","0","0","1","0","0","1","0","0","1"
"La Trinidad","15.1","-87.2","1","0","0","0","0","0","0","1","1","0","0","0","1","1","0","0","0","1","0","0","1","0","0","1"
"La Trinidad","12.96881","-86.23534","1","0","0","0","0","0","0","1","1","0","0","0","1","1","0","0","0","1","0","0","1","0","0","1"
"La Trinidad","7.91457","-80.70332","1","0","0","0","0","0","0","1","1","0","0","0","1","1","0","0","0","1","0","0","1","0","0","1"
"La Trinidad","16.455","120.5875","1","0","0","0","0","0","0","1","1","0","0","0","1","1","0","0","0","1","0","0","1","0","0","1"
"Lauder","55.71908","-2.74755","1","0","0","0","0","0","0","1","0","0","1","0","1","1","0","0","0","1","0","0","1","0","0","1"
"Launceston","50.63699","-4.36006","4","0","0","0","1","0","0","5","0","2","1","0","3","2","0","3","0","5","1","1","3","0","0","5"
"Launceston","-41.43876","147.13467","4","0","0","0","1","0","0","5","0","2","1","0","3","2","0","3","0","5","1","1","3","0","0","5"
"Laurencekirk","56.83338","-2.4654","1","0","0","0","0","0","0","1","0","1","0","0","1","0","1","0","0","1","1","0","0","0","0","1"
"Lausanne","46.516","6.63282","1","0","0","0","0","0","0","1","0","0","1","0","1","0","1","0","0","1","0","0","1","0","0","1"
"Lautoka","-17.61686","177.45049","7","0","0","0","0","0","0","7","3","1","0","0","4","3","3","1","0","7","2","0","4","0","1","7"
"La Vergne","36.01562","-86.58194","1","0","0","0","0","0","0","1","0","0","1","0","1","0","0","1","0","1","0","0","1","0","0","1"
"La Vergne","45.96283","-0.56426","1","0","0","0","0","0","0","1","0","0","1","0","1","0","0","1","0","1","0","0","1","0","0","1"
"Lawrenceville","38.72921","-87.68169","1","0","0","0","0","0","0","1","0","0","1","0","1","0","0","1","0","1","0","0","1","0","0","1"
"Lawrenceville","33.95621","-83.98796","1","0","0","0","0","0","0","1","0","0","1","0","1","0","0","1","0","1","0","0","1","0","0","1"
"Lawrenceville","40.46757","-79.96061","1","0","0","0","0","0","0","1","0","0","1","0","1","0","0","1","0","1","0","0","1","0","0","1"
"Lawrenceville","36.75765","-77.84694","1","0","0","0","0","0","0","1","0","0","1","0","1","0","0","1","0","1","0","0","1","0","0","1"
"Lawrenceville","41.99757","-77.12608","1","0","0","0","0","0","0","1","0","0","1","0","1","0","0","1","0","1","0","0","1","0","0","1"
"Lawrenceville","40.29733","-74.7296","1","0","0","0","0","0","0","1","0","0","1","0","1","0","0","1","0","1","0","0","1","0","0","1"
"Layer de la Haye","51.84593","0.85745","1","0","0","0","0","0","0","1","0","0","1","0","1","0","0","1","0","1","0","0","1","0","0","1"
"Layyah","30.96128","70.93904","6","1","0","0","0","0","0","7","4","1","2","0","7","4","1","2","0","7","0","0","7","0","0","7"
"Leatherhead","51.29652","-0.3338","7","0","0","1","0","0","0","8","1","2","4","0","7","3","2","3","0","8","2","1","5","0","0","8"
"Lecce","40.35481","18.17244","1","0","0","0","0","0","0","1","0","0","0","0","0","0","1","0","0","1","1","0","0","0","0","1"
"Lechlade","51.69403","-1.69128","2","0","0","0","0","0","0","2","2","0","0","0","2","1","0","1","0","2","0","1","1","0","0","2"
"Lede","50.96626","3.98594","1","0","0","0","0","0","0","1","0","0","0","0","0","1","0","0","0","1","0","0","1","0","0","1"
"Leeds","37.23859","-113.35912","137","6","0","7","17","0","6","173","31","50","59","2","142","69","25","78","1","173","24","34","113","0","3","174"
"Leeds","33.54816","-86.54443","137","6","0","7","17","0","6","173","31","50","59","2","142","69","25","78","1","173","24","34","113","0","3","174"
"Leeds","44.3034","-70.1195","137","6","0","7","17","0","6","173","31","50","59","2","142","69","25","78","1","173","24","34","113","0","3","174"
"Leeds","53.79648","-1.54785","137","6","0","7","17","0","6","173","31","50","59","2","142","69","25","78","1","173","24","34","113","0","3","174"
"Leek","53.10434","-2.02207","9","1","0","0","0","0","0","10","2","3","4","0","9","3","1","5","0","9","0","4","4","0","1","9"
"Leek","53.1625","6.37639","9","1","0","0","0","0","0","10","2","3","4","0","9","3","1","5","0","9","0","4","4","0","1","9"
"Lee-on-the-Solent","50.80169","-1.20174","1","0","0","0","0","0","0","1","0","0","1","0","1","0","0","1","0","1","0","0","1","0","0","1"
"Leesburg","41.33199","-85.84999","1","0","0","0","0","0","0","1","0","0","0","0","0","0","0","1","0","1","0","0","1","0","0","1"
"Leesburg","34.17982","-85.76136","1","0","0","0","0","0","0","1","0","0","0","0","0","0","0","1","0","1","0","0","1","0","0","1"
"Leesburg","31.73212","-84.17074","1","0","0","0","0","0","0","1","0","0","0","0","0","0","0","1","0","1","0","0","1","0","0","1"
"Leesburg","39.34506","-83.55297","1","0","0","0","0","0","0","1","0","0","0","0","0","0","0","1","0","1","0","0","1","0","0","1"
"Leesburg","28.81082","-81.87786","1","0","0","0","0","0","0","1","0","0","0","0","0","0","0","1","0","1","0","0","1","0","0","1"
"Leesburg","39.11566","-77.5636","1","0","0","0","0","0","0","1","0","0","0","0","0","0","0","1","0","1","0","0","1","0","0","1"
"Legnica","51.21006","16.1619","1","0","0","0","0","0","0","1","0","0","1","0","1","1","0","0","0","1","0","0","1","0","0","1"
"Le Hocq","49.16823","-2.06178","1","0","0","0","0","0","0","1","0","1","0","0","1","0","0","1","0","1","0","1","0","0","0","1"
"Leicester","43.86673","-73.10789","128","2","0","3","12","0","4","149","19","46","47","3","115","49","23","74","2","148","33","35","72","1","8","149"
"Leicester","42.24593","-71.90868","128","2","0","3","12","0","4","149","19","46","47","3","115","49","23","74","2","148","33","35","72","1","8","149"
"Leicester","52.6386","-1.13169","128","2","0","3","12","0","4","149","19","46","47","3","115","49","23","74","2","148","33","35","72","1","8","149"
"Leiderdorp","52.15833","4.52917","1","0","0","0","0","0","0","1","0","1","0","0","1","0","0","1","0","1","0","0","1","0","0","1"
"Leigh","53.49642","-2.51973","5","0","0","0","1","0","0","6","2","2","2","0","6","1","1","4","0","6","1","1","4","0","0","6"
"Leigh","52.17677","-2.31631","5","0","0","0","1","0","0","6","2","2","2","0","6","1","1","4","0","6","1","1","4","0","0","6"
"Leigh","51.61667","-1.9","5","0","0","0","1","0","0","6","2","2","2","0","6","1","1","4","0","6","1","1","4","0","0","6"
"Leigh-on-Sea","51.54297","0.64905","4","1","0","1","0","0","0","6","1","1","2","0","4","1","1","4","0","6","0","1","5","0","0","6"
"Leighton Buzzard","51.91722","-0.65802","11","0","0","1","0","0","0","12","1","3","5","1","10","5","1","6","0","12","1","4","7","0","0","12"
"Leirvík","62.20992","-6.69284","1","0","0","0","0","0","0","1","0","1","0","0","1","1","0","0","0","1","1","0","0","0","0","1"
"Leiston","52.20611","1.57757","1","0","0","0","0","0","0","1","1","0","0","0","1","1","0","0","0","1","0","1","0","0","0","1"
"Lelystad","52.50833","5.475","1","0","0","0","0","0","0","1","0","1","0","0","1","1","0","0","0","1","0","0","0","0","1","1"
"Lennoxtown","55.97263","-4.20001","1","0","0","0","0","0","0","1","0","1","0","0","1","1","0","0","0","1","1","0","0","0","0","1"
"Leominster","42.52509","-71.75979","2","0","0","0","0","0","0","2","0","2","0","0","2","2","0","0","0","2","1","0","1","0","0","2"
"Leominster","52.22583","-2.74491","2","0","0","0","0","0","0","2","0","2","0","0","2","2","0","0","0","2","1","0","1","0","0","2"
"Leopoldsburg","51.11667","5.25","1","0","0","0","0","0","0","1","0","0","0","0","0","0","1","0","0","1","0","0","1","0","0","1"
"Le Plessis-Robinson","48.78889","2.27078","0","1","0","0","0","0","0","1","0","0","1","0","1","0","0","1","0","1","0","0","1","0","0","1"
"Le Quesnoy","50.24797","3.63656","1","0","0","0","0","0","0","1","0","1","0","0","1","0","0","1","0","1","0","0","1","0","0","1"
"Leskovac","42.99806","21.94611","1","0","0","0","0","0","0","1","0","0","0","0","0","0","0","1","0","1","1","0","0","0","0","1"
"Leszno","51.84034","16.57494","1","0","0","0","0","0","0","1","0","0","0","1","1","1","0","0","0","1","1","0","0","0","0","1"
"Leszno","52.25799","20.59121","1","0","0","0","0","0","0","1","0","0","0","1","1","1","0","0","0","1","1","0","0","0","0","1"
"Letchworth Garden City","51.97938","-0.22664","7","0","0","0","3","0","0","10","1","3","4","0","8","2","3","5","0","10","1","4","4","0","1","10"
"Leuven","50.87959","4.70093","7","0","0","0","1","0","1","9","0","1","1","0","2","3","1","5","0","9","0","0","9","0","0","9"
"Levallois-Perret","48.89389","2.28864","1","0","0","0","0","0","0","1","1","0","0","0","1","1","0","0","0","1","0","0","1","0","0","1"
"Leven","56.2","-3","1","0","0","0","0","0","0","1","0","0","1","0","1","0","0","1","0","1","1","0","0","0","0","1"
"Leven","53.89028","-0.31783","1","0","0","0","0","0","0","1","0","0","1","0","1","0","0","1","0","1","1","0","0","0","0","1"
"Levens","54.26906","-2.78735","2","0","0","0","0","0","0","2","1","0","1","0","2","1","0","1","0","2","0","0","2","0","0","2"
"Levens","43.85948","7.22583","2","0","0","0","0","0","0","2","1","0","1","0","2","1","0","1","0","2","0","0","2","0","0","2"
"Lewes","38.77456","-75.13935","17","2","0","1","0","0","1","21","5","1","8","0","14","4","0","17","0","21","1","8","12","0","0","21"
"Lewes","50.87398","0.0088","17","2","0","1","0","0","1","21","5","1","8","0","14","4","0","17","0","21","1","8","12","0","0","21"
"Lexington","40.78084","-99.7415","9","0","0","0","0","0","0","9","1","4","1","0","6","5","1","3","0","9","6","2","1","0","0","9"
"Lexington","35.01479","-97.33558","9","0","0","0","0","0","0","9","1","4","1","0","6","5","1","3","0","9","6","2","1","0","0","9"
"Lexington","30.4191","-97.01165","9","0","0","0","0","0","0","9","1","4","1","0","6","5","1","3","0","9","6","2","1","0","0","9"
"Lexington","39.18473","-93.87994","9","0","0","0","0","0","0","9","1","4","1","0","6","5","1","3","0","9","6","2","1","0","0","9"
"Lexington","45.14247","-93.16328","9","0","0","0","0","0","0","9","1","4","1","0","6","5","1","3","0","9","6","2","1","0","0","9"
"Lexington","33.11318","-90.05314","9","0","0","0","0","0","0","9","1","4","1","0","6","5","1","3","0","9","6","2","1","0","0","9"
"Lexington","40.64142","-88.7834","9","0","0","0","0","0","0","9","1","4","1","0","6","5","1","3","0","9","6","2","1","0","0","9"
"Lexington","35.6509","-88.39338","9","0","0","0","0","0","0","9","1","4","1","0","6","5","1","3","0","9","6","2","1","0","0","9"
"Lexington","34.96925","-87.37113","9","0","0","0","0","0","0","9","1","4","1","0","6","5","1","3","0","9","6","2","1","0","0","9"
"Lexington","37.98869","-84.47772","9","0","0","0","0","0","0","9","1","4","1","0","6","5","1","3","0","9","6","2","1","0","0","9"
"Lexington","33.86984","-83.11182","9","0","0","0","0","0","0","9","1","4","1","0","6","5","1","3","0","9","6","2","1","0","0","9"
"Lexington","40.67867","-82.58239","9","0","0","0","0","0","0","9","1","4","1","0","6","5","1","3","0","9","6","2","1","0","0","9"
"Lexington","43.26808","-82.53076","9","0","0","0","0","0","0","9","1","4","1","0","6","5","1","3","0","9","6","2","1","0","0","9"
"Lexington","33.98154","-81.23621","9","0","0","0","0","0","0","9","1","4","1","0","6","5","1","3","0","9","6","2","1","0","0","9"
"Lexington","35.82403","-80.25338","9","0","0","0","0","0","0","9","1","4","1","0","6","5","1","3","0","9","6","2","1","0","0","9"
"Lexington","37.78402","-79.44282","9","0","0","0","0","0","0","9","1","4","1","0","6","5","1","3","0","9","6","2","1","0","0","9"
"Lexington","42.44732","-71.2245","9","0","0","0","0","0","0","9","1","4","1","0","6","5","1","3","0","9","6","2","1","0","0","9"
"Leyland","53.69786","-2.68758","4","0","0","0","1","0","3","8","1","3","2","0","6","2","1","5","0","8","3","1","4","0","0","8"
"Lhuentse","27.66787","91.18393","1","0","0","0","0","0","0","1","0","0","0","1","1","0","0","0","1","1","0","0","0","0","1","1"
"Librazhd","41.17944","20.315","1","0","0","0","0","0","0","1","0","1","0","0","1","0","1","0","0","1","0","1","0","0","0","1"
"Lichfield","52.68154","-1.82549","18","0","0","1","3","0","0","22","4","3","3","0","10","7","4","10","1","22","4","2","15","0","1","22"
"Lidingö","59.36667","18.13333","0","0","0","0","1","0","0","1","1","0","0","0","1","0","0","1","0","1","0","0","1","0","0","1"
"Lifton","50.64356","-4.28216","1","0","0","0","0","0","0","1","0","0","0","0","0","0","0","1","0","1","0","0","1","0","0","1"
"Lightwater","51.34846","-0.67147","0","0","0","0","1","0","0","1","0","0","1","0","1","0","0","1","0","1","0","0","1","0","0","1"
"Lillestrøm","59.95597","11.04918","0","0","0","0","1","0","0","1","1","0","0","0","1","0","0","1","0","1","0","1","0","0","0","1"
"Lilongwe","-13.96692","33.78725","6","0","0","0","2","0","0","8","0","3","1","2","6","3","2","0","2","7","3","0","4","1","0","8"
"Lima","40.74255","-84.10523","20","1","0","1","0","0","1","23","9","5","1","0","15","12","6","5","0","23","4","4","13","2","0","23"
"Lima","42.90479","-77.61139","20","1","0","1","0","0","1","23","9","5","1","0","15","12","6","5","0","23","4","4","13","2","0","23"
"Lima","-12.04318","-77.02824","20","1","0","1","0","0","1","23","9","5","1","0","15","12","6","5","0","23","4","4","13","2","0","23"
"Lima","39.91733","-75.44047","20","1","0","1","0","0","1","23","9","5","1","0","15","12","6","5","0","23","4","4","13","2","0","23"
"Lima","-23.88327","-56.48217","20","1","0","1","0","0","1","23","9","5","1","0","15","12","6","5","0","23","4","4","13","2","0","23"
"Limassol","34.68406","33.03794","2","0","0","0","0","0","0","2","0","2","0","0","2","0","2","0","0","2","2","0","0","0","0","2"
"Limavady","55.05045","-6.95074","3","0","0","1","0","0","0","4","1","1","2","0","4","2","0","2","0","4","1","2","1","0","0","4"
"Limbe","4.02356","9.20607","2","0","0","0","0","0","0","2","0","2","0","0","2","0","1","1","0","2","0","0","0","1","0","1"
"Limoges","45.3334","-75.24931","1","0","0","0","0","0","0","1","0","0","1","0","1","0","0","1","0","1","1","0","0","0","0","1"
"Limoges","45.83362","1.24759","1","0","0","0","0","0","0","1","0","0","1","0","1","0","0","1","0","1","1","0","0","0","0","1"
"Lincoln","38.89156","-121.29301","31","1","0","2","2","0","2","38","7","15","11","0","33","13","7","18","0","38","11","9","16","0","2","38"
"Lincoln","46.95494","-112.68171","31","1","0","2","2","0","2","38","7","15","11","0","33","13","7","18","0","38","11","9","16","0","2","38"
"Lincoln","43.51297","-111.96441","31","1","0","2","2","0","2","38","7","15","11","0","33","13","7","18","0","38","11","9","16","0","2","38"
"Lincoln","46.76249","-100.7004","31","1","0","2","2","0","2","38","7","15","11","0","33","13","7","18","0","38","11","9","16","0","2","38"
"Lincoln","39.04084","-98.14477","31","1","0","2","2","0","2","38","7","15","11","0","33","13","7","18","0","38","11","9","16","0","2","38"
"Lincoln","40.8","-96.66696","31","1","0","2","2","0","2","38","7","15","11","0","33","13","7","18","0","38","11","9","16","0","2","38"
"Lincoln","35.94953","-94.42355","31","1","0","2","2","0","2","38","7","15","11","0","33","13","7","18","0","38","11","9","16","0","2","38"
"Lincoln","38.39086","-93.33465","31","1","0","2","2","0","2","38","7","15","11","0","33","13","7","18","0","38","11","9","16","0","2","38"
"Lincoln","40.14838","-89.36482","31","1","0","2","2","0","2","38","7","15","11","0","33","13","7","18","0","38","11","9","16","0","2","38"
"Lincoln","33.61316","-86.11831","31","1","0","2","2","0","2","38","7","15","11","0","33","13","7","18","0","38","11","9","16","0","2","38"
"Lincoln","40.31896","-79.85477","31","1","0","2","2","0","2","38","7","15","11","0","33","13","7","18","0","38","11","9","16","0","2","38"
"Lincoln","44.10589","-72.99706","31","1","0","2","2","0","2","38","7","15","11","0","33","13","7","18","0","38","11","9","16","0","2","38"
"Lincoln","44.04562","-71.67008","31","1","0","2","2","0","2","38","7","15","11","0","33","13","7","18","0","38","11","9","16","0","2","38"
"Lincoln","41.92111","-71.435","31","1","0","2","2","0","2","38","7","15","11","0","33","13","7","18","0","38","11","9","16","0","2","38"
"Lincoln","42.42593","-71.30395","31","1","0","2","2","0","2","38","7","15","11","0","33","13","7","18","0","38","11","9","16","0","2","38"
"Lincoln","45.36228","-68.50502","31","1","0","2","2","0","2","38","7","15","11","0","33","13","7","18","0","38","11","9","16","0","2","38"
"Lincoln","45.90012","-66.58218","31","1","0","2","2","0","2","38","7","15","11","0","33","13","7","18","0","38","11","9","16","0","2","38"
"Lincoln","-34.86649","-61.5302","31","1","0","2","2","0","2","38","7","15","11","0","33","13","7","18","0","38","11","9","16","0","2","38"
"Lincoln","53.22683","-0.53792","31","1","0","2","2","0","2","38","7","15","11","0","33","13","7","18","0","38","11","9","16","0","2","38"
"Lincoln","-43.65","172.48333","31","1","0","2","2","0","2","38","7","15","11","0","33","13","7","18","0","38","11","9","16","0","2","38"
"Lingen","52.3","-2.93333","1","0","0","0","0","0","0","1","0","1","0","0","1","0","1","0","0","1","0","0","1","0","0","1"
"Lingen","52.52143","7.31845","1","0","0","0","0","0","0","1","0","1","0","0","1","0","1","0","0","1","0","0","1","0","0","1"
"Lingfield","51.17719","-0.01558","1","0","0","0","0","0","0","1","0","0","1","0","1","1","0","0","0","1","0","0","1","0","0","1"
"Linköping","58.41086","15.62157","2","0","0","0","0","0","0","2","0","0","1","1","2","1","0","1","0","2","0","0","1","0","1","2"
"Linlithgow","55.97639","-3.60364","2","1","0","0","0","0","1","4","1","1","2","0","4","3","1","0","0","4","0","2","2","0","0","4"
"Linwood","43.58171","-80.72815","0","1","0","0","0","0","0","1","0","0","1","0","1","0","0","1","0","1","0","0","1","0","0","1"
"Linwood","39.8265","-75.42547","0","1","0","0","0","0","0","1","0","0","1","0","1","0","0","1","0","1","0","0","1","0","0","1"
"Linwood","39.33984","-74.57516","0","1","0","0","0","0","0","1","0","0","1","0","1","0","0","1","0","1","0","0","1","0","0","1"
"Linwood","55.84834","-4.49337","0","1","0","0","0","0","0","1","0","0","1","0","1","0","0","1","0","1","0","0","1","0","0","1"
"Linz","48.30639","14.28611","1","0","0","0","0","0","0","1","0","1","0","0","1","1","0","0","0","1","1","0","0","0","0","1"
"Liopétri","35.00885","33.89256","1","0","0","0","0","0","0","1","0","0","0","0","0","0","1","0","0","1","0","0","1","0","0","1"
"Lipa City","13.9411","121.1631","0","0","0","0","1","0","0","1","0","0","0","0","0","0","1","0","0","1","0","0","1","0","0","1"
"Liphook","51.07673","-0.8032","2","1","0","0","0","0","1","4","3","0","0","0","3","1","2","1","0","4","0","2","1","0","1","4"
"Lisbon","46.44163","-97.68121","14","0","0","1","0","0","0","15","5","4","2","1","12","5","5","5","0","15","8","1","6","0","0","15"
"Lisbon","41.92112","-91.38545","14","0","0","1","0","0","0","15","5","4","2","1","12","5","5","5","0","15","8","1","6","0","0","15"
"Lisbon","39.86089","-83.6352","14","0","0","1","0","0","0","15","5","4","2","1","12","5","5","5","0","15","8","1","6","0","0","15"
"Lisbon","40.772","-80.76813","14","0","0","1","0","0","0","15","5","4","2","1","12","5","5","5","0","15","8","1","6","0","0","15"
"Lisbon","41.60399","-72.01174","14","0","0","1","0","0","0","15","5","4","2","1","12","5","5","5","0","15","8","1","6","0","0","15"
"Lisbon","44.2134","-71.91092","14","0","0","1","0","0","0","15","5","4","2","1","12","5","5","5","0","15","8","1","6","0","0","15"
"Lisbon","44.03146","-70.1045","14","0","0","1","0","0","0","15","5","4","2","1","12","5","5","5","0","15","8","1","6","0","0","15"
"Lisbon","38.71667","-9.13333","14","0","0","1","0","0","0","15","5","4","2","1","12","5","5","5","0","15","8","1","6","0","0","15"
"Lisburn","54.52337","-6.03527","6","0","0","0","0","0","1","7","0","2","3","1","6","0","1","6","0","7","1","3","3","0","0","7"
"Liskeard","50.4545","-4.46517","4","0","0","1","0","0","0","5","2","1","1","1","5","1","0","4","0","5","0","4","1","0","0","5"
"Liss","51.04277","-0.89238","1","0","0","0","1","0","1","3","1","0","1","0","2","2","0","1","0","3","0","1","2","0","0","3"
"Litchfield Park","33.49337","-112.35794","1","0","0","0","0","0","0","1","1","0","0","0","1","1","0","0","0","1","0","1","0","0","0","1"
"Lit-et-Mixe","44.03242","-1.25687","1","0","0","0","0","0","0","1","0","0","0","1","1","0","0","1","0","1","1","0","0","0","0","1"
"Litherland","53.46993","-2.99809","0","1","0","0","0","0","0","1","0","0","1","0","1","0","0","1","0","1","0","0","1","0","0","1"
"Littlehampton","50.81137","-0.54078","2","0","0","0","0","0","1","3","1","0","3","0","4","1","0","3","0","4","0","3","1","0","0","4"
"Little Rock","47.86801","-95.11055","1","0","0","0","0","0","0","1","0","1","0","0","1","1","0","0","0","1","1","0","0","0","0","1"
"Little Rock","34.74648","-92.28959","1","0","0","0","0","0","0","1","0","1","0","0","1","1","0","0","0","1","1","0","0","0","0","1"
"Littleton","39.61332","-105.01665","2","0","0","0","0","0","0","2","0","0","1","0","1","1","0","1","0","2","0","0","2","0","0","2"
"Littleton","36.43459","-77.91193","2","0","0","0","0","0","0","2","0","0","1","0","1","1","0","1","0","2","0","0","2","0","0","2"
"Littleton","44.30617","-71.77009","2","0","0","0","0","0","0","2","0","0","1","0","1","1","0","1","0","2","0","0","2","0","0","2"
"Littleton","46.23088","-67.84113","2","0","0","0","0","0","0","2","0","0","1","0","1","1","0","1","0","2","0","0","2","0","0","2"
"Littleton","-33.49571","150.13993","2","0","0","0","0","0","0","2","0","0","1","0","1","1","0","1","0","2","0","0","2","0","0","2"
"Livermore","37.68187","-121.76801","1","0","0","0","0","0","0","1","0","1","0","0","1","0","1","0","0","1","1","0","0","0","0","1"
"Livermore","37.4931","-87.13194","1","0","0","0","0","0","0","1","0","1","0","0","1","0","1","0","0","1","1","0","0","0","0","1"
"Livermore","44.38396","-70.24922","1","0","0","0","0","0","0","1","0","1","0","0","1","0","1","0","0","1","1","0","0","0","0","1"
"Liverpool","29.29496","-95.27882","120","8","0","9","14","0","8","159","25","41","48","5","119","68","19","68","3","158","32","40","79","1","6","158"
"Liverpool","40.57481","-76.98915","120","8","0","9","14","0","8","159","25","41","48","5","119","68","19","68","3","158","32","40","79","1","6","158"
"Liverpool","43.10646","-76.2177","120","8","0","9","14","0","8","159","25","41","48","5","119","68","19","68","3","158","32","40","79","1","6","158"
"Liverpool","53.41058","-2.97794","120","8","0","9","14","0","8","159","25","41","48","5","119","68","19","68","3","158","32","40","79","1","6","158"
"Liverpool","-33.91938","150.92588","120","8","0","9","14","0","8","159","25","41","48","5","119","68","19","68","3","158","32","40","79","1","6","158"
"Liversedge","53.70514","-1.69327","2","0","0","1","0","0","0","3","0","0","3","0","3","2","0","1","0","3","2","1","0","0","0","3"
"Livingston","37.38688","-120.72353","3","0","0","0","2","0","0","5","1","1","1","0","3","1","1","3","0","5","1","0","4","0","0","5"
"Livingston","45.66244","-110.56104","3","0","0","0","2","0","0","5","1","1","1","0","3","1","1","3","0","5","1","0","4","0","0","5"
"Livingston","30.71103","-94.93299","3","0","0","0","2","0","0","5","1","1","1","0","3","1","1","3","0","5","1","0","4","0","0","5"
"Livingston","30.50213","-90.74787","3","0","0","0","2","0","0","5","1","1","1","0","3","1","1","3","0","5","1","0","4","0","0","5"
"Livingston","42.89999","-90.43096","3","0","0","0","2","0","0","5","1","1","1","0","3","1","1","3","0","5","1","0","4","0","0","5"
"Livingston","38.96755","-89.76398","3","0","0","0","2","0","0","5","1","1","1","0","3","1","1","3","0","5","1","0","4","0","0","5"
"Livingston","32.5843","-88.18725","3","0","0","0","2","0","0","5","1","1","1","0","3","1","1","3","0","5","1","0","4","0","0","5"
"Livingston","36.3834","-85.32302","3","0","0","0","2","0","0","5","1","1","1","0","3","1","1","3","0","5","1","0","4","0","0","5"
"Livingston","40.79593","-74.31487","3","0","0","0","2","0","0","5","1","1","1","0","3","1","1","3","0","5","1","0","4","0","0","5"
"Livingston","55.90288","-3.52261","3","0","0","0","2","0","0","5","1","1","1","0","3","1","1","3","0","5","1","0","4","0","0","5"
"Livingstone","-17.84194","25.85425","2","0","0","0","0","0","0","2","0","1","1","0","2","1","0","0","0","1","0","0","0","0","2","2"
"Livno","43.82695","17.00746","1","0","0","0","0","0","0","1","0","0","0","0","0","0","0","1","0","1","1","0","0","0","0","1"
"Livonia","30.55908","-91.55594","2","0","0","0","0","0","0","2","0","0","0","0","0","1","0","1","0","2","0","1","1","0","0","2"
"Livonia","42.36837","-83.35271","2","0","0","0","0","0","0","2","0","0","0","0","0","1","0","1","0","2","0","1","1","0","0","2"
"Livonia","42.82145","-77.66861","2","0","0","0","0","0","0","2","0","0","0","0","0","1","0","1","0","2","0","1","1","0","0","2"
"Livorno","43.54427","10.32615","1","0","0","0","0","0","0","1","0","0","0","0","0","0","0","1","0","1","0","0","1","0","0","1"
"Ljubljana","46.05108","14.50513","9","0","0","0","0","0","0","9","1","3","1","0","5","2","3","4","0","9","1","0","4","0","4","9"
"Llanberis","53.11809","-4.12923","1","0","0","0","0","0","0","1","0","1","0","0","1","0","0","1","0","1","1","0","0","0","0","1"
"Llanboidy","51.87889","-4.59278","1","0","0","0","0","0","0","1","0","0","0","0","0","0","0","1","0","1","0","1","0","0","0","1"
"Llanbradach","51.60639","-3.23028","0","0","0","0","0","0","0","0","0","0","0","0","0","0","0","0","0","0","0","0","0","0","0","0"
"Llandovery","51.99415","-3.79637","1","0","0","0","0","0","0","1","0","0","1","0","1","0","0","1","0","1","0","0","1","0","0","1"
"Llandrindod Wells","52.24164","-3.37868","4","0","0","0","1","0","0","5","1","1","3","0","5","2","1","2","0","5","1","0","4","0","0","5"
"Llandudno","53.32498","-3.83148","4","1","0","0","0","0","0","5","2","1","1","0","4","2","0","3","0","5","1","2","2","0","0","5"
"Llandybie","51.82044","-4.0071","1","0","0","0","0","0","0","1","0","0","0","0","0","0","0","1","0","1","0","0","1","0","0","1"
"Llandysul","52.04166","-4.30909","3","0","0","0","0","0","0","3","0","0","3","0","3","3","0","0","0","3","1","1","1","0","0","3"
"Llanelli","51.68195","-4.16191","18","1","0","3","5","0","2","29","6","12","7","1","26","14","4","10","1","29","10","6","11","0","1","28"
"Llangattock","51.85184","-3.14778","1","0","0","0","0","0","0","1","1","0","0","0","1","1","0","0","0","1","0","0","1","0","0","1"
"Llangefni","53.25561","-4.31063","1","0","0","0","0","0","0","1","0","0","1","0","1","1","0","0","0","1","0","0","1","0","0","1"
"Llangollen","52.96829","-3.17127","0","0","0","1","1","0","0","2","1","0","1","0","2","1","0","1","0","2","0","0","2","0","0","2"
"Llangwm","51.74833","-4.91361","2","0","0","0","0","0","0","2","0","0","2","0","2","0","0","2","0","2","0","2","0","0","0","2"
"Llangwm","52.98333","-3.53333","2","0","0","0","0","0","0","2","0","0","2","0","2","0","0","2","0","2","0","2","0","0","0","2"
"Llangwm","51.69611","-2.83","2","0","0","0","0","0","0","2","0","0","2","0","2","0","0","2","0","2","0","2","0","0","0","2"
"Llanrhaeadr-ym-Mochnant","52.82507","-3.30225","1","0","0","0","0","0","0","1","0","0","1","0","1","0","0","1","0","1","0","1","0","0","0","1"
"Llantrisant","51.54028","-3.37389","1","0","0","0","0","0","0","1","0","0","1","0","1","0","0","1","0","1","0","0","1","0","0","1"
"Llantwit Fardre","51.5546","-3.33241","1","0","0","0","0","0","0","1","0","1","0","0","1","0","0","1","0","1","1","0","0","0","0","1"
"Llantwit Major","51.4107","-3.48632","3","0","0","0","0","0","0","3","1","0","2","0","3","1","1","1","0","3","0","1","2","0","0","3"
"Lleida","41.61674","0.62218","1","0","0","0","0","0","0","1","0","0","0","0","0","0","1","0","0","1","0","0","1","0","0","1"
"Loans","55.5504","-4.6241","0","0","0","0","0","0","1","1","0","0","0","0","0","1","0","0","0","1","0","1","0","0","0","1"
"Lochgilphead","56.03796","-5.43206","1","0","0","0","0","0","0","1","0","0","1","0","1","0","0","1","0","1","0","0","1","0","0","1"
"Lochwinnoch","55.79521","-4.63034","1","0","0","0","0","0","0","1","1","0","0","0","1","0","0","1","0","1","0","1","0","0","0","1"
"Lockerbie","55.12302","-3.35635","2","0","0","0","0","0","0","2","0","0","2","0","2","0","0","2","0","2","0","1","1","0","0","2"
"Locust Grove","36.20009","-95.16774","1","0","0","0","0","0","0","1","0","0","1","0","1","1","0","0","0","1","0","0","1","0","0","1"
"Locust Grove","33.34595","-84.10908","1","0","0","0","0","0","0","1","0","0","1","0","1","1","0","0","0","1","0","0","1","0","0","1"
"Loddington","52.39734","-0.80174","1","0","0","0","0","0","0","1","0","1","0","0","1","0","0","1","0","1","0","0","1","0","0","1"
"Lodhran","29.5339","71.63244","1","0","0","0","0","0","0","1","1","0","0","0","1","0","1","0","0","1","0","0","1","0","0","1"
"Lodwar","3.11988","35.59642","2","0","0","0","0","0","0","2","0","1","0","0","1","0","2","0","0","2","1","0","0","0","1","2"
"Łódź","51.77058","19.47395","2","0","0","0","0","0","0","2","1","1","0","0","2","0","1","1","0","2","2","0","0","0","0","2"
"Loftus","54.55543","-0.89459","1","0","0","0","0","0","0","1","0","0","0","0","0","0","1","0","0","1","0","0","0","0","1","1"
"Loftus","-34.04467","151.04646","1","0","0","0","0","0","0","1","0","0","0","0","0","0","1","0","0","1","0","0","0","0","1","1"
"Logan City","-27.63917","153.10944","1","0","0","0","0","0","0","1","0","0","0","0","0","0","1","0","0","1","0","1","0","0","0","1"
"Loja","-3.99313","-79.20422","1","0","0","0","0","0","0","1","0","0","1","0","1","0","0","1","0","1","0","0","1","0","0","1"
"Loja","37.16887","-4.15129","1","0","0","0","0","0","0","1","0","0","1","0","1","0","0","1","0","1","0","0","1","0","0","1"
"Loja","57.15336","24.6433","1","0","0","0","0","0","0","1","0","0","1","0","1","0","0","1","0","1","0","0","1","0","0","1"
"Lokoja","7.79688","6.74048","4","0","0","0","0","0","0","4","1","0","0","1","2","0","1","2","1","4","0","1","1","0","2","4"
"Lomé","6.12874","1.22154","1","0","0","0","0","0","0","1","0","0","0","1","1","1","0","0","0","1","0","0","1","0","0","1"
"Londesborough","53.88333","-0.68333","1","0","0","1","0","0","0","2","1","0","0","0","1","1","0","1","0","2","0","1","1","0","0","2"
"London","36.47606","-119.44318","1980","117","6","197","197","3","265","2765","674","429","747","33","1883","1044","350","1360","12","2766","199","434","1950","82","99","2764"
"London","35.32897","-93.25296","1980","117","6","197","197","3","265","2765","674","429","747","33","1883","1044","350","1360","12","2766","199","434","1950","82","99","2764"
"London","37.12898","-84.08326","1980","117","6","197","197","3","265","2765","674","429","747","33","1883","1044","350","1360","12","2766","199","434","1950","82","99","2764"
"London","39.88645","-83.44825","1980","117","6","197","197","3","265","2765","674","429","747","33","1883","1044","350","1360","12","2766","199","434","1950","82","99","2764"
"London","42.98339","-81.23304","1980","117","6","197","197","3","265","2765","674","429","747","33","1883","1044","350","1360","12","2766","199","434","1950","82","99","2764"
"London","51.50853","-0.12574","1980","117","6","197","197","3","265","2765","674","429","747","33","1883","1044","350","1360","12","2766","199","434","1950","82","99","2764"
"Londonderry County Borough","54.99721","-7.30917","16","1","0","4","2","0","0","23","7","3","8","0","18","10","2","11","0","23","3","8","11","0","1","23"
"Long Beach","46.35232","-124.05432","1","0","0","0","0","0","0","1","0","0","1","0","1","0","0","1","0","1","0","0","1","0","0","1"
"Long Beach","33.76696","-118.18923","1","0","0","0","0","0","0","1","0","0","1","0","1","0","0","1","0","1","0","0","1","0","0","1"
"Long Beach","30.35048","-89.15282","1","0","0","0","0","0","0","1","0","0","1","0","1","0","0","1","0","1","0","0","1","0","0","1"
"Long Beach","41.73893","-86.85697","1","0","0","0","0","0","0","1","0","0","1","0","1","0","0","1","0","1","0","0","1","0","0","1"
"Long Beach","33.91045","-78.11777","1","0","0","0","0","0","0","1","0","0","1","0","1","0","0","1","0","1","0","0","1","0","0","1"
"Long Beach","38.46096","-76.46884","1","0","0","0","0","0","0","1","0","0","1","0","1","0","0","1","0","1","0","0","1","0","0","1"
"Long Beach","40.58844","-73.65791","1","0","0","0","0","0","0","1","0","0","1","0","1","0","0","1","0","1","0","0","1","0","0","1"
"Long Beach","-35.70833","150.24483","1","0","0","0","0","0","0","1","0","0","1","0","1","0","0","1","0","1","0","0","1","0","0","1"
"Long Bennington","52.99314","-0.75803","1","0","0","0","0","0","0","1","0","1","0","0","1","0","0","1","0","1","0","0","1","0","0","1"
"Long Clawson","52.83725","-0.9288","1","0","0","0","0","0","0","1","0","1","0","0","1","1","0","0","0","1","0","0","1","0","0","1"
"Long Crendon","51.77294","-0.99684","2","0","0","0","0","0","0","2","0","1","1","0","2","0","1","1","0","2","1","0","1","0","0","2"
"Long Eaton","52.89855","-1.27136","4","0","0","0","0","0","0","4","0","3","1","0","4","0","4","0","0","4","1","0","1","0","2","4"
"Longfield","51.3969","0.30212","2","0","0","1","1","0","0","4","2","1","1","0","4","1","0","3","0","4","0","0","4","0","0","4"
"Longford","53.72536","-7.79823","1","0","0","0","0","0","0","1","0","0","0","0","0","1","0","0","0","1","1","0","0","0","0","1"
"Longford","-38.16237","147.08591","1","0","0","0","0","0","0","1","0","0","0","0","0","1","0","0","0","1","1","0","0","0","0","1"
"Longford","-41.60512","147.11887","1","0","0","0","0","0","0","1","0","0","0","0","0","1","0","0","0","1","1","0","0","0","0","1"
"Long Island City","40.74482","-73.94875","1","0","0","0","0","0","0","1","0","0","0","0","0","0","0","1","0","1","0","0","1","0","0","1"
"Long Xuyên","10.38639","105.43518","0","0","0","0","0","0","0","0","0","0","0","0","0","0","0","0","0","0","0","0","0","0","1","1"
"Looe","50.35778","-4.45418","2","0","0","0","0","0","0","2","0","1","1","0","2","1","0","1","0","2","0","1","1","0","0","2"
"Loralai","30.37051","68.59795","2","0","0","0","0","0","0","2","1","0","0","1","2","1","1","0","0","2","0","0","2","0","0","2"
"Los Altos","37.38522","-122.11413","1","0","0","0","0","0","0","1","0","0","1","0","1","0","0","1","0","1","0","0","1","0","0","1"
"Los Altos","21.50976","-97.75705","1","0","0","0","0","0","0","1","0","0","1","0","1","0","0","1","0","1","0","0","1","0","0","1"
"Los Altos","19.4462","-97.20218","1","0","0","0","0","0","0","1","0","0","1","0","1","0","0","1","0","1","0","0","1","0","0","1"
"Los Altos","-28.04845","-65.49945","1","0","0","0","0","0","0","1","0","0","1","0","1","0","0","1","0","1","0","0","1","0","0","1"
"Los Angeles","34.05223","-118.24368","8","0","0","0","0","0","0","8","1","2","2","0","5","2","2","4","0","8","1","0","7","0","0","8"
"Los Angeles","25.60289","-108.48095","8","0","0","0","0","0","0","8","1","2","2","0","5","2","2","4","0","8","1","0","7","0","0","8"
"Los Angeles","25.52206","-103.56757","8","0","0","0","0","0","0","8","1","2","2","0","5","2","2","4","0","8","1","0","7","0","0","8"
"Los Angeles","9.0125","125.60806","8","0","0","0","0","0","0","8","1","2","2","0","5","2","2","4","0","8","1","0","7","0","0","8"
"Losap","6.894","152.74","1","0","0","0","0","0","0","1","0","1","0","0","1","1","0","0","0","1","1","0","0","0","0","1"
"Lossiemouth","57.72136","-3.28341","1","0","0","0","0","0","1","2","0","1","1","0","2","0","1","1","0","2","1","0","1","0","0","2"
"Loughborough","52.76667","-1.2","18","2","0","0","4","0","0","24","10","3","5","0","18","11","0","13","0","24","1","4","19","0","0","24"
"Loughton","52.03037","-0.78642","5","0","0","0","0","0","1","6","1","1","2","0","4","2","1","3","0","6","0","0","5","0","0","5"
"Louisville","39.97776","-105.13193","2","0","0","0","0","0","0","2","0","0","1","0","1","2","1","0","0","3","1","1","1","0","0","3"
"Louisville","40.99778","-96.16224","2","0","0","0","0","0","0","2","0","0","1","0","1","2","1","0","0","3","1","1","1","0","0","3"
"Louisville","33.12374","-89.05506","2","0","0","0","0","0","0","2","0","0","1","0","1","2","1","0","0","3","1","1","1","0","0","3"
"Louisville","38.77227","-88.50255","2","0","0","0","0","0","0","2","0","0","1","0","1","2","1","0","0","3","1","1","1","0","0","3"
"Louisville","38.25424","-85.75941","2","0","0","0","0","0","0","2","0","0","1","0","1","2","1","0","0","3","1","1","1","0","0","3"
"Louisville","35.82175","-84.04796","2","0","0","0","0","0","0","2","0","0","1","0","1","2","1","0","0","3","1","1","1","0","0","3"
"Louisville","33.00154","-82.41124","2","0","0","0","0","0","0","2","0","0","1","0","1","2","1","0","0","3","1","1","1","0","0","3"
"Louisville","40.83728","-81.25955","2","0","0","0","0","0","0","2","0","0","1","0","1","2","1","0","0","3","1","1","1","0","0","3"
"Lousada","41.27822","-8.27993","1","0","0","0","0","0","0","1","0","0","0","0","0","0","0","1","0","1","1","0","0","0","0","1"
"Louth","53.94861","-6.54139","4","0","0","0","0","0","0","4","0","0","3","0","3","1","0","3","0","4","0","3","1","0","0","4"
"Louth","53.36664","-0.00438","4","0","0","0","0","0","0","4","0","0","3","0","3","1","0","3","0","4","0","3","1","0","0","4"
"Lower Hutt","-41.21667","174.91667","5","0","0","0","0","0","0","5","1","0","2","0","3","0","0","5","0","5","0","0","5","0","0","5"
"Lowestoft","52.47523","1.75167","4","0","0","0","0","0","0","4","0","2","1","0","3","3","1","0","0","4","2","1","1","0","0","4"
"Loxwood","51.07781","-0.51872","0","0","0","0","1","0","0","1","0","0","1","0","1","0","0","1","0","1","0","0","1","0","0","1"
"Luanda","-8.83682","13.23432","7","0","0","0","0","0","0","7","1","2","3","0","6","3","2","2","0","7","2","2","2","0","0","6"
"Luanda","0.31354","34.07146","7","0","0","0","0","0","0","7","1","2","3","0","6","3","2","2","0","7","2","2","2","0","0","6"
"Luang Prabang","19.88601","102.13503","0","0","0","1","0","0","0","1","0","1","0","0","1","1","0","0","0","1","0","0","0","0","1","1"
"Luangwa","-15.61667","30.41667","1","0","0","0","0","0","0","1","0","1","0","0","1","0","0","1","0","1","0","0","1","0","0","1"
"Luanshya","-13.13667","28.41661","1","0","0","0","0","0","0","1","0","0","0","0","0","1","0","0","0","1","0","0","1","0","0","1"
"Lubbock","33.57786","-101.85517","2","0","0","0","0","0","0","2","1","0","1","0","2","1","0","1","0","2","1","0","1","0","0","2"
"Lublin","51.25","22.56667","2","0","0","0","0","0","0","2","0","0","1","0","1","1","0","1","0","2","0","0","2","0","0","2"
"Lubumbashi","-11.66089","27.47938","4","0","0","0","0","0","0","4","1","2","0","1","4","1","2","0","1","4","2","0","0","0","1","3"
"Lucas","33.08429","-96.57666","1","0","0","0","0","0","0","1","1","0","0","0","1","0","0","1","0","1","1","0","0","0","0","1"
"Lucas","40.70506","-82.41822","1","0","0","0","0","0","0","1","1","0","0","0","1","0","0","1","0","1","1","0","0","0","0","1"
"Lucas","-16.33333","-55.93333","1","0","0","0","0","0","0","1","1","0","0","0","1","0","0","1","0","1","1","0","0","0","0","1"
"Lucas","-37.54572","143.7758","1","0","0","0","0","0","0","1","1","0","0","0","1","0","0","1","0","1","1","0","0","0","0","1"
"Lucca","43.84369","10.50447","1","0","0","0","0","0","0","1","0","0","0","0","0","0","1","0","0","1","1","0","0","0","0","1"
"Lucknow","26.83928","80.92313","14","0","0","0","0","0","0","14","10","2","1","0","13","4","2","7","1","14","2","1","8","0","3","14"
"Lucknow","-37.81667","147.65","14","0","0","0","0","0","0","14","10","2","1","0","13","4","2","7","1","14","2","1","8","0","3","14"
"Luddenden Foot","53.71873","-1.94582","1","0","0","0","0","0","0","1","1","0","0","0","1","1","0","0","0","1","0","1","0","0","0","1"
"Ludhiāna","30.91204","75.85379","6","1","0","0","1","0","0","8","3","0","2","1","6","3","0","5","0","8","1","0","4","0","3","8"
"Ludlow","39.09256","-84.54744","4","0","0","0","0","0","0","4","0","3","1","0","4","1","1","2","0","4","2","1","1","0","0","4"
"Ludlow","43.39591","-72.70065","4","0","0","0","0","0","0","4","0","3","1","0","4","1","1","2","0","4","2","1","1","0","0","4"
"Ludlow","42.16009","-72.47592","4","0","0","0","0","0","0","4","0","3","1","0","4","1","1","2","0","4","2","1","1","0","0","4"
"Ludlow","52.37431","-2.71311","4","0","0","0","0","0","0","4","0","3","1","0","4","1","1","2","0","4","2","1","1","0","0","4"
"Luganville","-15.51989","167.16235","1","0","0","0","0","0","0","1","0","0","0","0","0","1","0","0","0","1","0","0","0","0","0","0"
"Lukavac","44.54245","18.52618","1","0","0","0","0","0","0","1","0","0","0","0","0","0","1","0","0","1","1","0","0","0","0","1"
"Lukulu","-14.37067","23.24196","1","0","0","0","0","0","0","1","1","0","0","0","1","1","0","0","0","1","0","1","0","0","0","1"
"Lund","53.9192","-0.52211","2","0","0","0","0","0","0","2","0","0","0","0","0","1","1","0","0","2","0","0","0","0","2","2"
"Lund","55.70584","13.19321","2","0","0","0","0","0","0","2","0","0","0","0","0","1","1","0","0","2","0","0","0","0","2","2"
"Lundin Links","56.21399","-2.95173","0","0","0","0","0","0","1","1","0","1","0","0","1","0","0","1","0","1","0","0","1","0","0","1"
"Lüneburg","53.2509","10.41409","1","0","0","0","0","0","0","1","0","0","0","0","0","0","1","0","0","1","0","0","1","0","0","1"
"Lunglei","22.89247","92.74218","1","0","0","0","0","0","0","1","1","0","0","0","1","0","1","0","0","1","0","0","1","0","0","1"
"Lunsar","8.68439","-12.53499","1","0","0","0","0","0","0","1","1","0","0","0","1","1","0","0","0","1","0","0","1","0","0","1"
"Lusaka","-15.40669","28.28713","32","1","0","2","1","0","0","36","4","13","9","4","30","18","7","10","1","36","7","4","18","4","3","36"
"Lushnjë","40.94194","19.705","0","1","0","0","1","0","0","2","2","0","0","0","2","1","1","0","0","2","0","0","2","0","0","2"
"Lutín","49.55845","17.13572","0","0","0","0","1","0","0","1","1","0","0","0","1","0","0","1","0","1","0","0","1","0","0","1"
"Luton","51.87967","-0.41748","25","0","0","1","2","0","0","28","3","5","12","1","21","8","6","13","0","27","3","7","16","2","0","28"
"Lutsk","50.75932","25.34244","3","0","0","0","0","0","0","3","0","1","0","0","1","0","2","1","0","3","1","0","1","0","1","3"
"Lutterworth","52.45634","-1.20218","2","0","0","0","0","0","1","3","0","1","1","0","2","1","0","2","0","3","0","2","1","0","0","3"
"Luuq","3.80315","42.54417","2","0","0","0","0","0","0","2","0","1","0","1","2","2","0","0","0","2","1","0","1","0","0","2"
"Luwingu","-10.2621","29.92712","1","0","0","0","0","0","0","1","0","0","1","0","1","1","0","0","0","1","0","0","1","0","0","1"
"Luxor","25.69893","32.6421","2","2","0","0","0","0","2","6","3","0","0","0","3","3","2","1","0","6","2","2","2","0","0","6"
"Luzern","47.05048","8.30635","1","0","0","0","0","0","0","1","0","0","0","0","0","0","0","1","0","1","0","0","1","0","0","1"
"Lviv","49.83826","24.02324","8","1","0","1","1","0","0","11","1","3","1","1","6","4","3","3","1","11","4","2","4","0","1","11"
"Lydbrook","51.83763","-2.57818","1","0","0","0","0","0","0","1","0","0","1","0","1","0","0","1","0","1","0","1","0","0","0","1"
"Lydd","50.95132","0.90654","2","0","0","0","0","0","0","2","0","0","2","0","2","0","1","1","0","2","0","2","0","0","0","2"
"Lydney","51.72598","-2.52605","3","0","0","0","1","0","0","4","1","0","2","0","3","1","0","3","0","4","0","1","3","0","0","4"
"Lymington","50.75767","-1.5443","5","0","0","0","0","0","0","5","1","2","1","0","4","2","1","2","0","5","2","1","2","0","0","5"
"Lymm","53.38105","-2.47763","1","0","0","0","0","0","1","2","1","0","1","0","2","1","0","1","0","2","0","0","2","0","0","2"
"Lympstone","50.64751","-3.43162","2","0","0","0","0","0","0","2","0","1","1","0","2","1","1","0","0","2","0","0","0","1","1","2"
"Lyndhurst","41.52005","-81.48873","1","0","0","0","0","0","0","1","0","0","1","0","1","0","0","1","0","1","0","0","1","0","0","1"
"Lyndhurst","38.0293","-78.94502","1","0","0","0","0","0","0","1","0","0","1","0","1","0","0","1","0","1","0","0","1","0","0","1"
"Lyndhurst","40.81204","-74.12431","1","0","0","0","0","0","0","1","0","0","1","0","1","0","0","1","0","1","0","0","1","0","0","1"
"Lyndhurst","50.87259","-1.57662","1","0","0","0","0","0","0","1","0","0","1","0","1","0","0","1","0","1","0","0","1","0","0","1"
"Lytham St Annes","53.7426","-2.997","8","0","0","1","1","0","1","11","2","7","1","0","10","3","1","7","0","11","2","2","7","0","0","11"
"maalot Tarshīhā","33.01667","35.26667","1","0","0","0","0","0","0","1","1","0","0","0","1","0","0","1","0","1","0","1","0","0","0","1"
"Maasmechelen","50.96545","5.69452","1","0","0","0","0","0","0","1","0","0","0","0","0","0","1","0","0","1","1","0","0","0","0","1"
"Maastricht","50.84833","5.68889","1","0","0","0","0","0","0","1","0","0","0","0","0","0","1","0","0","1","1","0","0","0","0","1"
"Mabalacat City","15.22303","120.57117","1","0","0","0","0","0","0","1","0","0","1","0","1","1","0","0","0","1","0","0","1","0","0","1"
"Mablethorpe","53.3409","0.26102","1","0","0","0","0","0","0","1","0","1","0","0","1","1","0","0","0","1","1","0","0","0","0","1"
"Mableton","33.81872","-84.58243","2","0","0","0","0","0","0","2","0","2","0","0","2","0","0","2","0","2","1","0","1","0","0","2"
"Macas","-2.30868","-78.11135","1","0","0","0","0","0","0","1","0","1","0","0","1","0","1","0","0","1","1","0","0","0","0","1"
"Macau","-5.115","-36.63444","1","0","0","0","0","0","0","1","0","0","0","0","0","0","0","0","1","1","0","0","0","1","0","1"
"Macau","45.0064","-0.61947","1","0","0","0","0","0","0","1","0","0","0","0","0","0","0","0","1","1","0","0","0","1","0","1"
"Macau","22.20056","113.54611","1","0","0","0","0","0","0","1","0","0","0","0","0","0","0","0","1","1","0","0","0","1","0","1"
"Macclesfield","53.26023","-2.12564","8","0","0","0","1","0","1","10","3","3","2","0","8","5","0","4","1","10","1","3","5","0","1","10"
"Macclesfield","-35.17182","138.83589","8","0","0","0","1","0","1","10","3","3","2","0","8","5","0","4","1","10","1","3","5","0","1","10"
"Macclesfield","-37.88333","145.48333","8","0","0","0","1","0","1","10","3","3","2","0","8","5","0","4","1","10","1","3","5","0","1","10"
"Machakos","-1.52233","37.26521","0","0","0","0","1","0","0","1","0","1","0","0","1","1","0","0","0","1","0","0","0","1","0","1"
"Machen","51.59599","-3.1419","1","0","0","0","0","0","0","1","0","1","0","0","1","1","0","0","0","1","1","0","0","0","0","1"
"Macungie","40.51593","-75.55519","1","0","0","0","0","0","0","1","0","0","1","0","1","0","0","1","0","1","0","0","1","0","0","1"
"Mādabā","31.71599","35.79392","1","0","0","0","0","0","0","1","1","0","0","0","1","1","0","0","0","1","0","0","1","0","0","1"
"Mādārīpur","23.17097","90.20935","2","0","0","0","0","0","0","2","0","2","0","0","2","0","2","0","0","2","0","0","0","0","2","2"
"Madhubani","26.35367","86.07169","1","1","0","0","0","0","0","2","2","0","0","0","2","0","0","2","0","2","0","1","1","0","0","2"
"Madīnat Ḩamad","26.11528","50.50694","3","0","0","0","0","0","0","3","1","1","0","0","2","1","1","1","0","3","2","0","1","0","0","3"
"Madīnat ‘Īsá","26.17361","50.54778","2","0","0","0","0","0","0","2","1","0","0","0","1","0","1","0","0","1","0","0","2","0","0","2"
"Madrid","19.08459","-103.87123","20","0","0","0","0","0","3","23","8","2","4","1","15","4","2","17","0","23","9","2","11","0","1","23"
"Madrid","41.87665","-93.82328","20","0","0","0","0","0","3","23","8","2","4","1","15","4","2","17","0","23","9","2","11","0","1","23"
"Madrid","44.75034","-75.13104","20","0","0","0","0","0","3","23","8","2","4","1","15","4","2","17","0","23","9","2","11","0","1","23"
"Madrid","4.73245","-74.26419","20","0","0","0","0","0","3","23","8","2","4","1","15","4","2","17","0","23","9","2","11","0","1","23"
"Madrid","40.4165","-3.70256","20","0","0","0","0","0","3","23","8","2","4","1","15","4","2","17","0","23","9","2","11","0","1","23"
"Madrid","9.26211","125.96437","20","0","0","0","0","0","3","23","8","2","4","1","15","4","2","17","0","23","9","2","11","0","1","23"
"Madurai","9.919","78.11953","4","1","0","0","0","0","0","5","3","0","1","0","4","3","0","2","0","5","0","0","4","1","0","5"
"Maenclochog","51.91183","-4.78754","1","0","0","0","0","0","0","1","1","0","0","0","1","0","0","1","0","1","0","1","0","0","0","1"
"Mae Sot","16.71667","98.56667","1","0","0","0","0","0","0","1","0","0","0","1","1","1","0","0","0","1","1","0","0","0","0","1"
"Maesteg","51.60926","-3.65823","2","0","0","0","0","0","0","2","0","0","1","0","1","1","0","1","0","2","0","1","1","0","0","2"
"Mafeteng","-29.82299","27.23744","1","0","0","0","0","0","0","1","0","1","0","0","1","0","1","0","0","1","0","0","0","0","1","1"
"Mafraq","32.34289","36.20804","2","0","0","0","0","0","0","2","2","0","0","0","2","0","0","2","0","2","1","0","1","0","0","2"
"Magherafelt","54.75356","-6.60656","4","0","0","0","0","0","0","4","2","2","0","0","4","1","1","2","0","4","2","0","2","0","0","4"
"Maglaj","44.54771","18.10003","1","0","0","0","0","0","0","1","0","1","0","0","1","1","0","0","0","1","0","0","1","0","0","1"
"Magura","23.48702","89.41592","2","0","0","0","0","0","0","2","1","0","0","0","1","1","1","0","0","2","0","1","0","0","1","2"
"Magway","20.14956","94.93246","1","0","0","0","0","0","0","1","0","0","0","1","1","1","0","0","0","1","0","0","1","0","0","1"
"Maharagama","6.848","79.9265","2","0","0","0","0","0","0","2","0","0","0","2","2","1","0","0","1","2","0","0","2","0","0","2"
"Mahasthangarh","24.96111","89.34278","1","0","0","0","0","0","0","1","0","0","0","1","1","1","0","0","0","1","0","1","0","0","0","1"
"Mahdia","5.26667","-59.15","2","0","0","0","0","0","0","2","0","1","0","0","1","1","0","1","0","2","0","0","2","0","0","2"
"Mahdia","35.50472","11.06222","2","0","0","0","0","0","0","2","0","1","0","0","1","1","0","1","0","2","0","0","2","0","0","2"
"Mahébourg","-20.40806","57.7","1","0","0","0","0","0","0","1","1","0","0","0","1","0","0","0","1","1","1","0","0","0","0","1"
"Mahendragarh","28.26935","76.15253","1","0","0","0","0","0","0","1","1","0","0","0","1","0","0","1","0","1","0","0","1","0","0","1"
"Mahendranagar","28.96399","80.17715","2","0","0","0","0","0","0","2","0","0","0","1","1","0","1","2","0","3","0","0","2","0","0","2"
"Mahilyow","53.9168","30.3449","1","0","0","0","0","0","0","1","0","0","0","0","0","1","0","0","0","1","0","0","0","1","0","1"
"Mahomet","40.19531","-88.40422","1","0","0","0","0","0","0","1","0","0","0","0","0","0","1","0","0","1","1","0","0","0","0","1"
"Maidenhead","51.52279","-0.71986","27","1","0","3","2","0","2","35","10","8","6","1","25","16","2","17","0","35","3","8","22","0","2","35"
"Maiden Newton","50.77909","-2.57226","1","0","0","0","0","0","0","1","0","0","0","0","0","0","0","1","0","1","0","1","0","0","0","1"
"Maidstone","51.26667","0.51667","46","2","0","2","4","0","1","55","8","17","17","1","43","20","2","33","0","55","10","17","27","0","1","55"
"Maidstone","-37.78035","144.87353","46","2","0","2","4","0","1","55","8","17","17","1","43","20","2","33","0","55","10","17","27","0","1","55"
"Maiduguri","11.84692","13.15712","10","0","0","0","1","0","0","11","2","4","2","1","9","3","5","2","1","11","3","0","4","2","2","11"
"Mainpuri","27.22857","79.02882","0","0","0","1","0","0","0","1","1","0","0","0","1","1","0","0","0","1","0","0","1","0","0","1"
"Mainz","49.98419","8.2791","0","0","0","1","0","0","0","1","0","0","1","0","1","0","0","1","0","1","0","1","0","0","0","1"
"Maisons-Laffitte","48.95264","2.14521","1","0","0","0","0","0","0","1","0","0","0","0","0","0","0","1","0","1","0","0","1","0","0","1"
"Makassar","-5.14861","119.43194","2","0","0","0","0","0","0","2","0","1","0","0","1","1","1","0","0","2","0","0","1","0","1","2"
"Makati City","14.55027","121.03269","3","0","0","0","0","0","1","4","1","2","1","0","4","2","0","2","0","4","0","0","2","0","2","4"
"Makurdi","7.73375","8.52139","1","0","0","0","0","0","0","1","0","1","0","0","1","1","0","0","0","1","1","0","0","0","0","1"
"Malacca","2.196","102.2405","2","0","0","0","1","0","0","3","1","1","1","0","3","1","2","0","0","3","0","0","2","0","1","3"
"Málaga","6.69903","-72.73233","1","0","0","0","0","0","0","1","1","0","0","0","1","0","0","1","0","1","0","0","1","0","0","1"
"Málaga","36.72016","-4.42034","1","0","0","0","0","0","0","1","1","0","0","0","1","0","0","1","0","1","0","0","1","0","0","1"
"Malakal","9.53342","31.66049","1","0","0","0","0","0","0","1","1","0","0","0","1","0","0","0","0","0","1","0","0","0","0","1"
"Malakand","34.56561","71.93043","3","0","0","0","0","0","0","3","1","0","1","0","2","1","1","1","0","3","0","1","0","0","2","3"
"Malaṅgawā","26.85658","85.5594","1","0","0","0","0","0","0","1","0","1","0","0","1","1","0","0","0","1","0","0","1","0","0","1"
"Malappuram","11.04199","76.08154","1","0","0","0","0","0","0","1","1","0","0","0","1","1","0","0","0","1","0","0","1","0","0","1"
"Malatya","38.35018","38.31667","2","1","0","0","0","0","0","3","1","2","0","0","3","1","1","1","0","3","1","1","1","0","0","3"
"Malden","36.557","-89.96648","1","0","0","0","0","0","0","1","0","0","1","0","1","1","0","0","0","1","0","0","1","0","0","1"
"Malden","42.4251","-71.06616","1","0","0","0","0","0","0","1","0","0","1","0","1","1","0","0","0","1","0","0","1","0","0","1"
"Maldon","51.7311","0.67463","2","0","0","0","3","0","0","5","0","3","2","0","5","1","3","1","0","5","2","0","2","1","0","5"
"Maldon","-36.9957","144.06834","2","0","0","0","3","0","0","5","0","3","2","0","5","1","3","1","0","5","2","0","2","1","0","5"
"Male","4.17521","73.50916","3","0","0","0","0","0","0","3","1","1","0","1","3","1","2","0","0","3","2","0","1","0","0","3"
"Malindi","-3.21799","40.11692","0","0","0","0","2","0","0","2","0","1","0","0","1","1","0","0","0","1","0","0","0","0","2","2"
"Malkerns","-26.56667","31.18333","0","0","0","0","2","0","0","2","0","0","0","1","1","0","1","1","0","2","0","0","2","0","0","2"
"Mallawī","27.73264","30.84129","1","0","0","0","0","0","0","1","0","0","0","0","0","1","0","0","0","1","0","1","0","0","0","1"
"Malmesbury","51.58175","-2.09708","7","0","0","0","0","0","1","8","1","2","5","0","8","2","1","5","0","8","0","2","5","0","1","8"
"Malmesbury","-33.4608","18.72714","7","0","0","0","0","0","1","8","1","2","5","0","8","2","1","5","0","8","0","2","5","0","1","8"
"Malmö","55.60587","13.00073","4","0","0","0","0","0","0","4","0","2","2","0","4","2","1","1","0","4","0","0","2","2","0","4"
"Malolos","14.8443","120.81039","1","0","0","0","0","0","0","1","0","0","1","0","1","1","0","0","0","1","0","1","0","0","0","1"
"Malpas","53.01667","-2.76667","3","0","0","0","1","0","0","4","0","1","1","0","2","0","1","3","0","4","1","1","2","0","0","4"
"Malton","54.13695","-0.7996","3","0","0","0","0","0","0","3","0","3","0","0","3","1","1","1","0","3","2","0","1","0","0","3"
"Mamaroneck","40.94871","-73.73263","2","0","0","0","0","0","0","2","0","2","0","0","2","2","0","0","0","2","1","0","1","0","0","2"
"Mamponteng","6.73333","-1.55","1","0","0","0","0","0","0","1","0","1","0","0","1","0","0","0","0","0","0","0","0","0","0","0"
"Mamu Kanjan","30.83044","72.79943","1","0","0","0","0","0","0","1","1","0","0","0","1","0","1","0","0","1","0","0","1","0","0","1"
"Manakau","-40.71667","175.21667","1","0","0","0","0","0","0","1","0","1","0","0","1","1","0","0","0","1","0","0","1","0","0","1"
"Manama","26.22787","50.58565","4","1","0","0","0","0","0","5","1","3","1","0","5","2","1","0","2","5","3","0","2","0","0","5"
"Manaus","-3.10194","-60.025","2","0","0","0","0","0","0","2","0","0","0","1","1","1","1","0","0","2","2","0","0","0","0","2"
"Manby","53.36291","0.09653","1","0","0","0","0","0","0","1","0","0","0","0","0","0","0","1","0","1","0","0","1","0","0","1"
"Manchester","47.55566","-122.54507","167","5","0","10","28","0","13","223","39","74","69","2","184","74","36","111","1","222","52","45","123","1","4","225"
"Manchester","42.48415","-91.45543","167","5","0","10","28","0","13","223","39","74","69","2","184","74","36","111","1","222","52","45","123","1","4","225"
"Manchester","38.597","-90.50929","167","5","0","10","28","0","13","223","39","74","69","2","184","74","36","111","1","222","52","45","123","1","4","225"
"Manchester","43.69054","-89.04845","167","5","0","10","28","0","13","223","39","74","69","2","184","74","36","111","1","222","52","45","123","1","4","225"
"Manchester","35.48174","-86.0886","167","5","0","10","28","0","13","223","39","74","69","2","184","74","36","111","1","222","52","45","123","1","4","225"
"Manchester","32.85985","-84.61993","167","5","0","10","28","0","13","223","39","74","69","2","184","74","36","111","1","222","52","45","123","1","4","225"
"Manchester","42.15032","-84.03772","167","5","0","10","28","0","13","223","39","74","69","2","184","74","36","111","1","222","52","45","123","1","4","225"
"Manchester","37.1537","-83.76186","167","5","0","10","28","0","13","223","39","74","69","2","184","74","36","111","1","222","52","45","123","1","4","225"
"Manchester","38.68813","-83.60936","167","5","0","10","28","0","13","223","39","74","69","2","184","74","36","111","1","222","52","45","123","1","4","225"
"Manchester","40.937","-81.56929","167","5","0","10","28","0","13","223","39","74","69","2","184","74","36","111","1","222","52","45","123","1","4","225"
"Manchester","42.96979","-77.23026","167","5","0","10","28","0","13","223","39","74","69","2","184","74","36","111","1","222","52","45","123","1","4","225"
"Manchester","39.66121","-76.88498","167","5","0","10","28","0","13","223","39","74","69","2","184","74","36","111","1","222","52","45","123","1","4","225"
"Manchester","40.06315","-76.7183","167","5","0","10","28","0","13","223","39","74","69","2","184","74","36","111","1","222","52","45","123","1","4","225"
"Manchester","43.16369","-73.07233","167","5","0","10","28","0","13","223","39","74","69","2","184","74","36","111","1","222","52","45","123","1","4","225"
"Manchester","41.77593","-72.52148","167","5","0","10","28","0","13","223","39","74","69","2","184","74","36","111","1","222","52","45","123","1","4","225"
"Manchester","42.99564","-71.45479","167","5","0","10","28","0","13","223","39","74","69","2","184","74","36","111","1","222","52","45","123","1","4","225"
"Manchester","44.32451","-69.86033","167","5","0","10","28","0","13","223","39","74","69","2","184","74","36","111","1","222","52","45","123","1","4","225"
"Manchester","53.48095","-2.23743","167","5","0","10","28","0","13","223","39","74","69","2","184","74","36","111","1","222","52","45","123","1","4","225"
"Mandalay","21.97473","96.08359","8","1","0","0","0","0","0","9","2","5","0","0","7","4","3","2","0","9","5","0","3","0","1","9"
"Mandaluyong City","14.5832","121.0409","2","1","0","0","0","0","0","3","1","1","1","0","3","1","0","2","0","3","0","1","0","1","1","3"
"Mandaue City","10.32361","123.92222","1","0","0","0","0","0","0","1","0","0","0","0","0","1","0","0","0","1","0","0","1","0","0","1"
"Mandera","3.93726","41.85688","4","0","0","0","0","0","0","4","0","3","0","0","3","3","1","0","0","4","0","0","1","0","3","4"
"Mandeville","30.35825","-90.06563","1","0","0","1","0","0","0","2","1","0","0","0","1","0","1","1","0","2","0","1","1","0","0","2"
"Mandeville","18.04168","-77.50714","1","0","0","1","0","0","0","2","1","0","0","0","1","0","1","1","0","2","0","1","1","0","0","2"
"Mandeville","46.36677","-73.34915","1","0","0","1","0","0","0","2","1","0","0","0","1","0","1","1","0","2","0","1","1","0","0","2"
"Mandi","31.71194","76.93273","1","0","0","0","0","0","0","1","1","0","0","0","1","0","0","1","0","1","0","0","1","0","0","1"
"Mandi Bahauddin","32.58704","73.49123","1","0","0","0","0","0","0","1","1","0","0","0","1","0","1","0","0","1","1","0","0","0","0","1"
"Manfalūţ","27.3126","30.96987","1","0","0","0","0","0","0","1","0","0","0","0","0","1","0","0","0","1","0","0","0","1","0","1"
"Mangalagiri","16.43083","80.56815","1","0","0","0","0","0","0","1","0","1","0","0","1","0","1","0","0","1","0","0","0","0","1","1"
"Mangalore","12.91723","74.85603","2","0","0","0","0","0","0","2","1","0","0","0","1","1","0","1","0","2","0","0","1","0","1","2"
"Mangla","31.89306","72.38167","1","1","0","0","0","0","0","2","2","0","0","0","2","0","0","2","0","2","0","1","1","0","0","2"
"Mangochi","-14.47815","35.26448","2","0","0","0","0","0","0","2","0","1","0","1","2","1","1","0","0","2","1","0","0","0","1","2"
"Manhattan","45.8566","-111.33246","1","0","0","0","0","0","0","1","0","1","0","0","1","1","0","0","0","1","0","0","1","0","0","1"
"Manhattan","39.18361","-96.57167","1","0","0","0","0","0","0","1","0","1","0","0","1","1","0","0","0","1","0","0","1","0","0","1"
"Manhattan","41.42253","-87.98589","1","0","0","0","0","0","0","1","0","1","0","0","1","1","0","0","0","1","0","0","1","0","0","1"
"Manhattan","40.78343","-73.96625","1","0","0","0","0","0","0","1","0","1","0","0","1","1","0","0","0","1","0","0","1","0","0","1"
"Mani","20.38774","-89.39189","0","1","0","0","0","0","0","1","0","1","0","0","1","1","0","0","0","1","0","0","1","0","0","1"
"Mani","13.25833","-0.21306","0","1","0","0","0","0","0","1","0","1","0","0","1","1","0","0","0","1","0","0","1","0","0","1"
"Mani","12.85426","7.87526","0","1","0","0","0","0","0","1","0","1","0","0","1","1","0","0","0","1","0","0","1","0","0","1"
"Manila","40.85179","-124.16229","8","0","0","0","0","0","0","8","5","1","1","0","7","4","1","3","0","8","3","1","4","0","0","8"
"Manila","40.98801","-109.72265","8","0","0","0","0","0","0","8","5","1","1","0","7","4","1","3","0","8","3","1","4","0","0","8"
"Manila","25.691","-103.53966","8","0","0","0","0","0","0","8","5","1","1","0","7","4","1","3","0","8","3","1","4","0","0","8"
"Manila","35.88007","-90.16704","8","0","0","0","0","0","0","8","5","1","1","0","7","4","1","3","0","8","3","1","4","0","0","8"
"Manila","14.6042","120.9822","8","0","0","0","0","0","0","8","5","1","1","0","7","4","1","3","0","8","3","1","4","0","0","8"
"Manipal","13.35","74.78333","1","0","0","0","0","0","0","1","1","0","0","0","1","0","0","1","0","1","0","0","1","0","0","1"
"Manizales","5.06889","-75.51738","1","0","0","0","0","0","0","1","1","0","0","0","1","0","0","2","0","2","0","1","1","0","0","2"
"Manly","43.28718","-93.20215","1","0","0","0","0","0","0","1","0","0","1","0","1","1","0","0","0","1","0","0","1","0","0","1"
"Manly","-33.79798","151.28826","1","0","0","0","0","0","0","1","0","0","1","0","1","1","0","0","0","1","0","0","1","0","0","1"
"Mannargudi","10.66626","79.45064","0","0","0","0","0","0","0","0","0","0","0","0","0","0","0","0","0","0","0","0","0","0","0","0"
"Manningtree","51.94538","1.06112","0","0","0","0","1","0","0","1","0","0","1","0","1","0","0","1","0","1","0","1","0","0","0","1"
"Manorbier","51.64614","-4.79901","0","0","0","0","1","0","0","1","1","0","0","0","1","1","0","0","0","1","0","1","0","0","0","1"
"Manouba","36.81006","10.09557","2","0","0","0","0","0","0","2","1","1","0","0","2","1","1","0","0","2","1","0","1","0","0","2"
"Mansa","-11.19976","28.89431","1","0","0","0","0","0","0","1","0","1","0","0","1","0","1","0","0","1","0","0","0","0","1","1"
"Mansa Konko","13.44325","-15.5357","1","0","0","0","0","0","0","1","0","1","0","0","1","1","0","0","0","1","1","0","0","0","0","1"
"Mansehra","34.33023","73.19679","4","0","0","0","1","0","0","5","1","3","0","1","5","1","1","3","0","5","3","0","2","0","0","5"
"Mansfield","32.56319","-97.14168","6","0","0","0","1","0","0","7","1","3","2","0","6","1","3","3","0","7","4","1","2","0","0","7"
"Mansfield","35.05954","-94.25271","6","0","0","0","1","0","0","7","1","3","2","0","6","1","3","3","0","7","4","1","2","0","0","7"
"Mansfield","32.03766","-93.70018","6","0","0","0","1","0","0","7","1","3","2","0","6","1","3","3","0","7","4","1","2","0","0","7"
"Mansfield","37.10672","-92.58072","6","0","0","0","1","0","0","7","1","3","2","0","6","1","3","3","0","7","4","1","2","0","0","7"
"Mansfield","40.21142","-88.50617","6","0","0","0","1","0","0","7","1","3","2","0","6","1","3","3","0","7","4","1","2","0","0","7"
"Mansfield","40.75839","-82.51545","6","0","0","0","1","0","0","7","1","3","2","0","6","1","3","3","0","7","4","1","2","0","0","7"
"Mansfield","41.8073","-77.07747","6","0","0","0","1","0","0","7","1","3","2","0","6","1","3","3","0","7","4","1","2","0","0","7"
"Mansfield","42.03343","-71.21894","6","0","0","0","1","0","0","7","1","3","2","0","6","1","3","3","0","7","4","1","2","0","0","7"
"Mansfield","53.13333","-1.2","6","0","0","0","1","0","0","7","1","3","2","0","6","1","3","3","0","7","4","1","2","0","0","7"
"Mansfield","-37.052","146.08846","6","0","0","0","1","0","0","7","1","3","2","0","6","1","3","3","0","7","4","1","2","0","0","7"
"Mansfield","-27.53929","153.09895","6","0","0","0","1","0","0","7","1","3","2","0","6","1","3","3","0","7","4","1","2","0","0","7"
"Mansfield Woodhouse","53.16495","-1.19384","2","0","0","0","0","0","1","3","1","1","1","0","3","3","0","0","0","3","0","0","3","0","0","3"
"Manta","-0.96212","-80.71271","1","0","0","0","0","0","0","1","0","0","0","0","0","0","0","1","0","1","1","0","0","0","0","1"
"Manta","5.00864","-73.54115","1","0","0","0","0","0","0","1","0","0","0","0","0","0","0","1","0","1","1","0","0","0","0","1"
"Manta","44.61583","7.48703","1","0","0","0","0","0","0","1","0","0","0","0","0","0","0","1","0","1","1","0","0","0","0","1"
"Mantes-la-Jolie","48.99048","1.7167","0","0","0","0","0","0","1","1","0","1","0","0","1","1","0","0","0","1","0","0","0","1","0","1"
"Mänttä","62.03014","24.62791","1","0","0","0","0","0","0","1","1","0","0","0","1","1","0","0","0","1","0","0","1","0","0","1"
"Manzini","-26.49884","31.38004","4","0","0","0","1","0","0","5","1","4","0","0","5","2","2","1","1","6","3","1","1","0","0","5"
"Maple Cross","51.625","-0.508","0","0","0","1","0","0","0","1","1","0","0","0","1","0","0","1","0","1","0","0","1","0","0","1"
"Maple Grove","45.07246","-93.45579","0","0","0","0","1","0","0","1","0","0","0","0","0","1","0","0","0","1","1","0","0","0","0","1"
"Maple Grove","44.18944","-87.92371","0","0","0","0","1","0","0","1","0","0","0","0","0","1","0","0","0","1","1","0","0","0","0","1"
"Maple Ridge","49.21939","-122.60193","0","0","0","0","1","0","0","1","0","1","0","0","1","1","0","0","0","1","0","0","1","0","0","1"
"Maple Ridge","53.50172","-113.36274","0","0","0","0","1","0","0","1","0","1","0","0","1","1","0","0","0","1","0","0","1","0","0","1"
"Maple Ridge","40.92311","-81.05093","0","0","0","0","1","0","0","1","0","1","0","0","1","1","0","0","0","1","0","0","1","0","0","1"
"Maputo","-25.96553","32.58322","4","0","0","0","0","0","0","4","0","3","2","1","6","1","4","1","0","6","2","0","4","0","0","6"
"Maracaibo","10.66663","-71.61245","5","0","0","0","0","0","0","5","1","2","1","0","4","2","0","2","0","4","3","1","1","0","0","5"
"Maracay","10.23535","-67.59113","1","0","0","0","0","0","0","1","0","1","0","0","1","0","1","1","0","2","1","0","0","1","0","2"
"Maradi","13.5","7.10174","7","0","0","0","0","0","0","7","0","0","2","0","2","0","7","0","0","7","0","0","6","0","1","7"
"Maralal","1.09667","36.69806","1","0","0","0","0","0","0","1","1","0","0","0","1","0","1","0","0","1","0","0","1","0","0","1"
"Marbella","36.51543","-4.88583","1","0","0","0","0","0","0","1","1","0","0","0","1","0","0","1","0","1","0","0","1","0","0","1"
"Marble Falls","30.57841","-98.27507","1","0","0","0","0","0","0","1","0","0","1","0","1","0","0","1","0","1","0","1","0","0","0","1"
"Marble Falls","36.08425","-93.14998","1","0","0","0","0","0","0","1","0","0","1","0","1","0","0","1","0","1","0","1","0","0","0","1"
"March","52.55131","0.08828","3","0","0","0","0","0","0","3","0","2","0","1","3","1","1","1","0","3","2","0","1","0","0","3"
"March","37.52845","70.4482","3","0","0","0","0","0","0","3","0","2","0","1","3","1","1","1","0","3","2","0","1","0","0","3"
"Mardan","34.19794","72.04965","10","0","0","0","0","0","0","10","2","5","1","1","9","4","2","4","0","10","4","0","4","0","2","10"
"Mar del Plata","-38.00042","-57.5562","1","0","0","0","0","0","0","1","0","1","0","0","1","0","1","0","0","1","1","0","0","0","0","1"
"Marden","51.17482","0.48855","2","0","0","0","1","0","0","3","1","0","2","0","3","0","1","2","0","3","0","0","3","0","0","3"
"Marden","-34.89569","138.6378","2","0","0","0","1","0","0","3","1","0","2","0","3","0","1","2","0","3","0","0","3","0","0","3"
"Mardin","37.31309","40.74357","2","0","0","0","0","0","0","2","0","0","0","0","0","1","0","1","0","2","1","1","0","0","0","2"
"Mare La Chaux","-20.19806","57.74944","1","0","0","0","0","0","0","1","0","0","0","0","0","0","0","1","0","1","1","0","0","0","0","1"
"Marengo","41.79806","-92.07074","1","0","0","0","0","0","0","1","0","0","1","0","1","0","0","1","0","1","0","0","1","0","0","1"
"Marengo","42.24863","-88.60843","1","0","0","0","0","0","0","1","0","0","1","0","1","0","0","1","0","1","0","0","1","0","0","1"
"Marengo","38.36923","-86.34359","1","0","0","0","0","0","0","1","0","0","1","0","1","0","0","1","0","1","0","0","1","0","0","1"
"Margate","26.24453","-80.20644","3","0","0","0","0","0","1","4","1","1","1","0","3","2","1","1","0","4","1","0","3","0","0","4"
"Margate","51.38132","1.38617","3","0","0","0","0","0","1","4","1","1","1","0","3","2","1","1","0","4","1","0","3","0","0","4"
"Margate","-30.8636","30.37052","3","0","0","0","0","0","1","4","1","1","1","0","3","2","1","1","0","4","1","0","3","0","0","4"
"Margate","-43.02814","147.26256","3","0","0","0","0","0","1","4","1","1","1","0","3","2","1","1","0","4","1","0","3","0","0","4"
"Margate","-27.24761","153.09809","3","0","0","0","0","0","1","4","1","1","1","0","3","2","1","1","0","4","1","0","3","0","0","4"
"Mariakani","-3.86261","39.47458","1","0","0","0","0","0","0","1","0","0","1","0","1","1","0","0","0","1","0","0","1","0","0","1"
"Maribor","46.55472","15.64667","3","0","0","0","0","0","0","3","0","0","0","0","0","2","0","1","0","3","0","1","1","0","1","3"
"Mariehamn","60.09726","19.93481","1","0","0","0","0","0","0","1","0","0","0","0","0","0","1","0","0","1","0","0","1","0","0","1"
"Mariestad","58.70971","13.82367","2","0","0","0","0","0","0","2","0","2","0","0","2","0","2","0","0","2","0","0","2","0","0","2"
"Marietta","48.78705","-122.58045","1","0","0","0","0","0","0","1","0","0","0","0","0","0","0","1","0","1","0","1","0","0","0","1"
"Marietta","33.93704","-97.11668","1","0","0","0","0","0","0","1","0","0","0","0","0","0","0","1","0","1","0","1","0","0","0","1"
"Marietta","33.9526","-84.54993","1","0","0","0","0","0","0","1","0","0","0","0","0","0","0","1","0","1","0","1","0","0","0","1"
"Marietta","39.41535","-81.45484","1","0","0","0","0","0","0","1","0","0","0","0","0","0","0","1","0","1","0","1","0","0","0","1"
"Marietta","40.05704","-76.55219","1","0","0","0","0","0","0","1","0","0","0","0","0","0","0","1","0","1","0","1","0","0","0","1"
"Marina del Rey","33.98029","-118.45174","1","0","0","0","0","0","0","1","0","0","0","0","0","0","1","0","0","1","1","0","0","0","0","1"
"Market Bosworth","52.62428","-1.40174","1","0","0","0","0","0","0","1","0","0","0","0","0","1","0","0","0","1","0","0","1","0","0","1"
"Market Deeping","52.67654","-0.31629","1","0","0","0","0","0","0","1","0","0","0","0","0","1","0","0","0","1","0","0","1","0","0","1"
"Market Drayton","52.90538","-2.49012","6","0","0","0","0","0","0","6","1","4","0","0","5","2","0","4","0","6","1","0","4","0","0","5"
"Market Harborough","52.4776","-0.92053","8","0","0","0","0","0","0","8","1","4","3","0","8","2","3","3","0","8","2","0","6","0","0","8"
"Market Weighton","53.8631","-0.66505","2","0","0","0","0","0","0","2","0","1","0","0","1","2","0","0","0","2","2","0","0","0","0","2"
"Markfield","52.68747","-1.27476","1","0","0","0","0","0","1","2","0","1","1","0","2","0","0","2","0","2","0","0","2","0","0","2"
"Markham","28.96026","-96.06524","1","0","0","0","0","0","0","1","1","0","0","0","1","1","0","0","0","1","0","1","0","0","0","1"
"Markham","41.59365","-87.69477","1","0","0","0","0","0","0","1","1","0","0","0","1","1","0","0","0","1","0","1","0","0","0","1"
"Markham","43.86682","-79.2663","1","0","0","0","0","0","0","1","1","0","0","0","1","1","0","0","0","1","0","1","0","0","0","1"
"Marktoberdorf","47.77964","10.61713","1","0","0","0","0","0","0","1","0","1","0","0","1","1","0","0","0","1","1","0","0","0","0","1"
"Marl","51.65671","7.09038","1","0","0","0","0","0","0","1","0","0","1","0","1","0","1","0","0","1","0","0","1","0","0","1"
"Marl","52.48333","8.36667","1","0","0","0","0","0","0","1","0","0","1","0","1","0","1","0","0","1","0","0","1","0","0","1"
"Marlborough","38.57033","-90.33706","10","2","0","3","0","0","3","18","7","3","2","0","12","6","3","9","0","18","0","9","8","1","0","18"
"Marlborough","42.90425","-72.20786","10","2","0","3","0","0","3","18","7","3","2","0","12","6","3","9","0","18","0","9","8","1","0","18"
"Marlborough","42.34593","-71.55229","10","2","0","3","0","0","3","18","7","3","2","0","12","6","3","9","0","18","0","9","8","1","0","18"
"Marlborough","51.42027","-1.72949","10","2","0","3","0","0","3","18","7","3","2","0","12","6","3","9","0","18","0","9","8","1","0","18"
"Marlow","34.64813","-97.95809","12","2","0","0","1","0","0","15","2","3","7","0","12","6","0","9","0","15","1","3","11","0","0","15"
"Marlow","43.11591","-72.19703","12","2","0","0","1","0","0","15","2","3","7","0","12","6","0","9","0","15","1","3","11","0","0","15"
"Marlow","51.56933","-0.77415","12","2","0","0","1","0","0","15","2","3","7","0","12","6","0","9","0","15","1","3","11","0","0","15"
"Marlow","54.15439","12.57261","12","2","0","0","1","0","0","15","2","3","7","0","12","6","0","9","0","15","1","3","11","0","0","15"
"Marlton","38.77373","-76.78997","1","0","0","0","0","0","0","1","0","0","0","0","0","0","1","0","0","1","0","0","1","0","0","1"
"Marlton","39.89122","-74.92183","1","0","0","0","0","0","0","1","0","0","0","0","0","0","1","0","0","1","0","0","1","0","0","1"
"Marneuli","41.48713","44.80195","1","0","0","0","0","0","0","1","1","0","0","0","1","0","1","0","0","1","0","0","1","0","0","1"
"Maros","-5.006","119.5727","1","0","0","0","0","0","0","1","1","0","0","0","1","1","0","0","0","1","0","0","1","0","0","1"
"Maroúsi","38.05","23.8","1","0","0","0","0","0","0","1","0","0","0","0","0","1","0","0","0","1","1","0","0","0","0","1"
"Marple","53.39452","-2.06292","3","0","0","0","1","0","0","4","2","1","1","0","4","0","0","4","0","4","0","2","2","0","0","4"
"Marrakesh","31.63416","-7.99994","6","0","0","0","0","0","0","6","2","0","1","0","3","3","1","2","0","6","2","0","3","0","1","6"
"Marsabit","2.33468","37.99086","3","0","0","0","0","0","0","3","0","1","0","0","1","1","1","0","0","2","0","0","1","0","2","3"
"Marsaskala","35.8622","14.56701","1","0","0","0","0","0","0","1","0","0","0","0","0","0","0","1","0","1","0","0","1","0","0","1"
"Marshfield","37.33866","-92.90712","2","0","0","0","0","0","0","2","0","0","1","0","1","1","0","1","0","2","0","1","1","0","0","2"
"Marshfield","44.66885","-90.1718","2","0","0","0","0","0","0","2","0","0","1","0","1","1","0","1","0","2","0","1","1","0","0","2"
"Marshfield","42.09177","-70.70559","2","0","0","0","0","0","0","2","0","0","1","0","1","1","0","1","0","2","0","1","1","0","0","2"
"Marshfield","44.73313","-67.47749","2","0","0","0","0","0","0","2","0","0","1","0","1","1","0","1","0","2","0","1","1","0","0","2"
"Marshfield","51.53389","-3.07306","2","0","0","0","0","0","0","2","0","0","1","0","1","1","0","1","0","2","0","1","1","0","0","2"
"Marshfield","51.46194","-2.32","2","0","0","0","0","0","0","2","0","0","1","0","1","1","0","1","0","2","0","1","1","0","0","2"
"Marston Moretaine","52.0641","-0.54932","1","0","0","0","0","0","0","1","0","1","0","0","1","1","0","0","0","1","0","0","1","0","0","1"
"Marthasville","38.62838","-91.05764","1","1","0","0","0","0","0","2","0","2","0","0","2","1","0","1","0","2","1","0","1","0","0","2"
"Martock","50.97361","-2.76684","2","0","0","2","0","0","0","4","2","0","2","0","4","1","0","3","0","4","0","3","1","0","0","4"
"Mārupe","56.90544","24.05113","1","0","0","0","0","0","0","1","0","0","0","0","0","0","0","1","0","1","0","0","1","0","0","1"
"Maryland City","39.09205","-76.81775","1","0","0","0","0","0","0","1","0","0","0","0","0","0","1","0","0","1","0","0","1","0","0","1"
"Maryport","54.71434","-3.49509","0","0","0","0","1","0","0","1","1","0","0","0","1","0","0","1","0","1","0","0","1","0","0","1"
"Masaka","8.66492","-11.8026","3","0","0","0","0","0","0","3","0","2","0","0","2","2","1","0","0","3","0","0","0","1","2","3"
"Masaka","-0.33379","31.73409","3","0","0","0","0","0","0","3","0","2","0","0","2","2","1","0","0","3","0","0","0","1","2","3"
"Mascara","35.39664","0.14027","2","0","0","0","0","0","0","2","1","0","0","0","1","1","1","0","0","2","0","1","0","0","1","2"
"Mascot","36.0612","-83.74573","1","0","0","0","0","0","0","1","0","0","0","0","0","0","1","0","0","1","0","0","1","0","0","1"
"Mascot","-33.92598","151.19347","1","0","0","0","0","0","0","1","0","0","0","0","0","0","1","0","0","1","0","0","1","0","0","1"
"Mascotte","28.57833","-81.88675","0","0","0","0","1","0","0","1","0","0","0","0","0","0","0","1","0","1","0","1","0","0","0","1"
"Maseru","-29.31667","27.48333","6","0","0","0","0","0","0","6","0","3","1","0","4","2","3","0","0","5","3","1","1","0","1","6"
"Mashhad","36.31559","59.56796","2","0","0","0","0","0","0","2","0","0","0","0","0","0","0","2","0","2","1","0","1","0","0","2"
"Mashhad","36.81665","70.10211","2","0","0","0","0","0","0","2","0","0","0","0","0","0","0","2","0","2","1","0","1","0","0","2"
"Mashtūl as Sūq","30.36056","31.3776","1","0","0","0","0","0","0","1","1","0","0","0","1","0","1","0","0","1","0","0","1","0","0","1"
"Maspalomas","27.76056","-15.58602","1","0","0","0","0","0","0","1","0","0","0","0","0","0","0","1","0","1","0","0","1","0","0","1"
"Matagalpa","12.92559","-85.91747","1","0","0","0","0","0","0","1","0","1","0","0","1","0","1","0","0","1","0","0","0","1","0","1"
"Mateur","37.04045","9.66557","1","0","0","0","0","0","0","1","0","0","0","1","1","1","0","0","0","1","0","0","0","0","1","1"
"Mathura","27.5035","77.67215","2","0","0","0","0","0","0","2","1","0","0","0","1","0","0","2","0","2","0","0","2","0","0","2"
"Matli","25.0429","68.65591","1","0","0","0","0","0","0","1","0","0","1","0","1","1","0","0","0","1","0","0","0","0","1","1"
"Matlock","53.13838","-1.5556","19","1","0","2","2","0","2","26","9","1","1","0","11","13","0","13","0","26","5","9","11","0","1","26"
"Matosinhos","41.18207","-8.68908","1","0","0","0","0","0","0","1","0","1","0","0","1","0","0","1","0","1","1","0","0","0","0","1"
"Mau","26.26584","78.67108","1","0","0","0","0","0","0","1","1","0","0","0","1","0","1","0","0","1","0","0","1","0","0","1"
"Mau","25.94167","83.56111","1","0","0","0","0","0","0","1","1","0","0","0","1","0","1","0","0","1","0","0","1","0","0","1"
"Maua","0.2332","37.94086","0","0","0","0","0","0","0","0","0","0","0","0","0","1","0","0","0","1","0","0","0","0","0","0"
"Mauchline","55.51604","-4.37928","1","0","0","0","0","0","0","1","0","1","0","0","1","0","0","1","0","1","0","0","1","0","0","1"
"Maud","35.13036","-96.77585","1","0","0","0","0","0","0","1","0","1","0","0","1","1","0","0","0","1","0","1","0","0","0","1"
"Maud","33.3329","-94.3427","1","0","0","0","0","0","0","1","0","1","0","0","1","1","0","0","0","1","0","1","0","0","0","1"
"Maud","57.52165","-2.1257","1","0","0","0","0","0","0","1","0","1","0","0","1","1","0","0","0","1","0","1","0","0","0","1"
"Maughold","54.29877","-4.31844","1","0","0","0","0","0","0","1","1","0","0","0","1","0","1","0","0","1","0","0","1","0","0","1"
"Mauldin","34.77873","-82.31012","1","0","0","0","0","0","0","1","0","0","0","1","1","1","0","0","0","1","1","0","0","0","0","1"
"Maussane-les-Alpilles","43.72236","4.80497","0","0","0","0","0","0","1","1","0","0","0","0","0","0","0","1","0","1","0","0","1","0","0","1"
"Maybole","55.35503","-4.68026","1","0","0","0","0","0","0","1","0","0","1","0","1","0","0","1","0","1","0","1","0","0","0","1"
"Mayfield","39.11413","-111.71075","0","0","0","0","1","0","0","1","1","0","0","0","1","0","0","1","0","1","0","0","1","0","0","1"
"Mayfield","36.74172","-88.63672","0","0","0","0","1","0","0","1","1","0","0","0","1","0","0","1","0","1","0","0","1","0","0","1"
"Mayfield","39.49478","-84.37272","0","0","0","0","1","0","0","1","1","0","0","0","1","0","0","1","0","1","0","0","1","0","0","1"
"Mayfield","41.552","-81.43928","0","0","0","0","1","0","0","1","1","0","0","0","1","0","0","1","0","1","0","0","1","0","0","1"
"Mayfield","40.13618","-79.59782","0","0","0","0","1","0","0","1","1","0","0","0","1","0","0","1","0","1","0","0","1","0","0","1"
"Mayfield","41.53814","-75.53602","0","0","0","0","1","0","0","1","1","0","0","0","1","0","0","1","0","1","0","0","1","0","0","1"
"Mayfield","43.10452","-74.26486","0","0","0","0","1","0","0","1","1","0","0","0","1","0","0","1","0","1","0","0","1","0","0","1"
"Mayfield","55.87172","-3.03875","0","0","0","0","1","0","0","1","1","0","0","0","1","0","0","1","0","1","0","0","1","0","0","1"
"Mayfield","53","-1.76667","0","0","0","0","1","0","0","1","1","0","0","0","1","0","0","1","0","1","0","0","1","0","0","1"
"Mayfield","-41.3876","147.13052","0","0","0","0","1","0","0","1","1","0","0","0","1","0","0","1","0","1","0","0","1","0","0","1"
"Mayfield","-32.89793","151.73613","0","0","0","0","1","0","0","1","1","0","0","0","1","0","0","1","0","1","0","0","1","0","0","1"
"Mayiladuthurai","11.10354","79.655","1","0","0","0","0","0","0","1","1","0","0","0","1","1","0","0","0","1","0","0","1","0","0","1"
"Mazatenango","14.53417","-91.50333","1","0","0","0","0","0","0","1","1","0","0","0","1","0","0","1","0","1","0","0","1","0","0","1"
"Mbabane","-26.31667","31.13333","1","0","0","0","0","0","0","1","0","0","0","0","0","1","0","0","0","1","6","0","0","0","0","6"
"Mbala","-8.84024","31.36587","0","1","0","0","0","0","0","1","0","1","0","0","1","1","0","0","0","1","0","0","0","0","1","1"
"Mbale","1.08209","34.17503","5","0","0","0","0","0","0","5","1","2","0","1","4","3","1","0","0","4","1","0","2","1","1","5"
"Mbale","0.08213","34.72139","5","0","0","0","0","0","0","5","1","2","0","1","4","3","1","0","0","4","1","0","2","1","1","5"
"Mbarara","-0.60467","30.64851","7","0","0","0","0","0","0","7","0","3","2","0","5","4","1","2","0","7","0","0","3","0","4","7"
"Mbeya","-8.9","33.45","7","0","0","0","1","0","0","8","1","5","0","0","6","7","0","1","0","8","2","0","2","0","2","6"
"McKeesport","40.34785","-79.86422","1","0","0","0","0","0","0","1","0","0","0","0","0","0","0","1","0","1","0","1","0","0","0","1"
"McKinney","33.19762","-96.61527","3","1","0","0","0","0","0","4","0","2","0","0","2","3","0","1","0","4","1","0","3","0","0","4"
"McLean","35.23255","-100.59986","1","0","0","0","0","0","0","1","0","0","0","0","0","0","0","1","0","1","0","0","1","0","0","1"
"McLean","40.31448","-89.16981","1","0","0","0","0","0","0","1","0","0","0","0","0","0","0","1","0","1","0","0","1","0","0","1"
"McLean","38.93428","-77.17748","1","0","0","0","0","0","0","1","0","0","0","0","0","0","0","1","0","1","0","0","1","0","0","1"
"Meadowbank","-33.81668","151.08861","1","0","0","0","0","0","0","1","0","0","0","0","0","0","0","1","0","1","0","0","1","0","0","1"
"Measham","52.70644","-1.50637","1","0","0","0","0","0","0","1","0","0","0","0","0","1","0","0","0","1","0","1","0","0","0","1"
"Mecca","33.57219","-116.0782","12","0","0","0","0","0","0","12","2","4","0","0","6","3","5","4","0","12","7","2","1","0","1","11"
"Mecca","21.42664","39.82563","12","0","0","0","0","0","0","12","2","4","0","0","6","3","5","4","0","12","7","2","1","0","1","11"
"Medan","3.58333","98.66667","2","0","0","0","0","0","0","2","0","2","0","0","2","1","0","1","0","2","1","0","1","0","0","2"
"Medellín","18.41639","-95.36611","5","0","0","0","0","0","0","5","2","0","1","0","3","2","2","1","0","5","2","0","3","0","0","5"
"Medellín","6.25184","-75.56359","5","0","0","0","0","0","0","5","2","0","1","0","3","2","2","1","0","5","2","0","3","0","0","5"
"Medellín","38.96265","-5.95785","5","0","0","0","0","0","0","5","2","0","1","0","3","2","2","1","0","5","2","0","3","0","0","5"
"Medenine","33.35495","10.50548","1","0","0","0","0","0","1","2","1","0","0","1","2","0","1","0","1","2","0","1","1","0","0","2"
"Mediaş","46.16667","24.35","1","0","0","0","0","0","0","1","1","0","0","0","1","1","0","0","0","1","0","0","1","0","0","1"
"Medina","47.62093","-122.22762","2","0","0","0","0","0","0","2","1","0","0","0","1","1","0","1","0","2","1","0","1","0","0","2"
"Medina","21.14972","-101.6225","2","0","0","0","0","0","0","2","1","0","0","0","1","1","0","1","0","2","1","0","1","0","0","2"
"Medina","20.89556","-100.39417","2","0","0","0","0","0","0","2","1","0","0","0","1","1","0","1","0","2","1","0","1","0","0","2"
"Medina","24.01224","-100.3807","2","0","0","0","0","0","0","2","1","0","0","0","1","1","0","1","0","2","1","0","1","0","0","2"
"Medina","26.92115","-99.25948","2","0","0","0","0","0","0","2","1","0","0","0","1","1","0","1","0","2","1","0","1","0","0","2"
"Medina","29.79661","-99.24643","2","0","0","0","0","0","0","2","1","0","0","0","1","1","0","1","0","2","1","0","1","0","0","2"
"Medina","45.03524","-93.58246","2","0","0","0","0","0","0","2","1","0","0","0","1","1","0","1","0","2","1","0","1","0","0","2"
"Medina","35.80285","-88.77478","2","0","0","0","0","0","0","2","1","0","0","0","1","1","0","1","0","2","1","0","1","0","0","2"
"Medina","41.13839","-81.86375","2","0","0","0","0","0","0","2","1","0","0","0","1","1","0","1","0","2","1","0","1","0","0","2"
"Medina","43.22006","-78.38697","2","0","0","0","0","0","0","2","1","0","0","0","1","1","0","1","0","2","1","0","1","0","0","2"
"Medina","4.51005","-73.34982","2","0","0","0","0","0","0","2","1","0","0","0","1","1","0","1","0","2","1","0","1","0","0","2"
"Medina","-16.2225","-41.47694","2","0","0","0","0","0","0","2","1","0","0","0","1","1","0","1","0","2","1","0","1","0","0","2"
"Medina","24.46861","39.61417","2","0","0","0","0","0","0","2","1","0","0","0","1","1","0","1","0","2","1","0","1","0","0","2"
"Medina","-32.23406","115.79901","2","0","0","0","0","0","0","2","1","0","0","0","1","1","0","1","0","2","1","0","1","0","0","2"
"Medina","8.91222","125.02444","2","0","0","0","0","0","0","2","1","0","0","0","1","1","0","1","0","2","1","0","1","0","0","2"
"Medinīpur","22.42114","87.32257","1","0","0","0","0","0","0","1","0","0","1","0","1","1","0","0","0","1","0","0","1","0","0","1"
"Medjez el Bab","36.64964","9.61231","1","0","0","0","0","0","0","1","1","0","0","0","1","0","0","1","0","1","0","0","1","0","0","1"
"Meerut","28.98002","77.70636","1","0","0","0","0","0","0","1","1","0","0","0","1","0","0","1","0","1","0","0","1","0","0","1"
"Mejicanos","13.72397","-89.188","1","0","0","0","0","0","0","1","0","0","1","0","1","1","0","0","0","1","0","0","1","0","0","1"
"Mek'ele","13.49667","39.47528","3","0","0","0","0","0","0","3","0","2","0","0","2","2","1","1","0","4","0","0","2","1","1","4"
"Meknès","33.89352","-5.54727","2","0","0","0","0","0","0","2","1","0","1","0","2","1","1","0","0","2","0","1","1","0","0","2"
"Melbourn","52.08128","0.01514","0","0","0","0","1","0","1","2","1","0","0","1","2","0","1","1","0","2","1","0","1","0","0","2"
"Melbourne","41.94138","-93.10326","10","1","0","1","2","0","1","15","0","4","4","0","8","8","3","4","0","15","6","2","6","1","0","15"
"Melbourne","36.05951","-91.90848","10","1","0","1","2","0","1","15","0","4","4","0","8","8","3","4","0","15","6","2","6","1","0","15"
"Melbourne","28.08363","-80.60811","10","1","0","1","2","0","1","15","0","4","4","0","8","8","3","4","0","15","6","2","6","1","0","15"
"Melbourne","52.8219","-1.42522","10","1","0","1","2","0","1","15","0","4","4","0","8","8","3","4","0","15","6","2","6","1","0","15"
"Melbourne","53.88755","-0.85925","10","1","0","1","2","0","1","15","0","4","4","0","8","8","3","4","0","15","6","2","6","1","0","15"
"Melbourne","-37.814","144.96332","10","1","0","1","2","0","1","15","0","4","4","0","8","8","3","4","0","15","6","2","6","1","0","15"
"Melbourne City Centre","-37.81501","144.96657","1","0","0","0","0","0","0","1","0","0","0","0","0","1","0","0","0","1","0","0","0","0","1","1"
"Melilla","35.29369","-2.93833","1","0","0","0","0","0","0","1","0","1","0","0","1","0","0","1","0","1","0","0","1","0","0","1"
"Melito di Napoli","40.91948","14.23104","1","0","0","0","0","0","0","1","0","0","0","1","1","0","0","0","1","1","1","0","0","0","0","1"
"Melksham","51.37281","-2.14002","6","0","0","0","1","0","0","7","0","5","0","0","5","3","1","3","0","7","1","1","2","1","2","7"
"Mellieħa","35.95639","14.36222","1","0","0","0","0","0","0","1","0","1","0","0","1","1","0","0","0","1","1","0","0","0","0","1"
"Melrose","43.24762","-123.45897","2","1","0","0","1","0","1","5","1","1","3","0","5","0","0","5","0","5","0","4","1","0","0","5"
"Melrose","34.43035","-103.63246","2","1","0","0","1","0","1","5","1","1","3","0","5","0","0","5","0","5","0","4","1","0","0","5"
"Melrose","45.67469","-94.80752","2","1","0","0","1","0","1","5","1","1","3","0","5","0","0","5","0","5","0","4","1","0","0","5"
"Melrose","40.82455","-73.91041","2","1","0","0","1","0","1","5","1","1","3","0","5","0","0","5","0","5","0","4","1","0","0","5"
"Melrose","42.45843","-71.06616","2","1","0","0","1","0","1","5","1","1","3","0","5","0","0","5","0","5","0","4","1","0","0","5"
"Melrose","55.59969","-2.7277","2","1","0","0","1","0","1","5","1","1","3","0","5","0","0","5","0","5","0","4","1","0","0","5"
"Melrose","-20.26972","57.63194","2","1","0","0","1","0","1","5","1","1","3","0","5","0","0","5","0","5","0","4","1","0","0","5"
"Melton Mowbray","52.76588","-0.88693","4","0","0","1","0","0","1","6","2","1","2","0","5","1","0","5","0","6","0","3","3","0","0","6"
"Melun","48.5457","2.65356","1","0","0","0","0","0","0","1","0","0","0","0","0","1","0","0","0","1","0","0","1","0","0","1"
"Mélykút","46.21509","19.38102","1","0","0","0","0","0","0","1","1","0","0","0","1","0","0","1","0","1","0","0","1","0","0","1"
"Melzo","45.4981","9.42043","1","0","0","0","0","0","0","1","0","0","0","0","0","0","0","1","0","1","0","0","1","0","0","1"
"Memphis","34.72478","-100.53401","3","0","0","0","1","0","0","4","2","1","1","0","4","1","0","3","0","4","0","0","4","0","0","4"
"Memphis","40.45781","-92.17129","3","0","0","0","1","0","0","4","2","1","1","0","4","1","0","3","0","4","0","0","4","0","0","4"
"Memphis","35.14953","-90.04898","3","0","0","0","1","0","0","4","2","1","1","0","4","1","0","3","0","4","0","0","4","0","0","4"
"Memphis","38.4834","-85.76163","3","0","0","0","1","0","0","4","2","1","1","0","4","1","0","3","0","4","0","0","4","0","0","4"
"Memphis","42.89642","-82.76881","3","0","0","0","1","0","0","4","2","1","1","0","4","1","0","3","0","4","0","0","4","0","0","4"
"Memphis","27.53587","-82.56121","3","0","0","0","1","0","0","4","2","1","1","0","4","1","0","3","0","4","0","0","4","0","0","4"
"Menai Bridge","53.22775","-4.16926","3","0","0","0","0","0","0","3","0","0","3","0","3","2","0","1","0","3","0","1","2","0","0","3"
"Mendoza","9.01471","-79.85073","1","0","0","0","0","0","0","1","1","0","0","0","1","0","0","1","0","1","0","1","0","0","0","1"
"Mendoza","-6.39444","-77.48167","1","0","0","0","0","0","0","1","1","0","0","0","1","0","0","1","0","1","0","1","0","0","0","1"
"Mendoza","-32.89084","-68.82717","1","0","0","0","0","0","0","1","1","0","0","0","1","0","0","1","0","1","0","1","0","0","0","1"
"Menlo Park","37.45383","-122.18219","2","0","0","0","0","0","0","2","0","1","1","0","2","0","0","2","0","2","0","0","2","0","0","2"
"Menston","53.89041","-1.74395","1","0","0","0","0","0","0","1","0","0","0","0","0","0","0","1","0","1","0","0","1","0","0","1"
"Mentor","41.66616","-81.33955","0","0","0","1","0","0","0","1","1","0","0","0","1","0","0","1","0","1","0","0","1","0","0","1"
"Menzel Bourguiba","37.15368","9.78594","2","0","0","0","0","0","0","2","0","0","2","0","2","0","0","2","0","2","0","0","1","0","1","2"
"Mere","53.3321","-2.40935","0","1","0","0","0","0","0","1","0","1","0","0","1","0","0","1","0","1","0","0","1","0","0","1"
"Mere","51.08889","-2.26694","0","1","0","0","0","0","0","1","0","1","0","0","1","0","0","1","0","1","0","0","1","0","0","1"
"Mérida","32.6609","-114.91891","0","0","0","0","1","0","0","1","0","0","1","0","1","0","1","0","0","1","0","0","1","0","0","1"
"Mérida","16.5675","-93.81722","0","0","0","0","1","0","0","1","0","0","1","0","1","0","1","0","0","1","0","0","1","0","0","1"
"Mérida","20.97537","-89.61696","0","0","0","0","1","0","0","1","0","0","1","0","1","0","1","0","0","1","0","0","1","0","0","1"
"Mérida","8.58972","-71.15611","0","0","0","0","1","0","0","1","0","0","1","0","1","0","1","0","0","1","0","0","1","0","0","1"
"Mérida","38.91611","-6.34366","0","0","0","0","1","0","0","1","0","0","1","0","1","0","1","0","0","1","0","0","1","0","0","1"
"Merriott","50.91275","-2.79538","1","0","0","0","1","0","0","2","1","0","1","0","2","1","0","1","0","2","0","1","0","0","1","2"
"Merritt Island","28.53917","-80.672","1","0","0","0","0","0","0","1","0","0","0","1","1","0","0","1","0","1","0","0","1","0","0","1"
"Mersa Matruh","31.3529","27.23725","0","0","0","0","1","0","0","1","0","0","0","0","0","1","0","0","0","1","0","0","1","0","0","1"
"Mersin","36.81196","34.63886","4","0","0","0","0","0","2","6","2","0","3","0","5","3","0","3","0","6","1","0","3","0","2","6"
"Merthyr Tydfil","51.74794","-3.37779","25","0","0","0","2","0","1","28","5","14","7","1","27","12","5","10","1","28","12","4","11","0","1","28"
"Meru","0.04626","37.65587","1","0","0","0","0","0","0","1","0","0","1","0","1","1","0","0","0","1","0","0","1","0","0","1"
"Messina","38.19394","15.55256","1","0","0","0","0","0","0","1","0","0","0","0","0","1","0","0","0","1","1","0","0","0","0","1"
"Mestrino","45.44139","11.75931","0","0","0","0","0","1","0","1","0","0","0","0","0","0","1","0","0","1","1","0","0","0","0","1"
"Metheringham","53.14015","-0.40368","1","0","0","0","0","0","0","1","1","0","0","0","1","0","0","1","0","1","0","0","1","0","0","1"
"Metković","43.05417","17.64833","1","0","0","0","0","0","0","1","0","0","0","0","0","0","1","0","0","1","1","0","0","0","0","1"
"Metković","44.85617","19.54654","1","0","0","0","0","0","0","1","0","0","0","0","0","0","1","0","0","1","1","0","0","0","0","1"
"Mettur","11.78796","77.8008","5","0","0","0","0","0","0","5","5","0","0","0","5","0","0","5","0","5","0","5","0","0","0","5"
"Metz","49.11911","6.17269","3","0","0","0","0","0","0","3","2","1","0","0","3","0","0","1","2","3","1","2","0","0","0","3"
"Mexicali","32.62781","-115.45446","1","0","0","0","0","0","0","1","0","0","0","1","1","1","0","0","0","1","0","0","1","0","0","1"
"Mexico City","19.42847","-99.12766","11","1","0","0","0","0","0","12","4","4","1","0","9","4","3","5","0","12","4","1","6","1","0","12"
"Mexilhoeira Grande","37.15858","-8.61487","1","0","0","0","0","0","0","1","0","1","0","0","1","0","1","0","0","1","0","0","1","0","0","1"
"Meycauayan","14.73694","120.96083","1","0","0","0","0","0","0","1","1","0","0","0","1","1","0","0","0","1","0","0","0","1","0","1"
"Meylan","45.20978","5.77762","1","0","0","0","0","0","0","1","0","0","0","0","0","0","0","1","0","1","0","0","0","1","0","1"
"Meyrin","46.23424","6.08025","1","0","0","0","0","0","0","1","0","1","0","0","1","0","1","0","0","1","1","0","0","0","0","1"
"Mhlambanyatsi","-26.45","31.01667","1","0","0","0","0","0","0","1","0","1","0","0","1","0","0","1","0","1","1","0","0","0","0","1"
"Miami","33.39922","-110.86872","12","0","0","0","0","0","0","12","2","6","3","0","11","4","3","6","0","13","2","2","9","0","0","13"
"Miami","35.69143","-100.63819","12","0","0","0","0","0","0","12","2","6","3","0","11","4","3","6","0","13","2","2","9","0","0","13"
"Miami","36.87451","-94.87746","12","0","0","0","0","0","0","12","2","6","3","0","11","4","3","6","0","13","2","2","9","0","0","13"
"Miami","25.77427","-80.19366","12","0","0","0","0","0","0","12","2","6","3","0","11","4","3","6","0","13","2","2","9","0","0","13"
"Miami","-28.07173","153.44158","12","0","0","0","0","0","0","12","2","6","3","0","11","4","3","6","0","13","2","2","9","0","0","13"
"Miami Beach","25.79065","-80.13005","2","0","0","0","0","0","0","2","0","1","0","0","1","1","0","1","0","2","1","0","0","1","0","2"
"Miami Gardens","25.94204","-80.2456","1","0","0","0","0","0","0","1","0","1","0","0","1","1","0","0","0","1","1","0","0","0","0","1"
"Miami Gardens","25.97981","-80.20255","1","0","0","0","0","0","0","1","0","1","0","0","1","1","0","0","0","1","1","0","0","0","0","1"
"Miami Lakes","25.90871","-80.30866","1","0","0","0","0","0","0","1","0","0","1","0","1","0","1","0","0","1","0","1","0","0","0","1"
"Miano","40.88816","14.25339","1","0","0","0","0","0","0","1","0","0","0","0","0","0","0","1","0","1","1","0","0","0","0","1"
"Mianwali","32.57756","71.52847","3","0","0","0","0","0","0","3","1","0","0","1","2","1","2","0","0","3","2","0","1","0","0","3"
"Middleham","54.28592","-1.80838","1","0","0","0","0","0","0","1","0","0","0","0","0","0","0","1","0","1","0","1","0","0","0","1"
"Middlesbrough","54.57623","-1.23483","20","1","0","1","2","0","0","24","3","13","5","1","22","6","2","15","1","24","7","4","12","0","1","24"
"Middlewich","53.19296","-2.44402","2","0","0","0","0","0","0","2","0","0","2","0","2","1","1","0","0","2","0","0","2","0","0","2"
"Midelt","32.6852","-4.74512","1","0","0","0","0","0","0","1","0","1","0","0","1","0","0","1","0","1","0","0","1","0","0","1"
"Midhurst","50.98559","-0.74003","2","0","0","0","0","0","0","2","0","1","1","0","2","1","0","1","0","2","0","1","1","0","0","2"
"Midland","47.16704","-122.40484","1","0","0","0","0","0","0","1","0","1","0","0","1","0","1","0","0","1","1","0","0","0","0","1"
"Midland","31.99735","-102.07791","1","0","0","0","0","0","0","1","0","1","0","0","1","0","1","0","0","1","1","0","0","0","0","1"
"Midland","43.61558","-84.24721","1","0","0","0","0","0","0","1","0","1","0","0","1","0","1","0","0","1","1","0","0","0","0","1"
"Midland","35.22737","-80.50062","1","0","0","0","0","0","0","1","0","1","0","0","1","0","1","0","0","1","1","0","0","0","0","1"
"Midland","40.63257","-80.44645","1","0","0","0","0","0","0","1","0","1","0","0","1","0","1","0","0","1","1","0","0","0","0","1"
"Midland","40.25896","-80.21811","1","0","0","0","0","0","0","1","0","1","0","0","1","0","1","0","0","1","1","0","0","0","0","1"
"Midland","44.7501","-79.88296","1","0","0","0","0","0","0","1","0","1","0","0","1","0","1","0","0","1","1","0","0","0","0","1"
"Midland","-31.88909","116.0107","1","0","0","0","0","0","0","1","0","1","0","0","1","0","1","0","0","1","1","0","0","0","0","1"
"Midsomer Norton","51.28567","-2.48591","5","0","0","0","0","0","0","5","1","0","3","0","4","2","0","3","0","5","1","3","1","0","0","5"
"Midway","40.51218","-111.47435","1","0","0","0","0","0","0","1","0","0","0","0","0","1","0","0","0","1","0","0","1","0","0","1"
"Midway","33.29482","-104.45052","1","0","0","0","0","0","0","1","0","0","0","0","0","1","0","0","0","1","0","0","1","0","0","1"
"Midway","36.38534","-92.46183","1","0","0","0","0","0","0","1","0","0","0","0","0","1","0","0","0","1","0","0","1","0","0","1"
"Midway","31.69212","-92.15236","1","0","0","0","0","0","0","1","0","0","0","0","0","1","0","0","0","1","0","0","1","0","0","1"
"Midway","30.40648","-87.00553","1","0","0","0","0","0","0","1","0","0","0","0","0","1","0","0","0","1","0","0","1","0","0","1"
"Midway","38.15091","-84.68383","1","0","0","0","0","0","0","1","0","0","0","0","0","1","0","0","0","1","0","0","1","0","0","1"
"Midway","30.49548","-84.45435","1","0","0","0","0","0","0","1","0","0","0","0","0","1","0","0","0","1","0","0","1","0","0","1"
"Midway","36.30011","-82.42375","1","0","0","0","0","0","0","1","0","0","0","0","0","1","0","0","0","1","0","0","1","0","0","1"
"Midway","31.80577","-81.43066","1","0","0","0","0","0","0","1","0","0","0","0","0","1","0","0","0","1","0","0","1","0","0","1"
"Midway","28.79027","-81.2309","1","0","0","0","0","0","0","1","0","0","0","0","0","1","0","0","0","1","0","0","1","0","0","1"
"Midway","40.36924","-80.29284","1","0","0","0","0","0","0","1","0","0","0","0","0","1","0","0","0","1","0","0","1","0","0","1"
"Midway","35.95347","-80.2181","1","0","0","0","0","0","0","1","0","0","0","0","0","1","0","0","0","1","0","0","1","0","0","1"
"Midway","39.80843","-77.00276","1","0","0","0","0","0","0","1","0","0","0","0","0","1","0","0","0","1","0","0","1","0","0","1"
"Miercurea-Ciuc","46.35","25.8","3","0","0","0","0","0","0","3","1","0","1","0","2","1","0","2","0","3","0","1","2","0","0","3"
"Migdal Ha‘Emeq","32.67597","35.23986","1","0","0","0","0","0","0","1","0","0","0","0","0","0","1","0","0","1","0","0","1","0","0","1"
"Migori","-1.06343","34.47313","2","0","0","0","0","0","0","2","0","1","0","0","1","2","0","0","0","2","0","0","0","0","2","2"
"Mikulov","48.80556","16.6378","1","0","0","0","0","0","0","1","0","1","0","0","1","1","0","0","0","1","1","0","0","0","0","1"
"Mila","36.45028","6.26444","4","0","0","0","0","0","0","4","3","0","1","0","4","2","0","2","0","4","0","2","2","0","0","4"
"Milan","35.16976","-107.89089","18","0","0","0","0","1","0","19","2","1","0","0","3","5","3","11","0","19","9","2","8","0","0","19"
"Milan","40.20224","-93.12521","18","0","0","0","0","1","0","19","2","1","0","0","3","5","3","11","0","19","9","2","8","0","0","19"
"Milan","41.45309","-90.57208","18","0","0","0","0","1","0","19","2","1","0","0","3","5","3","11","0","19","9","2","8","0","0","19"
"Milan","35.91979","-88.75895","18","0","0","0","0","1","0","19","2","1","0","0","3","5","3","11","0","19","9","2","8","0","0","19"
"Milan","39.12117","-85.13135","18","0","0","0","0","1","0","19","2","1","0","0","3","5","3","11","0","19","9","2","8","0","0","19"
"Milan","42.08532","-83.68244","18","0","0","0","0","1","0","19","2","1","0","0","3","5","3","11","0","19","9","2","8","0","0","19"
"Milan","32.0174","-83.06265","18","0","0","0","0","1","0","19","2","1","0","0","3","5","3","11","0","19","9","2","8","0","0","19"
"Milan","41.29755","-82.60545","18","0","0","0","0","1","0","19","2","1","0","0","3","5","3","11","0","19","9","2","8","0","0","19"
"Milan","44.57339","-71.18508","18","0","0","0","0","1","0","19","2","1","0","0","3","5","3","11","0","19","9","2","8","0","0","19"
"Milan","45.46427","9.18951","18","0","0","0","0","1","0","19","2","1","0","0","3","5","3","11","0","19","9","2","8","0","0","19"
"Mildenhall","51.4256","-1.69988","1","0","0","0","0","0","0","1","0","1","0","0","1","0","0","1","0","1","1","0","0","0","0","1"
"Mildenhall","52.34446","0.51086","1","0","0","0","0","0","0","1","0","1","0","0","1","0","0","1","0","1","1","0","0","0","0","1"
"Milford","38.39691","-113.01079","2","0","0","0","0","0","0","2","0","0","1","0","1","1","0","1","0","2","0","1","1","0","0","2"
"Milford","40.77445","-97.05059","2","0","0","0","0","0","0","2","0","0","1","0","1","1","0","1","0","2","0","1","1","0","0","2"
"Milford","32.1246","-96.94528","2","0","0","0","0","0","0","2","0","0","1","0","1","1","0","1","0","2","0","1","1","0","0","2"
"Milford","39.16833","-96.91251","2","0","0","0","0","0","0","2","0","0","1","0","1","1","0","1","0","2","0","1","1","0","0","2"
"Milford","43.32469","-95.15","2","0","0","0","0","0","0","2","0","0","1","0","1","1","0","1","0","2","0","1","1","0","0","2"
"Milford","43.10083","-88.84677","2","0","0","0","0","0","0","2","0","0","1","0","1","1","0","1","0","2","0","1","1","0","0","2"
"Milford","40.62837","-87.69614","2","0","0","0","0","0","0","2","0","0","1","0","1","1","0","1","0","2","0","1","1","0","0","2"
"Milford","41.40977","-85.84555","2","0","0","0","0","0","0","2","0","0","1","0","1","1","0","1","0","2","0","1","1","0","0","2"
"Milford","39.17534","-84.29438","2","0","0","0","0","0","0","2","0","0","1","0","1","1","0","1","0","2","0","1","1","0","0","2"
"Milford","42.59364","-83.59939","2","0","0","0","0","0","0","2","0","0","1","0","1","1","0","1","0","2","0","1","1","0","0","2"
"Milford","39.95313","-79.10419","2","0","0","0","0","0","0","2","0","0","1","0","1","1","0","1","0","2","0","1","1","0","0","2"
"Milford","38.91261","-75.42797","2","0","0","0","0","0","0","2","0","0","1","0","1","1","0","1","0","2","0","1","1","0","0","2"
"Milford","40.56871","-75.09462","2","0","0","0","0","0","0","2","0","0","1","0","1","1","0","1","0","2","0","1","1","0","0","2"
"Milford","41.32232","-74.80239","2","0","0","0","0","0","0","2","0","0","1","0","1","1","0","1","0","2","0","1","1","0","0","2"
"Milford","41.22232","-73.0565","2","0","0","0","0","0","0","2","0","0","1","0","1","1","0","1","0","2","0","1","1","0","0","2"
"Milford","42.83536","-71.64896","2","0","0","0","0","0","0","2","0","0","1","0","1","1","0","1","0","2","0","1","1","0","0","2"
"Milford","42.13982","-71.51617","2","0","0","0","0","0","0","2","0","0","1","0","1","1","0","1","0","2","0","1","1","0","0","2"
"Milford","44.94618","-68.64392","2","0","0","0","0","0","0","2","0","0","1","0","1","1","0","1","0","2","0","1","1","0","0","2"
"Milford","51.17272","-0.65042","2","0","0","0","0","0","0","2","0","0","1","0","1","1","0","1","0","2","0","1","1","0","0","2"
"Milford Haven","51.71278","-5.0341","26","2","0","2","4","0","1","35","15","3","3","0","21","14","2","16","3","35","16","17","2","0","0","35"
"Milland","51.03117","-0.80376","1","0","0","0","0","0","0","1","1","0","0","0","1","1","0","0","0","1","0","1","0","0","0","1"
"Millom","54.21072","-3.272","1","0","0","0","0","0","0","1","0","1","0","0","1","1","0","0","0","1","0","1","0","0","0","1"
"Mill Valley","37.90604","-122.54498","1","0","0","0","0","0","0","1","1","0","0","0","1","1","0","0","0","1","0","1","0","0","0","1"
"Milnthorpe","54.22785","-2.76939","1","0","0","0","0","0","0","1","0","0","1","0","1","0","0","1","0","1","0","1","0","0","0","1"
"Milpitas","37.42827","-121.90662","1","0","0","0","0","0","0","1","0","0","1","0","1","0","0","1","0","1","0","0","1","0","0","1"
"Milton","47.24816","-122.3129","1","0","0","0","0","0","0","1","1","0","0","0","1","0","0","1","0","1","0","0","1","0","0","1"
"Milton","30.10381","-92.07651","1","0","0","0","0","0","0","1","1","0","0","0","1","0","0","1","0","1","0","0","1","0","0","1"
"Milton","42.77556","-88.944","1","0","0","0","0","0","0","1","1","0","0","0","1","0","0","1","0","1","0","0","1","0","0","1"
"Milton","30.63241","-87.03969","1","0","0","0","0","0","0","1","1","0","0","0","1","0","0","1","0","1","0","0","1","0","0","1"
"Milton","38.72367","-85.3694","1","0","0","0","0","0","0","1","1","0","0","0","1","0","0","1","0","1","0","0","1","0","0","1"
"Milton","34.13216","-84.30067","1","0","0","0","0","0","0","1","1","0","0","0","1","0","0","1","0","1","0","0","1","0","0","1"
"Milton","38.43453","-82.13236","1","0","0","0","0","0","0","1","1","0","0","0","1","0","0","1","0","1","0","0","1","0","0","1"
"Milton","43.51681","-79.88294","1","0","0","0","0","0","0","1","1","0","0","0","1","0","0","1","0","1","0","0","1","0","0","1"
"Milton","41.01203","-76.84774","1","0","0","0","0","0","0","1","1","0","0","0","1","0","0","1","0","1","0","0","1","0","0","1"
"Milton","38.77761","-75.30991","1","0","0","0","0","0","0","1","1","0","0","0","1","0","0","1","0","1","0","0","1","0","0","1"
"Milton","41.65982","-73.95708","1","0","0","0","0","0","0","1","1","0","0","0","1","0","0","1","0","1","0","0","1","0","0","1"
"Milton","43.03369","-73.85262","1","0","0","0","0","0","0","1","1","0","0","0","1","0","0","1","0","1","0","0","1","0","0","1"
"Milton","44.63977","-73.11041","1","0","0","0","0","0","0","1","1","0","0","0","1","0","0","1","0","1","0","0","1","0","0","1"
"Milton","42.24954","-71.06616","1","0","0","0","0","0","0","1","1","0","0","0","1","0","0","1","0","1","0","0","1","0","0","1"
"Milton","43.4098","-70.9884","1","0","0","0","0","0","0","1","1","0","0","0","1","0","0","1","0","1","0","0","1","0","0","1"
"Milton","55.93658","-4.51907","1","0","0","0","0","0","0","1","1","0","0","0","1","0","0","1","0","1","0","0","1","0","0","1"
"Milton","57.33949","-4.50457","1","0","0","0","0","0","0","1","1","0","0","0","1","0","0","1","0","1","0","0","1","0","0","1"
"Milton","-35.31644","150.4361","1","0","0","0","0","0","0","1","1","0","0","0","1","0","0","1","0","1","0","0","1","0","0","1"
"Milton","-27.47039","153.00312","1","0","0","0","0","0","0","1","1","0","0","0","1","0","0","1","0","1","0","0","1","0","0","1"
"Milton","-46.12083","169.96944","1","0","0","0","0","0","0","1","1","0","0","0","1","0","0","1","0","1","0","0","1","0","0","1"
"Milton Keynes","52.04172","-0.75583","60","1","0","0","8","0","1","70","11","11","28","0","50","20","5","45","0","70","4","19","47","0","0","70"
"Milwaukee","43.0389","-87.90647","3","0","0","0","1","0","0","4","1","0","0","0","1","3","0","1","0","4","1","0","3","0","0","4"
"Minchianabad","30.16356","73.56858","2","0","0","0","0","0","0","2","2","0","0","0","2","1","1","0","0","2","0","0","2","0","0","2"
"Mindelo","16.89014","-24.98042","1","0","0","0","0","0","0","1","0","1","0","0","1","1","0","0","0","1","0","0","1","0","0","1"
"Mindelo","41.31527","-8.72124","1","0","0","0","0","0","0","1","0","1","0","0","1","1","0","0","0","1","0","0","1","0","0","1"
"Minehead","51.20452","-3.48284","1","0","0","0","1","0","0","2","1","1","0","0","2","1","0","1","0","2","1","1","0","0","0","2"
"Mingelchaur","40.76395","47.05953","1","0","0","0","0","0","0","1","0","0","0","0","0","1","0","0","0","1","0","0","1","0","0","1"
"Mingora","34.7795","72.36265","7","0","0","0","2","0","0","9","4","0","3","1","8","4","1","4","0","9","0","1","8","0","0","9"
"Minneapolis","39.12194","-97.7067","3","0","0","0","0","0","0","3","2","1","0","0","3","1","0","2","0","3","0","0","3","0","0","3"
"Minneapolis","44.97997","-93.26384","3","0","0","0","0","0","0","3","2","1","0","0","3","1","0","2","0","3","0","0","3","0","0","3"
"Minsk","53.9","27.56667","4","2","0","0","0","0","0","6","1","1","2","1","5","2","2","2","0","6","2","1","3","0","0","6"
"Minyat an Naşr","31.12624","31.64313","0","0","0","0","0","0","1","1","1","0","0","0","1","0","1","0","0","1","0","0","1","0","0","1"
"Mirfield","53.67343","-1.69636","1","0","0","0","0","0","0","1","0","1","0","0","1","0","0","1","0","1","0","0","1","0","0","1"
"Miri","4.39928","113.99163","2","0","0","0","0","0","0","2","1","0","1","0","2","0","0","2","0","2","1","0","1","0","0","2"
"Mirpur Khas","25.5276","69.01255","1","0","0","0","0","0","0","1","1","0","0","0","1","0","1","0","0","1","0","0","1","0","0","1"
"Mirzāpur","25.1449","82.56534","2","0","0","0","0","0","0","2","2","0","0","0","2","1","0","1","0","2","0","0","2","0","0","2"
"Mirzāpur","24.10287","90.09841","2","0","0","0","0","0","0","2","2","0","0","0","2","1","0","1","0","2","0","0","2","0","0","2"
"Mişrātah","32.37535","15.09254","4","1","0","0","0","0","0","5","1","1","1","0","3","0","3","2","0","5","2","2","1","0","0","5"
"Mission Viejo","33.60002","-117.672","1","0","0","0","0","0","0","1","1","0","0","0","1","0","0","1","0","1","0","0","1","0","0","1"
"Mississauga","43.5789","-79.6583","8","0","1","1","0","0","0","10","6","1","1","0","8","3","3","4","0","10","1","2","7","0","0","10"
"Missoula","46.87215","-113.994","1","0","0","0","0","0","0","1","0","0","0","0","0","1","0","0","0","1","1","0","0","0","0","1"
"Mithi","24.73701","69.79707","3","0","0","0","0","0","0","3","0","1","0","0","1","1","1","1","0","3","0","0","3","0","0","3"
"Mitrovicë","42.88333","20.86667","1","0","0","0","0","0","0","1","0","0","1","0","1","0","0","1","0","1","0","0","1","0","0","1"
"Mixco","14.63077","-90.60711","2","0","0","0","0","0","0","2","2","0","0","0","2","0","1","1","0","2","1","0","1","0","0","2"
"Mkushi","-13.62015","29.3939","3","0","0","0","0","0","0","3","0","1","0","0","1","2","0","0","1","3","0","0","1","0","2","3"
"Mochudi","-24.41667","26.15","1","0","0","0","0","0","0","1","0","1","0","0","1","1","0","0","0","1","1","0","0","0","0","1"
"Modena","39.96201","-75.80026","1","0","0","0","0","0","0","1","1","0","0","0","1","0","1","0","0","1","0","1","0","0","0","1"
"Modena","44.64783","10.92539","1","0","0","0","0","0","0","1","1","0","0","0","1","0","1","0","0","1","0","1","0","0","0","1"
"Modesto","37.6391","-120.99688","0","0","0","0","1","0","0","1","0","0","1","0","1","1","0","0","0","1","0","0","1","0","0","1"
"Mogadishu","2.03711","45.34375","35","2","1","0","0","0","0","38","13","7","4","9","33","25","4","4","5","38","11","10","11","6","0","38"
"Mogán","27.88385","-15.72538","1","0","0","0","0","0","0","1","0","0","0","0","0","0","0","1","0","1","0","1","0","0","0","1"
"Mohale’s Hoek","-30.15137","27.47691","0","0","0","1","0","0","0","1","1","0","0","0","1","1","0","0","0","1","0","0","1","0","0","1"
"Mohali","30.67995","76.72211","2","0","0","0","0","0","0","2","2","0","0","0","2","1","0","1","0","2","0","0","2","0","0","2"
"Mohammedia","33.68607","-7.38298","2","0","0","0","0","0","0","2","1","0","0","0","1","2","0","0","0","2","1","0","1","0","0","2"
"Moira","54.48021","-6.22822","1","0","0","0","1","0","0","2","1","1","0","0","2","1","0","1","0","2","0","0","2","0","0","2"
"Moira","52.73698","-1.53496","1","0","0","0","1","0","0","2","1","1","0","0","2","1","0","1","0","2","0","0","2","0","0","2"
"Mold","53.16674","-3.14143","16","0","0","0","3","0","1","20","3","9","5","0","17","6","3","11","0","20","2","8","9","0","1","20"
"Molepolole","-24.40659","25.49508","1","0","0","0","0","0","0","1","0","1","0","0","1","1","0","0","0","1","1","0","0","0","0","1"
"Mölndal","57.6554","12.01378","0","0","0","0","1","0","0","1","0","0","0","1","1","0","0","1","0","1","0","0","1","0","0","1"
"Molong","-33.09233","148.87002","1","0","0","0","0","0","0","1","0","1","0","0","1","1","0","0","0","1","1","0","0","0","0","1"
"Mombasa","-4.05466","39.66359","10","2","0","0","0","0","0","12","1","4","2","2","9","6","4","2","0","12","2","1","3","2","4","12"
"Monaghan","54.25","-6.96667","2","0","0","0","0","0","0","2","0","0","1","0","1","1","0","1","0","2","1","0","1","0","0","2"
"Monahans","31.5943","-102.89265","1","0","0","0","0","0","0","1","0","1","0","0","1","0","0","0","1","1","0","0","1","0","0","1"
"Monastir","39.3836","9.04445","7","0","0","0","0","0","0","7","0","3","1","0","4","1","5","1","0","7","2","1","3","0","1","7"
"Monastir","35.77799","10.82617","7","0","0","0","0","0","0","7","0","3","1","0","4","1","5","1","0","7","2","1","3","0","1","7"
"Moneymore","54.69229","-6.66956","1","0","0","0","0","0","0","1","0","1","0","0","1","1","0","0","0","1","1","0","0","0","0","1"
"Moniga del Garda","45.52665","10.53728","1","0","0","0","0","0","0","1","1","0","0","0","1","0","0","1","0","1","0","1","0","0","0","1"
"Monkton","55.51356","-4.59339","1","0","0","0","0","0","0","1","1","0","0","0","1","1","0","0","0","1","0","1","0","0","0","1"
"Monmouth","44.84845","-123.23399","1","0","0","0","1","0","0","2","1","1","0","0","2","1","0","1","0","2","0","2","0","0","0","2"
"Monmouth","40.91143","-90.64736","1","0","0","0","1","0","0","2","1","1","0","0","2","1","0","1","0","2","0","2","0","0","0","2"
"Monmouth","44.23868","-70.03561","1","0","0","0","1","0","0","2","1","1","0","0","2","1","0","1","0","2","0","2","0","0","0","2"
"Monmouth","51.81265","-2.71363","1","0","0","0","1","0","0","2","1","1","0","0","2","1","0","1","0","2","0","2","0","0","0","2"
"Monrovia","34.14806","-117.99895","12","1","0","0","1","0","0","14","3","7","2","0","12","6","3","3","1","13","4","2","6","1","0","13"
"Monrovia","39.57894","-86.48222","12","1","0","0","1","0","0","14","3","7","2","0","12","6","3","3","1","13","4","2","6","1","0","13"
"Monrovia","6.30054","-10.7969","12","1","0","0","1","0","0","14","3","7","2","0","12","6","3","3","1","13","4","2","6","1","0","13"
"Montalto di Castro","42.34983","11.60788","0","1","0","0","0","0","0","1","1","0","0","0","1","0","0","1","0","1","0","1","0","0","0","1"
"Montería","8.74798","-75.88143","1","0","0","0","0","0","0","1","0","0","1","0","1","0","1","0","0","1","0","0","1","0","0","1"
"Monterrey","25.4895","-103.62673","4","0","0","0","1","0","0","5","1","2","1","1","5","1","1","2","1","5","0","2","3","0","0","5"
"Monterrey","25.67507","-100.31847","4","0","0","0","1","0","0","5","1","2","1","1","5","1","1","2","1","5","0","2","3","0","0","5"
"Monterrey","18.74028","-97.14639","4","0","0","0","1","0","0","5","1","2","1","1","5","1","1","2","1","5","0","2","3","0","0","5"
"Monterrey","16.06191","-93.36928","4","0","0","0","1","0","0","5","1","2","1","1","5","1","1","2","1","5","0","2","3","0","0","5"
"Monterrey","16.91975","-93.24161","4","0","0","0","1","0","0","5","1","2","1","1","5","1","1","2","1","5","0","2","3","0","0","5"
"Monterrey","15.71444","-92.89139","4","0","0","0","1","0","0","5","1","2","1","1","5","1","1","2","1","5","0","2","3","0","0","5"
"Monterrey","15.58333","-87.88333","4","0","0","0","1","0","0","5","1","2","1","1","5","1","1","2","1","5","0","2","3","0","0","5"
"Monterrey","9.7573","-84.10956","4","0","0","0","1","0","0","5","1","2","1","1","5","1","1","2","1","5","0","2","3","0","0","5"
"Monterrey","4.87802","-72.89575","4","0","0","0","1","0","0","5","1","2","1","1","5","1","1","2","1","5","0","2","3","0","0","5"
"Montevarchi","43.5252","11.57238","1","0","0","0","0","0","0","1","0","1","0","0","1","1","0","0","0","1","1","0","0","0","0","1"
"Montevideo","44.94803","-95.71701","4","0","0","0","0","0","0","4","0","1","0","0","1","2","2","0","0","4","3","0","1","0","0","4"
"Montevideo","-6.61583","-77.8025","4","0","0","0","0","0","0","4","0","1","0","0","1","2","2","0","0","4","3","0","1","0","0","4"
"Montevideo","-34.90328","-56.18816","4","0","0","0","0","0","0","4","0","1","0","0","1","2","2","0","0","4","3","0","1","0","0","4"
"Montgomery","30.38826","-95.69634","3","0","0","1","0","0","0","4","2","0","1","0","3","1","1","2","0","4","1","1","2","0","0","4"
"Montgomery","44.43885","-93.58134","3","0","0","1","0","0","0","4","2","0","1","0","3","1","1","2","0","4","1","1","2","0","0","4"
"Montgomery","31.66739","-92.89071","3","0","0","1","0","0","0","4","2","0","1","0","3","1","1","2","0","4","1","1","2","0","0","4"
"Montgomery","41.73058","-88.3459","3","0","0","1","0","0","0","4","2","0","1","0","3","1","1","2","0","4","1","1","2","0","0","4"
"Montgomery","32.36681","-86.29997","3","0","0","1","0","0","0","4","2","0","1","0","3","1","1","2","0","4","1","1","2","0","0","4"
"Montgomery","39.22811","-84.35411","3","0","0","1","0","0","0","4","2","0","1","0","3","1","1","2","0","4","1","1","2","0","0","4"
"Montgomery","38.18038","-81.32845","3","0","0","1","0","0","0","4","2","0","1","0","3","1","1","2","0","4","1","1","2","0","0","4"
"Montgomery","31.94049","-81.12205","3","0","0","1","0","0","0","4","2","0","1","0","3","1","1","2","0","4","1","1","2","0","0","4"
"Montgomery","41.17036","-76.87691","3","0","0","1","0","0","0","4","2","0","1","0","3","1","1","2","0","4","1","1","2","0","0","4"
"Montgomery","41.52759","-74.23682","3","0","0","1","0","0","0","4","2","0","1","0","3","1","1","2","0","4","1","1","2","0","0","4"
"Montgomery","42.20676","-72.8051","3","0","0","1","0","0","0","4","2","0","1","0","3","1","1","2","0","4","1","1","2","0","0","4"
"Montgomery","44.90255","-72.63818","3","0","0","1","0","0","0","4","2","0","1","0","3","1","1","2","0","4","1","1","2","0","0","4"
"Montgomery","52.56133","-3.14612","3","0","0","1","0","0","0","4","2","0","1","0","3","1","1","2","0","4","1","1","2","0","0","4"
"Montluçon","46.34015","2.60254","1","0","0","0","0","0","0","1","0","1","0","0","1","0","1","0","0","1","0","0","0","0","1","1"
"Montpellier","43.61092","3.87723","2","0","0","0","0","0","0","2","0","0","2","0","2","0","0","2","0","2","0","1","1","0","0","2"
"Montréal","45.50884","-73.58781","6","0","0","0","0","0","0","6","0","1","0","0","1","2","1","3","0","6","1","1","3","0","1","6"
"Montréal","43.95016","0.20358","6","0","0","0","0","0","0","6","0","1","0","0","1","2","1","3","0","6","1","1","3","0","1","6"
"Montréal","43.1998","2.14122","6","0","0","0","0","0","0","6","0","1","0","0","1","2","1","3","0","6","1","1","3","0","1","6"
"Montrose","38.47832","-107.87617","0","1","0","0","0","0","0","1","0","0","1","0","1","0","0","1","0","1","0","0","1","0","0","1"
"Montrose","45.06496","-93.91108","0","1","0","0","0","0","0","1","0","0","1","0","1","0","0","1","0","1","0","0","1","0","0","1"
"Montrose","40.53226","-91.41488","0","1","0","0","0","0","0","1","0","0","1","0","1","0","0","1","0","1","0","0","1","0","0","1"
"Montrose","43.17669","-83.89274","0","1","0","0","0","0","0","1","0","0","1","0","1","0","0","1","0","1","0","0","1","0","0","1"
"Montrose","37.5207","-77.37831","0","1","0","0","0","0","0","1","0","0","1","0","1","0","0","1","0","1","0","0","1","0","0","1"
"Montrose","40.30648","-75.98771","0","1","0","0","0","0","0","1","0","0","1","0","1","0","0","1","0","1","0","0","1","0","0","1"
"Montrose","41.83397","-75.87714","0","1","0","0","0","0","0","1","0","0","1","0","1","0","0","1","0","1","0","0","1","0","0","1"
"Montrose","41.25232","-73.93153","0","1","0","0","0","0","0","1","0","0","1","0","1","0","0","1","0","1","0","0","1","0","0","1"
"Montrose","56.71683","-2.46695","0","1","0","0","0","0","0","1","0","0","1","0","1","0","0","1","0","1","0","0","1","0","0","1"
"Montrose","-37.81667","145.35","0","1","0","0","0","0","0","1","0","0","1","0","1","0","0","1","0","1","0","0","1","0","0","1"
"Montrose","-42.82895","147.24735","0","1","0","0","0","0","0","1","0","0","1","0","1","0","0","1","0","1","0","0","1","0","0","1"
"Montvale","37.38458","-79.73115","0","0","0","0","1","0","0","1","0","0","1","0","1","0","1","0","0","1","0","0","1","0","0","1"
"Montvale","41.04676","-74.02292","0","0","0","0","1","0","0","1","0","0","1","0","1","0","1","0","0","1","0","0","1","0","0","1"
"Monze","-16.28333","27.48333","1","0","0","0","0","0","0","1","0","0","1","0","1","0","0","1","0","1","0","1","0","0","0","1"
"Moone","52.97556","-6.815","1","0","0","0","0","0","0","1","0","0","0","0","0","1","0","0","0","1","0","0","1","0","0","1"
"Mooresville","39.61282","-86.37416","0","0","0","1","0","0","0","1","1","0","0","0","1","0","0","1","0","1","0","0","1","0","0","1"
"Mooresville","35.58486","-80.81007","0","0","0","1","0","0","0","1","1","0","0","0","1","0","0","1","0","1","0","0","1","0","0","1"
"Moor Row","54.51515","-3.53725","1","0","0","0","0","0","0","1","0","1","0","0","1","1","0","0","0","1","0","0","1","0","0","1"
"Mora","35.9742","-105.33001","1","0","0","0","0","0","0","1","0","0","0","0","0","1","0","0","0","1","1","0","0","0","0","1"
"Mora","21.52651","-104.8103","1","0","0","0","0","0","0","1","0","0","0","0","0","1","0","0","0","1","1","0","0","0","0","1"
"Mora","45.8769","-93.29384","1","0","0","0","0","0","0","1","0","0","0","0","0","1","0","0","0","1","1","0","0","0","0","1"
"Mora","18.463","-67.03268","1","0","0","0","0","0","0","1","0","0","0","0","0","1","0","0","0","1","1","0","0","0","0","1"
"Mora","38.94351","-8.16434","1","0","0","0","0","0","0","1","0","0","0","0","0","1","0","0","0","1","1","0","0","0","0","1"
"Mora","39.68492","-3.77394","1","0","0","0","0","0","0","1","0","0","0","0","0","1","0","0","0","1","1","0","0","0","0","1"
"Mora","11.04611","14.14011","1","0","0","0","0","0","0","1","0","0","0","0","0","1","0","0","0","1","1","0","0","0","0","1"
"Mora","61.00704","14.54316","1","0","0","0","0","0","0","1","0","0","0","0","0","1","0","0","0","1","1","0","0","0","0","1"
"Mora","60.4","15.6","1","0","0","0","0","0","0","1","0","0","0","0","0","1","0","0","0","1","1","0","0","0","0","1"
"Moraḯtika","39.48467","19.92469","2","0","0","0","0","0","0","2","0","2","0","0","2","0","0","2","0","2","1","0","1","0","0","2"
"Morden","49.1919","-98.10136","6","0","0","0","0","0","0","6","1","1","1","0","3","1","1","4","0","6","0","2","4","0","0","6"
"Morden","51.39822","-0.19837","6","0","0","0","0","0","0","6","1","1","1","0","3","1","1","4","0","6","0","2","4","0","0","6"
"Morecambe","54.06835","-2.86108","2","0","0","0","0","0","1","3","0","2","1","0","3","2","0","1","0","3","1","1","0","0","1","3"
"Moreton","53.4","-3.11667","1","0","0","0","1","0","0","2","1","0","1","0","2","0","0","2","0","2","0","1","1","0","0","2"
"Moreton in Marsh","51.98964","-1.70297","2","0","0","0","0","0","0","2","0","0","1","0","1","0","0","2","0","2","0","0","2","0","0","2"
"Morley","37.04366","-89.61036","1","0","0","0","0","0","0","1","0","1","0","0","1","0","0","1","0","1","0","0","0","0","1","1"
"Morley","53.74013","-1.59877","1","0","0","0","0","0","0","1","0","1","0","0","1","0","0","1","0","1","0","0","0","0","1","1"
"Morley","-31.88775","115.9099","1","0","0","0","0","0","0","1","0","1","0","0","1","0","0","1","0","1","0","0","0","0","1","1"
"Moro","45.48401","-120.73117","0","1","0","0","0","0","0","1","1","0","0","0","1","1","0","0","0","1","0","0","1","0","0","1"
"Moro","-9.13889","-78.18194","0","1","0","0","0","0","0","1","1","0","0","0","1","1","0","0","0","1","0","0","1","0","0","1"
"Moro","45.9061","12.2826","0","1","0","0","0","0","0","1","1","0","0","0","1","1","0","0","0","1","0","0","1","0","0","1"
"Moro","26.66317","68.00016","0","1","0","0","0","0","0","1","1","0","0","0","1","1","0","0","0","1","0","0","1","0","0","1"
"Moro","0.75417","103.70833","0","1","0","0","0","0","0","1","1","0","0","0","1","1","0","0","0","1","0","0","1","0","0","1"
"Morogoro","-6.82102","37.66122","2","0","0","0","0","0","0","2","1","1","0","1","3","2","0","1","0","3","0","0","2","0","0","2"
"Morón","22.10774","-78.62667","1","0","0","0","0","0","0","1","0","1","0","0","1","0","0","1","0","1","0","0","0","1","0","1"
"Morón","10.48715","-68.20078","1","0","0","0","0","0","0","1","0","1","0","0","1","0","0","1","0","1","0","0","0","1","0","1"
"Morón","-34.6509","-58.61956","1","0","0","0","0","0","0","1","0","1","0","0","1","0","0","1","0","1","0","0","0","1","0","1"
"Morpeth","55.16882","-1.68893","11","0","0","0","1","0","0","12","3","1","3","0","7","5","2","5","0","12","2","4","6","0","0","12"
"Morpeth","-32.73333","151.63333","11","0","0","0","1","0","0","12","3","1","3","0","7","5","2","5","0","12","2","4","6","0","0","12"
"Mortdale","-33.96897","151.07231","1","0","0","0","0","0","0","1","0","0","0","1","1","0","1","0","0","1","0","0","0","0","0","0"
"Moscow","46.73239","-117.00017","11","0","0","1","0","0","1","13","1","5","1","2","9","8","3","2","0","13","3","1","5","4","0","13"
"Moscow","35.06203","-89.40396","11","0","0","1","0","0","1","13","1","5","1","2","9","8","3","2","0","13","3","1","5","4","0","13"
"Moscow","41.33675","-75.51852","11","0","0","1","0","0","1","13","1","5","1","2","9","8","3","2","0","13","3","1","5","4","0","13"
"Moscow","45.07061","-69.89117","11","0","0","1","0","0","1","13","1","5","1","2","9","8","3","2","0","13","3","1","5","4","0","13"
"Moscow","55.75222","37.61556","11","0","0","1","0","0","1","13","1","5","1","2","9","8","3","2","0","13","3","1","5","4","0","13"
"Moshi","-3.35","37.33333","6","0","0","0","0","0","0","6","0","3","2","1","6","6","1","0","0","7","2","0","4","0","1","7"
"Moshi","29.76376","110.94904","6","0","0","0","0","0","0","6","0","3","2","1","6","6","1","0","0","7","2","0","4","0","1","7"
"Moshi","30.41487","111.23866","6","0","0","0","0","0","0","6","0","3","2","1","6","6","1","0","0","7","2","0","4","0","1","7"
"Mosman","-33.83902","151.23956","2","0","0","0","0","0","0","2","1","1","0","0","2","1","0","1","0","2","0","0","2","0","0","2"
"Mossley","53.51454","-2.03462","1","0","0","0","0","0","0","1","0","1","0","0","1","1","0","0","0","1","0","0","1","0","0","1"
"Mostaganem","35.93115","0.08918","2","0","0","0","0","0","0","2","1","0","1","0","2","1","0","1","0","2","0","2","0","0","0","2"
"Mostar","43.34333","17.80806","2","0","0","0","0","0","0","2","1","0","1","0","2","0","0","2","0","2","0","0","2","0","0","2"
"Mosul","36.335","43.11889","16","1","0","0","0","0","0","17","9","4","2","1","16","4","7","6","0","17","6","3","8","0","0","17"
"Motherwell","55.78924","-3.99187","8","1","0","0","0","0","0","9","2","5","2","0","9","4","0","5","0","9","3","2","3","0","1","9"
"Mountain Ash","51.68361","-3.38008","3","1","0","1","0","0","0","5","2","3","0","0","5","0","2","3","0","5","2","2","1","0","0","5"
"Mountain View","19.55583","-155.10806","0","1","0","0","0","0","0","1","1","0","0","0","1","0","0","1","0","1","0","0","1","0","0","1"
"Mountain View","38.00881","-122.11746","0","1","0","0","0","0","0","1","1","0","0","0","1","0","0","1","0","1","0","0","1","0","0","1"
"Mountain View","37.38605","-122.08385","0","1","0","0","0","0","0","1","1","0","0","0","1","0","0","1","0","1","0","0","1","0","0","1"
"Mountain View","41.26884","-110.33988","0","1","0","0","0","0","0","1","1","0","0","0","1","0","0","1","0","1","0","0","1","0","0","1"
"Mountain View","39.77443","-105.05554","0","1","0","0","0","0","0","1","1","0","0","0","1","0","0","1","0","1","0","0","1","0","0","1"
"Mountain View","35.09756","-98.74646","0","1","0","0","0","0","0","1","1","0","0","0","1","0","0","1","0","1","0","0","1","0","0","1"
"Mountain View","35.86841","-92.11765","0","1","0","0","0","0","0","1","1","0","0","0","1","0","0","1","0","1","0","0","1","0","0","1"
"Mountain View","36.99533","-91.70376","0","1","0","0","0","0","0","1","1","0","0","0","1","0","0","1","0","1","0","0","1","0","0","1"
"Mountain View","35.68319","-81.36898","0","1","0","0","0","0","0","1","1","0","0","0","1","0","0","1","0","1","0","0","1","0","0","1"
"Mountsorrel","52.71667","-1.15","1","0","0","0","0","0","0","1","1","0","0","0","1","0","0","1","0","1","0","1","0","0","0","1"
"Moyo","3.66088","31.72474","1","0","0","0","0","0","0","1","0","1","0","0","1","0","0","1","0","1","0","0","1","0","0","1"
"Mpanda","-6.34379","31.06951","0","0","0","0","0","0","0","0","0","1","0","0","1","0","0","1","0","1","0","0","0","0","1","1"
"Mpika","-11.83431","31.45287","3","0","0","0","0","0","0","3","1","2","0","0","3","3","0","0","0","3","0","0","2","0","1","3"
"Mthatha","-31.58893","28.78443","1","0","0","0","0","0","0","1","0","1","0","0","1","0","1","0","0","1","0","0","0","0","1","1"
"Mtwara","-10.26667","40.18333","2","0","0","0","0","0","0","2","0","1","0","1","2","1","1","0","0","2","0","0","1","0","1","2"
"Muang Khamkeut","18.22572","104.73119","1","0","0","0","0","0","0","1","1","0","0","0","1","0","0","0","1","1","0","0","1","0","0","1"
"Muar","2.0442","102.5689","1","0","0","0","0","0","0","1","0","0","0","0","0","0","0","1","0","1","1","0","0","0","0","1"
"Mubi","10.26858","13.26701","0","1","0","0","0","0","1","2","1","0","1","0","2","0","0","2","0","2","0","0","2","0","0","2"
"Mucheln","54.25","10.43333","0","1","0","0","0","0","0","1","1","0","0","0","1","0","1","0","0","1","0","1","0","0","0","1"
"Much Hadham","51.85407","0.07188","1","0","0","0","0","0","0","1","0","0","1","0","1","1","0","0","0","1","0","0","1","0","0","1"
"Much Wenlock","52.59582","-2.55749","2","0","0","0","0","0","0","2","1","0","0","0","1","1","1","0","0","2","0","2","0","0","0","2"
"Mufulira","-12.54982","28.24071","1","1","0","0","0","0","0","2","0","2","0","0","2","3","0","0","0","3","1","0","0","1","1","3"
"Muḩradah","35.2479","36.5725","0","0","0","0","0","0","0","0","0","0","0","0","0","0","0","0","0","0","0","0","0","0","0","0"
"Mukacheve","48.43919","22.71779","1","0","0","0","0","0","0","1","0","0","0","0","0","1","0","0","0","1","1","0","0","0","0","1"
"Mukono","0.35333","32.75528","1","1","0","0","0","0","0","2","1","1","0","0","2","2","0","0","0","2","1","0","1","0","0","2"
"Muktsar","30.47426","74.5166","0","0","0","0","0","0","1","1","1","0","0","0","1","0","0","1","0","1","0","0","0","0","1","1"
"Multan","30.19679","71.47824","27","1","0","1","0","0","0","29","13","7","4","0","24","6","11","12","0","29","8","2","14","0","5","29"
"Mumbai","19.07283","72.88261","28","1","0","0","1","0","0","30","19","1","5","1","26","9","4","15","2","30","1","5","19","2","3","30"
"Mumbwa","-14.98293","27.0619","1","0","0","0","0","0","0","1","1","0","0","0","1","1","0","0","0","1","0","0","0","0","1","1"
"Mumias","0.33474","34.48796","1","0","0","0","0","0","0","1","0","0","0","0","0","1","0","0","0","1","0","0","0","0","1","1"
"Münchenbernsdorf","50.82114","11.93226","1","0","0","0","0","0","0","1","0","0","1","0","1","0","0","1","0","1","0","0","1","0","0","1"
"Munich","48.13743","11.57549","5","1","0","0","1","0","0","7","2","1","1","1","5","2","2","3","0","7","1","0","5","0","1","7"
"Munūf","30.46597","30.93199","1","0","0","0","0","0","0","1","1","0","0","0","1","1","0","0","0","1","0","0","1","0","0","1"
"Murang’a","-0.72104","37.15259","1","0","0","0","0","0","0","1","0","0","0","0","0","1","0","0","0","1","0","0","0","1","0","1"
"Murau","47.11056","14.16944","1","0","0","0","0","0","0","1","1","0","0","0","1","0","0","1","0","1","0","0","1","0","0","1"
"Murcia","37.98704","-1.13004","2","0","0","1","0","0","0","3","1","1","0","0","2","0","2","1","0","3","2","0","1","0","0","3"
"Murcia","15.40425","120.60903","2","0","0","1","0","0","0","3","1","1","0","0","2","0","2","1","0","3","2","0","1","0","0","3"
"Murcia","10.60516","123.0417","2","0","0","1","0","0","0","3","1","1","0","0","2","0","2","1","0","3","2","0","1","0","0","3"
"Murfreesboro","34.06233","-93.6899","1","0","0","0","0","0","0","1","0","0","0","0","0","0","0","1","0","1","0","0","1","0","0","1"
"Murfreesboro","35.84562","-86.39027","1","0","0","0","0","0","0","1","0","0","0","0","0","0","0","1","0","1","0","0","1","0","0","1"
"Murfreesboro","36.44238","-77.09858","1","0","0","0","0","0","0","1","0","0","0","0","0","0","0","1","0","1","0","0","1","0","0","1"
"Muridke","31.80258","74.25772","1","0","0","0","0","0","0","1","0","0","0","0","0","1","0","0","0","1","1","0","0","0","0","1"
"Murphy","43.21822","-116.55234","1","0","0","0","0","0","0","1","1","0","0","0","1","0","0","1","0","1","0","1","0","0","0","1"
"Murphy","33.01512","-96.61305","1","0","0","0","0","0","0","1","1","0","0","0","1","0","0","1","0","1","0","1","0","0","0","1"
"Murphy","38.49033","-90.48707","1","0","0","0","0","0","0","1","1","0","0","0","1","0","0","1","0","1","0","1","0","0","0","1"
"Murphy","35.08758","-84.03463","1","0","0","0","0","0","0","1","1","0","0","0","1","0","0","1","0","1","0","1","0","0","0","1"
"Murrieta","33.55391","-117.21392","1","0","0","0","0","0","0","1","0","0","0","0","0","1","0","0","0","1","0","0","1","0","0","1"
"Murrieta Hot Springs","33.56058","-117.15809","1","0","0","0","0","0","0","1","0","1","0","0","1","1","0","0","0","1","1","0","0","0","0","1"
"Mursley","51.94961","-0.81161","0","1","0","0","0","0","0","1","1","0","0","0","1","0","0","1","0","1","0","0","1","0","0","1"
"Muş","38.73163","41.48482","4","0","0","0","0","0","0","4","0","3","1","0","4","1","0","2","1","4","1","1","0","1","1","4"
"Musanze","-1.49984","29.63497","1","0","0","0","0","0","0","1","0","1","0","0","1","0","1","0","0","1","0","0","1","0","0","1"
"Muscat","23.58413","58.40778","5","0","0","0","0","0","0","5","1","1","0","1","3","2","2","1","0","5","3","0","2","0","1","6"
"Musselburgh","55.9417","-3.04991","4","0","0","1","1","0","0","6","1","1","1","0","3","4","1","1","0","6","1","3","1","1","0","6"
"Mutare","-18.9707","32.67086","1","0","0","0","0","0","0","1","0","0","0","0","0","1","0","0","0","1","0","0","1","0","0","1"
"Mutengene","4.0913","9.3144","1","0","0","0","0","0","0","1","0","0","0","0","0","0","1","0","0","1","0","0","0","0","1","1"
"Muzaffarābād","34.37002","73.47082","4","0","0","0","0","0","0","4","2","0","1","0","3","3","1","0","0","4","0","0","4","0","0","4"
"Muzaffargarh","30.07258","71.19379","0","0","0","0","0","0","0","0","0","0","0","0","0","1","0","0","0","1","0","1","0","0","0","1"
"Muzaffarnagar","29.47091","77.70332","1","0","0","0","0","0","0","1","1","0","0","0","1","0","0","1","0","1","0","0","1","0","0","1"
"Muzaffarpur","26.12259","85.39055","0","0","0","0","1","0","0","1","1","0","0","0","1","0","1","0","0","1","0","0","1","0","0","1"
"Muzayri‘","23.14355","53.7881","0","0","0","0","1","0","0","1","0","1","0","0","1","0","0","1","0","1","1","0","0","0","0","1"
"Mwanza","-2.51667","32.9","8","0","0","0","2","0","0","10","0","6","1","3","10","7","1","1","1","10","2","0","6","0","1","9"
"Mwanza","-15.60262","34.52479","8","0","0","0","2","0","0","10","0","6","1","3","10","7","1","1","1","10","2","0","6","0","1","9"
"Mwaro","-3.51128","29.70334","1","0","0","0","0","0","0","1","1","0","0","0","1","0","0","0","1","1","0","0","0","0","1","1"
"Mwene-Ditu","-7.00906","23.45278","1","0","0","0","0","0","0","1","1","0","0","0","1","1","0","0","0","1","0","0","1","0","0","1"
"Mwense","-10.38447","28.698","1","0","0","0","0","0","0","1","0","1","0","0","1","0","1","0","0","1","0","0","1","0","0","1"
"Mwinilunga","-11.73584","24.42926","1","0","0","0","0","0","0","1","0","1","0","0","1","0","0","1","0","1","0","0","0","0","1","1"
"Myanaung","18.28651","95.32014","1","0","0","0","0","0","0","1","0","1","0","0","1","1","0","0","0","1","0","0","0","0","0","0"
"Mykolayiv","46.96591","31.9974","1","0","0","0","0","0","0","1","0","1","0","0","1","1","0","0","0","1","1","0","0","0","0","1"
"Mymensingh","24.75636","90.40646","11","1","0","1","2","0","0","15","5","4","1","4","14","7","2","4","2","15","1","4","6","0","4","15"
"Mysore","12.29791","76.63925","1","0","0","0","0","0","0","1","0","0","0","0","0","1","0","0","0","1","0","0","1","0","0","1"
"Mytilene","39.10772","26.55529","2","0","0","0","0","0","0","2","0","2","0","0","2","1","1","0","0","2","1","0","1","0","0","2"
"Mytishchi","55.91163","37.73076","1","0","0","0","0","0","0","1","0","1","0","0","1","0","0","1","0","1","0","0","0","1","0","1"
"Mzuzu","-11.46556","34.02071","2","0","0","0","0","0","0","2","0","1","0","1","2","2","0","0","0","2","1","0","0","0","1","2"
"Naas","53.21583","-6.66694","1","0","0","0","0","0","0","1","0","0","1","0","1","0","0","1","0","1","0","0","1","0","0","1"
"Naas","47.25086","15.59449","1","0","0","0","0","0","0","1","0","0","1","0","1","0","0","1","0","1","0","0","1","0","0","1"
"Nabatîyé et Tahta","33.37889","35.48389","1","0","0","0","0","0","0","1","0","0","0","0","0","0","0","1","0","1","0","0","0","0","1","1"
"Nabeul","36.45606","10.73763","1","0","0","0","0","0","1","2","2","0","0","0","2","1","0","1","0","2","0","0","2","0","0","2"
"Nablus","32.22111","35.25444","5","0","0","0","0","0","0","5","0","3","0","0","3","3","1","1","0","5","4","0","0","0","0","4"
"Nacka","59.31053","18.16372","1","0","0","0","0","0","0","1","0","0","1","0","1","0","1","0","0","1","0","1","0","0","0","1"
"Nacogdoches","31.60351","-94.65549","1","0","0","0","0","0","0","1","1","0","0","0","1","0","0","1","0","1","0","1","0","0","0","1"
"Nadiād","22.69385","72.86157","1","0","0","0","0","0","0","1","1","0","0","0","1","0","0","1","0","1","0","0","0","1","0","1"
"Nador","35.16813","-2.93352","11","0","0","0","0","0","0","11","0","11","0","0","11","1","10","0","0","11","6","5","0","0","0","11"
"Nāgercoil","8.17899","77.43227","2","0","0","0","0","0","0","2","0","0","2","0","2","0","0","1","0","1","0","2","0","0","0","2"
"Nagpur","21.14631","79.08491","0","0","0","0","1","0","0","1","0","1","0","0","1","0","1","0","0","1","0","0","0","0","1","1"
"Nagytarcsa","47.53128","19.28343","1","0","0","0","0","0","0","1","1","0","0","0","1","0","0","1","0","1","0","1","0","0","0","1"
"Naihāti","22.89396","88.41521","1","0","0","0","0","0","0","1","0","1","0","0","1","0","1","0","0","1","1","0","0","0","0","1"
"Nailsea","51.43239","-2.75847","3","0","0","0","0","0","0","3","0","0","2","1","3","2","0","1","0","3","0","2","0","0","1","3"
"Nairn","57.58094","-3.87973","2","0","0","0","0","0","0","2","0","0","2","0","2","0","0","2","0","2","0","1","1","0","0","2"
"Nairobi","-1.28333","36.81667","62","2","0","0","2","0","0","66","13","26","6","9","54","30","15","19","4","68","15","4","24","18","7","68"
"Naivasha","-0.71383","36.43261","1","0","0","0","1","0","0","2","1","1","0","0","2","0","1","1","0","2","0","0","2","0","0","2"
"Najaf","32.02594","44.34625","7","0","0","0","0","0","0","7","2","3","2","0","7","5","1","1","0","7","2","2","3","0","0","7"
"Naja' Ḥammādī","26.04949","32.24142","2","0","0","0","0","0","0","2","0","1","0","0","1","1","1","0","0","2","1","0","1","0","0","2"
"Najrān","17.49326","44.12766","7","0","0","0","0","0","0","7","1","3","0","0","4","5","2","0","0","7","6","0","0","0","1","7"
"Nakhon Ratchasima","14.97066","102.10196","1","0","0","0","0","0","0","1","0","0","1","0","1","1","0","0","0","1","0","0","1","0","0","1"
"Nakuru","-0.30719","36.07225","8","0","0","0","1","0","0","9","2","3","2","1","8","3","1","4","1","9","3","1","5","0","0","9"
"Nal’chik","43.49806","43.61889","2","0","0","0","0","0","0","2","0","0","0","0","0","1","1","0","0","2","0","0","2","0","0","2"
"Nambour","-26.62613","152.95941","1","0","0","0","0","0","0","1","0","0","0","1","1","0","0","1","0","1","1","0","0","0","0","1"
"Námestovo","49.4079","19.48032","1","0","0","0","0","0","0","1","0","1","0","0","1","0","0","1","0","1","0","0","1","0","0","1"
"Namur","50.4669","4.86746","1","0","0","0","0","0","0","1","0","0","1","0","1","0","1","0","0","1","0","1","0","0","0","1"
"Nancy","48.68439","6.18496","3","0","0","0","0","1","0","4","2","0","1","0","3","1","0","3","0","4","1","0","3","0","0","4"
"Nanded","19.16023","77.31497","1","0","0","0","1","0","0","2","1","1","0","0","2","1","0","1","0","2","0","1","0","0","1","2"
"Nandyāl","15.47799","78.4836","1","0","0","0","0","0","0","1","1","0","0","0","1","0","1","0","0","1","0","0","1","0","0","1"
"Nankana Sahib","31.4501","73.70653","2","0","0","0","0","0","0","2","0","1","1","0","2","1","0","1","0","2","0","0","1","0","1","2"
"Nantes","47.21725","-1.55336","1","0","0","0","0","0","0","1","0","0","1","0","1","1","0","0","0","1","0","0","1","0","0","1"
"Nantwich","53.06878","-2.52051","2","1","0","1","0","0","0","4","1","2","1","0","4","1","0","3","0","4","0","2","2","0","0","4"
"Nanyuki","0.00624","37.07398","1","0","0","0","0","0","0","1","0","1","0","0","1","1","0","0","0","1","0","0","0","0","1","1"
"Naperville","41.78586","-88.14729","1","0","0","0","0","0","0","1","0","0","1","0","1","0","1","0","0","1","0","0","1","0","0","1"
"Napier","-39.4926","176.91233","1","0","0","0","0","0","0","1","1","0","0","0","1","1","0","0","0","1","1","0","0","0","0","1"
"Naples","40.42691","-109.4993","5","0","0","0","0","0","0","5","0","0","1","0","1","2","0","3","0","5","2","0","2","0","1","5"
"Naples","33.20318","-94.68021","5","0","0","0","0","0","0","5","0","0","1","0","1","2","0","3","0","5","2","0","2","0","1","5"
"Naples","26.14234","-81.79596","5","0","0","0","0","0","0","5","0","0","1","0","1","2","0","3","0","5","2","0","2","0","1","5"
"Naples","42.61535","-77.40249","5","0","0","0","0","0","0","5","0","0","1","0","1","2","0","3","0","5","2","0","2","0","1","5"
"Naples","40.85216","14.26811","5","0","0","0","0","0","0","5","0","0","1","0","1","2","0","3","0","5","2","0","2","0","1","5"
"Narail","23.15509","89.49515","1","0","0","0","0","0","0","1","0","0","0","0","0","0","0","0","0","0","0","0","1","0","0","1"
"Narasannapeta","18.41428","84.04463","1","0","0","0","0","0","0","1","1","0","0","0","1","0","0","1","0","1","0","0","1","0","0","1"
"Nārāyanganj","23.61352","90.50298","7","0","0","1","0","0","0","8","5","1","2","0","8","4","1","3","0","8","1","2","4","0","1","8"
"Narberth","40.00845","-75.26046","4","1","0","1","0","0","0","6","4","1","0","0","5","0","1","4","1","6","0","4","2","0","0","6"
"Narberth","51.79784","-4.74275","4","1","0","1","0","0","0","6","4","1","0","0","5","0","1","4","1","6","0","4","2","0","0","6"
"Narok","-1.08083","35.87111","1","0","0","0","0","0","0","1","0","0","0","0","0","0","1","0","0","1","0","0","1","0","0","1"
"Narowal","32.10197","74.87303","2","0","0","0","0","0","0","2","0","1","1","0","2","0","1","1","0","2","0","0","1","0","1","2"
"Narsingdi","23.92298","90.71768","2","0","0","0","0","0","0","2","2","0","0","0","2","2","0","0","0","2","0","0","2","0","0","2"
"Narsinghgarh","23.70758","77.09319","1","0","0","0","0","0","0","1","0","1","0","0","1","0","1","0","0","1","0","0","0","0","1","1"
"Narwāna","29.59903","76.11927","0","0","0","0","0","0","0","0","0","0","0","0","0","0","0","0","0","0","0","0","1","0","0","1"
"Nasarawa","8.53895","7.70821","1","0","0","0","0","0","0","1","0","1","0","0","1","0","1","0","0","1","0","0","1","0","0","1"
"Nashik","19.99727","73.79096","3","0","0","0","0","0","0","3","2","0","1","0","3","2","0","1","0","3","0","1","2","0","0","3"
"Nashville","33.94567","-93.84713","1","0","0","0","0","0","0","1","0","1","0","0","1","0","1","0","0","1","1","0","0","0","0","1"
"Nashville","38.34366","-89.38064","1","0","0","0","0","0","0","1","0","1","0","0","1","0","1","0","0","1","1","0","0","0","0","1"
"Nashville","45.52274","-89.02484","1","0","0","0","0","0","0","1","0","1","0","0","1","0","1","0","0","1","1","0","0","0","0","1"
"Nashville","36.16589","-86.78444","1","0","0","0","0","0","0","1","0","1","0","0","1","0","1","0","0","1","1","0","0","0","0","1"
"Nashville","39.20727","-86.2511","1","0","0","0","0","0","0","1","0","1","0","0","1","0","1","0","0","1","1","0","0","0","0","1"
"Nashville","42.60281","-85.09305","1","0","0","0","0","0","0","1","0","1","0","0","1","0","1","0","0","1","1","0","0","0","0","1"
"Nashville","31.20742","-83.25015","1","0","0","0","0","0","0","1","0","1","0","0","1","0","1","0","0","1","1","0","0","0","0","1"
"Nashville","35.9746","-77.96554","1","0","0","0","0","0","0","1","0","1","0","0","1","0","1","0","0","1","1","0","0","0","0","1"
"Nasiriyah","31.05799","46.25726","1","0","0","0","0","0","0","1","1","0","0","0","1","0","0","1","0","1","0","0","1","0","0","1"
"Natal","-5.795","-35.20944","2","1","0","0","0","0","0","3","0","1","0","0","1","1","2","0","0","3","3","0","0","0","0","3"
"Natal","0.5632","99.1099","2","1","0","0","0","0","0","3","0","1","0","0","1","1","2","0","0","3","3","0","0","0","0","3"
"Natore","24.41112","88.98673","1","0","0","0","0","0","0","1","0","0","0","1","1","0","0","0","1","1","0","0","0","0","0","0"
"Naucalpan de Juárez","19.47851","-99.23963","2","0","0","0","0","0","0","2","0","0","0","0","0","1","1","0","0","2","2","0","0","0","0","2"
"Naumburg","51.24816","9.16569","1","0","0","0","0","0","0","1","0","0","0","0","0","0","1","0","0","1","0","0","0","0","1","1"
"Naumburg","51.14987","11.80979","1","0","0","0","0","0","0","1","0","0","0","0","0","0","1","0","0","1","0","0","0","0","1","1"
"Navan","53.65278","-6.68139","2","0","0","0","0","0","0","2","1","0","0","0","1","0","0","2","0","2","0","0","2","0","0","2"
"Navi Mumbai","19.03681","73.01582","2","0","0","0","0","0","0","2","1","0","0","0","1","0","0","2","0","2","0","0","2","0","0","2"
"Nawābganj","28.54103","79.63462","1","0","0","0","0","0","0","1","0","1","0","0","1","1","0","0","0","1","0","1","0","0","0","1"
"Nawābganj","26.49716","80.30934","1","0","0","0","0","0","0","1","0","1","0","0","1","1","0","0","0","1","0","1","0","0","0","1"
"Nawābganj","26.93129","81.19841","1","0","0","0","0","0","0","1","0","1","0","0","1","1","0","0","0","1","0","1","0","0","0","1"
"Nawābganj","26.86396","82.14103","1","0","0","0","0","0","0","1","0","1","0","0","1","1","0","0","0","1","0","1","0","0","0","1"
"Nawābganj","24.59025","88.27444","1","0","0","0","0","0","0","1","0","1","0","0","1","1","0","0","0","1","0","1","0","0","0","1"
"Nawabshah","26.23939","68.40369","3","0","0","0","0","0","0","3","1","1","0","0","2","3","0","0","0","3","2","0","1","0","0","3"
"Nawāda","24.8867","85.54364","1","0","0","0","0","0","0","1","0","0","0","0","0","0","1","0","0","1","0","0","1","0","0","1"
"Nawal","28.64831","84.10279","0","0","0","0","1","0","0","1","1","0","0","0","1","0","0","1","0","1","0","0","1","0","0","1"
"Nawanshahr","31.1245","76.11613","1","0","0","0","0","0","0","1","1","0","0","0","1","0","0","1","0","1","0","0","1","0","0","1"
"Nay Pyi Taw","19.745","96.12972","1","0","0","0","0","0","0","1","0","0","1","0","1","0","1","0","0","1","0","0","1","0","0","1"
"Nazareth","17.37194","-91.94889","1","0","0","0","0","0","0","1","1","0","0","0","1","1","0","0","0","1","0","0","1","0","0","1"
"Nazareth","40.74038","-75.30962","1","0","0","0","0","0","0","1","1","0","0","0","1","1","0","0","0","1","0","0","1","0","0","1"
"Nazareth","50.95686","3.59425","1","0","0","0","0","0","0","1","1","0","0","0","1","1","0","0","0","1","0","0","1","0","0","1"
"Nazareth","32.70056","35.29722","1","0","0","0","0","0","0","1","1","0","0","0","1","1","0","0","0","1","0","0","1","0","0","1"
"N'Djamena","12.10672","15.0444","1","0","0","0","0","0","0","1","1","1","0","0","2","2","0","0","0","2","1","0","1","0","0","2"
"Ndola","-12.95867","28.63659","3","1","0","0","0","0","0","4","1","3","0","0","4","4","0","0","0","4","1","0","2","1","0","4"
"Néa Ionía","39.37904","22.92752","1","0","0","0","0","0","0","1","1","0","0","0","1","0","1","0","0","1","0","1","0","0","0","1"
"Néa Ionía","38.0357","23.75733","1","0","0","0","0","0","0","1","1","0","0","0","1","0","1","0","0","1","0","1","0","0","0","1"
"Neath","51.66317","-3.80443","15","0","0","1","1","0","3","20","4","11","4","0","19","10","4","6","0","20","8","4","8","0","0","20"
"Nebbi","2.47826","31.08893","1","0","0","0","0","0","0","1","0","1","0","0","1","1","0","0","0","1","0","0","0","0","1","1"
"Needham","42.28343","-71.23283","1","0","0","0","0","0","0","1","0","0","0","0","0","0","0","1","0","1","0","0","1","0","0","1"
"Negombo","7.2083","79.8358","3","0","0","0","0","0","0","3","1","1","0","1","3","0","0","1","2","3","1","0","2","0","0","3"
"Neiva","2.9273","-75.28189","1","0","0","0","0","0","0","1","1","0","0","0","1","1","0","0","0","1","0","1","0","0","0","1"
"Nellore","14.44992","79.98697","4","0","0","0","0","0","0","4","2","1","0","0","3","3","0","1","0","4","0","1","2","0","1","4"
"Nelson","49.49985","-117.28553","6","1","0","0","0","0","0","7","0","4","2","0","6","1","2","4","0","7","3","2","2","0","0","7"
"Nelson","40.20168","-98.06782","6","1","0","0","0","0","0","7","0","4","2","0","6","1","2","4","0","7","3","2","2","0","0","7"
"Nelson","34.38204","-84.37103","6","1","0","0","0","0","0","7","0","4","2","0","6","1","2","4","0","7","3","2","2","0","0","7"
"Nelson","42.99064","-72.13092","6","1","0","0","0","0","0","7","0","4","2","0","6","1","2","4","0","7","3","2","2","0","0","7"
"Nelson","51.65333","-3.28444","6","1","0","0","0","0","0","7","0","4","2","0","6","1","2","4","0","7","3","2","2","0","0","7"
"Nelson","53.83333","-2.2","6","1","0","0","0","0","0","7","0","4","2","0","6","1","2","4","0","7","3","2","2","0","0","7"
"Nelson","-41.27078","173.28404","6","1","0","0","0","0","0","7","0","4","2","0","6","1","2","4","0","7","3","2","2","0","0","7"
"Nelspruit","-25.47448","30.97033","1","0","0","0","0","0","0","1","0","0","0","0","0","0","1","0","0","1","1","0","0","0","0","1"
"Nepalgunj","28.05","81.61667","4","0","0","0","0","0","0","4","2","0","0","2","4","2","0","1","1","4","0","0","3","0","1","4"
"Nérac","44.13597","0.33844","0","1","0","0","0","0","0","1","0","0","1","0","1","0","1","0","0","1","0","1","0","0","0","1"
"Nesher","32.76622","35.04425","1","0","0","0","0","0","0","1","0","1","0","0","1","0","1","0","0","1","1","0","0","0","0","1"
"Neston","53.28333","-3.05","3","0","0","0","1","0","0","4","1","0","1","1","3","0","2","2","0","4","1","1","2","0","0","4"
"Neston","51.41222","-2.20056","3","0","0","0","1","0","0","4","1","0","1","1","3","0","2","2","0","4","1","1","2","0","0","4"
"Netanya","32.33291","34.85992","0","0","0","0","0","0","1","1","0","1","0","0","1","1","0","0","0","1","1","0","0","0","0","1"
"Netheravon","51.23613","-1.79083","0","0","0","0","1","0","0","1","1","0","0","0","1","0","1","0","0","1","0","0","1","0","0","1"
"Netley","50.87634","-1.35398","0","0","0","0","1","0","0","1","0","0","1","0","1","1","0","0","0","1","0","1","0","0","0","1"
"Netley","-34.94887","138.54983","0","0","0","0","1","0","0","1","0","0","1","0","1","1","0","0","0","1","0","1","0","0","0","1"
"Netrakona","24.88352","90.72898","0","1","0","0","0","0","0","1","0","0","1","0","1","1","0","0","0","1","0","0","1","0","0","1"
"Neumarkt in der Oberpfalz","49.28028","11.46278","1","0","0","0","0","0","0","1","0","0","0","0","0","1","0","0","0","1","1","0","0","0","0","1"
"Neusiß","50.74493","10.88951","1","0","0","0","0","0","0","1","0","1","0","0","1","0","0","1","0","1","0","0","0","0","1","1"
"Neutral Bay","-33.83784","151.2175","1","0","0","0","0","0","0","1","1","0","0","0","1","0","0","1","0","1","0","0","1","0","0","1"
"Nevşehir","38.625","34.71222","3","0","0","0","0","0","0","3","1","1","0","0","2","0","1","1","1","3","1","0","2","0","0","3"
"New Albany","34.49427","-89.00784","1","0","0","0","0","0","0","1","0","0","0","0","0","0","0","1","0","1","0","0","1","0","0","1"
"New Albany","38.28562","-85.82413","1","0","0","0","0","0","0","1","0","0","0","0","0","0","0","1","0","1","0","0","1","0","0","1"
"New Albany","40.08117","-82.80879","1","0","0","0","0","0","0","1","0","0","0","0","0","0","0","1","0","1","0","0","1","0","0","1"
"Newark","37.52966","-122.04024","0","0","0","1","0","0","0","1","0","0","0","0","0","0","1","0","0","1","0","0","1","0","0","1"
"Newark","33.00124","-97.48447","0","0","0","1","0","0","0","1","0","0","0","0","0","0","1","0","0","1","0","0","1","0","0","1"
"Newark","35.70174","-91.44152","0","0","0","1","0","0","0","1","0","0","0","0","0","0","1","0","0","1","0","0","1","0","0","1"
"Newark","41.53697","-88.58341","0","0","0","1","0","0","0","1","0","0","0","0","0","0","1","0","0","1","0","0","1","0","0","1"
"Newark","40.05812","-82.40126","0","0","0","1","0","0","0","1","0","0","0","0","0","0","1","0","0","1","0","0","1","0","0","1"
"Newark","43.04673","-77.09525","0","0","0","1","0","0","0","1","0","0","0","0","0","0","1","0","0","1","0","0","1","0","0","1"
"Newark","39.68372","-75.74966","0","0","0","1","0","0","0","1","0","0","0","0","0","0","1","0","0","1","0","0","1","0","0","1"
"Newark","40.73566","-74.17237","0","0","0","1","0","0","0","1","0","0","0","0","0","0","1","0","0","1","0","0","1","0","0","1"
"Newark on Trent","53.06667","-0.81667","12","0","0","0","1","0","1","14","2","5","4","1","12","9","4","1","0","14","5","1","7","0","1","14"
"Newbiggin-by-the-Sea","55.18532","-1.51469","1","0","0","0","0","0","0","1","0","1","0","0","1","0","0","1","0","1","1","0","0","0","0","1"
"Newbury","43.32146","-72.03592","16","0","0","1","3","0","1","21","5","6","8","0","19","6","4","11","0","21","2","6","12","0","1","21"
"Newbury","51.40148","-1.32471","16","0","0","1","3","0","1","21","5","6","8","0","19","6","4","11","0","21","2","6","12","0","1","21"
"New Cairo","30.03","31.47","1","0","0","0","0","0","0","1","0","1","0","0","1","0","1","0","0","1","0","0","0","1","0","1"
"Newcastle","47.53899","-122.15568","79","1","0","5","8","0","2","95","16","25","21","0","62","35","15","44","1","95","27","22","39","2","4","94"
"Newcastle","38.87407","-121.13328","79","1","0","5","8","0","2","95","16","25","21","0","62","35","15","44","1","95","27","22","39","2","4","94"
"Newcastle","43.8547","-104.20494","79","1","0","5","8","0","2","95","16","25","21","0","62","35","15","44","1","95","27","22","39","2","4","94"
"Newcastle","33.194","-98.73867","79","1","0","5","8","0","2","95","16","25","21","0","62","35","15","44","1","95","27","22","39","2","4","94"
"Newcastle","35.24729","-97.59976","79","1","0","5","8","0","2","95","16","25","21","0","62","35","15","44","1","95","27","22","39","2","4","94"
"Newcastle","44.03508","-69.53671","79","1","0","5","8","0","2","95","16","25","21","0","62","35","15","44","1","95","27","22","39","2","4","94"
"Newcastle","17.2","-62.58333","79","1","0","5","8","0","2","95","16","25","21","0","62","35","15","44","1","95","27","22","39","2","4","94"
"Newcastle","53.30111","-6.50222","79","1","0","5","8","0","2","95","16","25","21","0","62","35","15","44","1","95","27","22","39","2","4","94"
"Newcastle","53.06833","-6.06583","79","1","0","5","8","0","2","95","16","25","21","0","62","35","15","44","1","95","27","22","39","2","4","94"
"Newcastle","54.21804","-5.88979","79","1","0","5","8","0","2","95","16","25","21","0","62","35","15","44","1","95","27","22","39","2","4","94"
"Newcastle","-27.75796","29.9318","79","1","0","5","8","0","2","95","16","25","21","0","62","35","15","44","1","95","27","22","39","2","4","94"
"Newcastle","-32.92953","151.7801","79","1","0","5","8","0","2","95","16","25","21","0","62","35","15","44","1","95","27","22","39","2","4","94"
"Newcastle Emlyn","52.04056","-4.4667","1","0","0","0","0","0","0","1","0","0","0","0","0","0","1","0","0","1","0","0","1","0","0","1"
"Newcastle under Lyme","53","-2.23333","12","1","0","0","0","0","1","14","1","4","8","0","13","4","1","9","0","14","1","2","11","0","0","14"
"Newcastle upon Tyne","54.97328","-1.61396","119","2","0","2","14","0","7","144","23","31","40","4","98","61","19","63","1","144","32","30","78","2","2","144"
"Newcastle West","52.44917","-9.06111","1","0","0","0","0","0","0","1","0","0","1","0","1","0","1","0","0","1","0","1","0","0","0","1"
"Newcastle West","-32.92446","151.75711","1","0","0","0","0","0","0","1","0","0","1","0","1","0","1","0","0","1","0","1","0","0","0","1"
"New Delhi","28.63576","77.22445","6","0","0","0","0","0","0","6","3","1","1","0","5","3","0","3","0","6","1","0","5","0","0","6"
"New Grove","-20.40861","57.61361","1","0","0","0","0","0","0","1","0","1","0","0","1","1","0","0","0","1","1","0","0","0","0","1"
"Newhaven","53.13987","-1.75261","1","0","0","0","1","0","0","2","1","1","0","0","2","2","0","0","0","2","1","0","1","0","0","2"
"Newhaven","50.79693","0.05545","1","0","0","0","1","0","0","2","1","1","0","0","2","2","0","0","0","2","1","0","1","0","0","2"
"New Haven","38.60838","-91.21904","1","0","0","0","0","0","0","1","0","1","0","0","1","0","0","1","0","1","1","0","0","0","0","1"
"New Haven","37.65784","-85.59107","1","0","0","0","0","0","0","1","0","1","0","0","1","0","0","1","0","1","1","0","0","0","0","1"
"New Haven","41.0706","-85.01441","1","0","0","0","0","0","0","1","0","1","0","0","1","0","0","1","0","1","1","0","0","0","0","1"
"New Haven","39.27561","-84.74078","1","0","0","0","0","0","0","1","0","1","0","0","1","0","0","1","0","1","1","0","0","0","0","1"
"New Haven","43.09364","-84.15331","1","0","0","0","0","0","0","1","0","1","0","0","1","0","0","1","0","1","1","0","0","0","0","1"
"New Haven","42.72948","-82.80131","1","0","0","0","0","0","0","1","0","1","0","0","1","0","0","1","0","1","1","0","0","0","0","1"
"New Haven","38.98647","-81.97347","1","0","0","0","0","0","0","1","0","1","0","0","1","0","0","1","0","1","1","0","0","0","0","1"
"New Haven","41.30815","-72.92816","1","0","0","0","0","0","0","1","0","1","0","0","1","0","0","1","0","1","1","0","0","0","0","1"
"New Hope","42.36234","-123.36784","1","0","0","0","0","0","0","1","0","0","1","0","1","0","0","1","0","1","0","0","1","0","0","1"
"New Hope","33.21012","-96.56527","1","0","0","0","0","0","0","1","0","0","1","0","1","0","0","1","0","1","0","0","1","0","0","1"
"New Hope","45.03802","-93.38662","1","0","0","0","0","0","0","1","0","0","1","0","1","0","0","1","0","1","0","0","1","0","0","1"
"New Hope","33.46817","-88.3267","1","0","0","0","0","0","0","1","0","0","1","0","1","0","0","1","0","1","0","0","1","0","0","1"
"New Hope","34.53712","-86.39426","1","0","0","0","0","0","0","1","0","0","1","0","1","0","0","1","0","1","0","0","1","0","0","1"
"New Hope","35.00508","-85.6583","1","0","0","0","0","0","0","1","0","0","1","0","1","0","0","1","0","1","0","0","1","0","0","1"
"New Hope","38.19791","-78.90586","1","0","0","0","0","0","0","1","0","0","1","0","1","0","0","1","0","1","0","0","1","0","0","1"
"New Hope","40.36427","-74.95128","1","0","0","0","0","0","0","1","0","0","1","0","1","0","0","1","0","1","0","0","1","0","0","1"
"New Hyde Park","40.7351","-73.68791","1","0","0","0","0","0","0","1","0","0","0","0","0","1","0","0","0","1","0","0","1","0","0","1"
"New Malden","51.40065","-0.2617","2","0","0","2","0","0","2","6","3","1","1","0","5","2","1","3","0","6","0","2","4","0","0","6"
"Newmarket","44.05011","-79.46631","5","0","0","0","0","0","1","6","0","1","2","0","3","4","0","2","0","6","1","0","5","0","0","6"
"Newmarket","43.08286","-70.93506","5","0","0","0","0","0","1","6","0","1","2","0","3","4","0","2","0","6","1","0","5","0","0","6"
"Newmarket","52.21667","-9","5","0","0","0","0","0","1","6","0","1","2","0","3","4","0","2","0","6","1","0","5","0","0","6"
"Newmarket","52.24467","0.40418","5","0","0","0","0","0","1","6","0","1","2","0","3","4","0","2","0","6","1","0","5","0","0","6"
"Newmarket","-27.43534","153.00781","5","0","0","0","0","0","1","6","0","1","2","0","3","4","0","2","0","6","1","0","5","0","0","6"
"New Mills","53.36592","-1.99986","1","0","0","1","0","0","0","2","1","1","0","0","2","2","0","0","0","2","1","0","1","0","0","2"
"New Milton","50.75601","-1.6658","7","0","0","0","0","0","0","7","0","4","2","0","6","2","2","3","0","7","3","1","2","0","1","7"
"New Orleans","29.95465","-90.07507","1","0","0","0","0","0","0","1","0","0","1","0","1","0","0","1","0","1","0","0","1","0","0","1"
"New Plymouth","43.96989","-116.81904","5","0","0","0","0","0","1","6","1","5","0","0","6","0","0","6","0","6","0","5","1","0","0","6"
"New Plymouth","-39.06667","174.08333","5","0","0","0","0","0","1","6","1","5","0","0","6","0","0","6","0","6","0","5","1","0","0","6"
"Newport","44.63678","-124.05345","45","1","0","2","7","0","8","63","11","22","25","0","58","18","11","33","1","63","14","14","33","0","2","63"
"Newport","47.57121","-122.18068","45","1","0","2","7","0","8","63","11","22","25","0","58","18","11","33","1","63","14","14","33","0","2","63"
"Newport","48.17963","-117.04326","45","1","0","2","7","0","8","63","11","22","25","0","58","18","11","33","1","63","14","14","33","0","2","63"
"Newport","44.86636","-93.00049","45","1","0","2","7","0","8","63","11","22","25","0","58","18","11","33","1","63","14","14","33","0","2","63"
"Newport","35.6048","-91.2818","45","1","0","2","7","0","8","63","11","22","25","0","58","18","11","33","1","63","14","14","33","0","2","63"
"Newport","39.8842","-87.40863","45","1","0","2","7","0","8","63","11","22","25","0","58","18","11","33","1","63","14","14","33","0","2","63"
"Newport","39.09145","-84.49578","45","1","0","2","7","0","8","63","11","22","25","0","58","18","11","33","1","63","14","14","33","0","2","63"
"Newport","35.96704","-83.18766","45","1","0","2","7","0","8","63","11","22","25","0","58","18","11","33","1","63","14","14","33","0","2","63"
"Newport","39.39091","-81.22678","45","1","0","2","7","0","8","63","11","22","25","0","58","18","11","33","1","63","14","14","33","0","2","63"
"Newport","34.98986","-81.10091","45","1","0","2","7","0","8","63","11","22","25","0","58","18","11","33","1","63","14","14","33","0","2","63"
"Newport","40.47786","-77.13054","45","1","0","2","7","0","8","63","11","22","25","0","58","18","11","33","1","63","14","14","33","0","2","63"
"Newport","34.78655","-76.85911","45","1","0","2","7","0","8","63","11","22","25","0","58","18","11","33","1","63","14","14","33","0","2","63"
"Newport","39.71372","-75.60937","45","1","0","2","7","0","8","63","11","22","25","0","58","18","11","33","1","63","14","14","33","0","2","63"
"Newport","43.1859","-75.01432","45","1","0","2","7","0","8","63","11","22","25","0","58","18","11","33","1","63","14","14","33","0","2","63"
"Newport","44.93644","-72.2051","45","1","0","2","7","0","8","63","11","22","25","0","58","18","11","33","1","63","14","14","33","0","2","63"
"Newport","43.36535","-72.17342","45","1","0","2","7","0","8","63","11","22","25","0","58","18","11","33","1","63","14","14","33","0","2","63"
"Newport","41.4901","-71.31283","45","1","0","2","7","0","8","63","11","22","25","0","58","18","11","33","1","63","14","14","33","0","2","63"
"Newport","44.83534","-69.27394","45","1","0","2","7","0","8","63","11","22","25","0","58","18","11","33","1","63","14","14","33","0","2","63"
"Newport","53.88508","-9.54526","45","1","0","2","7","0","8","63","11","22","25","0","58","18","11","33","1","63","14","14","33","0","2","63"
"Newport","52.71111","-8.40972","45","1","0","2","7","0","8","63","11","22","25","0","58","18","11","33","1","63","14","14","33","0","2","63"
"Newport","52.01667","-4.83333","45","1","0","2","7","0","8","63","11","22","25","0","58","18","11","33","1","63","14","14","33","0","2","63"
"Newport","51.58774","-2.99835","45","1","0","2","7","0","8","63","11","22","25","0","58","18","11","33","1","63","14","14","33","0","2","63"
"Newport","52.76684","-2.37734","45","1","0","2","7","0","8","63","11","22","25","0","58","18","11","33","1","63","14","14","33","0","2","63"
"Newport","50.70146","-1.29124","45","1","0","2","7","0","8","63","11","22","25","0","58","18","11","33","1","63","14","14","33","0","2","63"
"Newport","53.76333","-0.69986","45","1","0","2","7","0","8","63","11","22","25","0","58","18","11","33","1","63","14","14","33","0","2","63"
"Newport","51.98425","0.21355","45","1","0","2","7","0","8","63","11","22","25","0","58","18","11","33","1","63","14","14","33","0","2","63"
"Newport","-37.84427","144.88483","45","1","0","2","7","0","8","63","11","22","25","0","58","18","11","33","1","63","14","14","33","0","2","63"
"Newport","-33.65639","151.31401","45","1","0","2","7","0","8","63","11","22","25","0","58","18","11","33","1","63","14","14","33","0","2","63"
"Newport","-27.20731","153.10135","45","1","0","2","7","0","8","63","11","22","25","0","58","18","11","33","1","63","14","14","33","0","2","63"
"Newport Beach","33.61891","-117.92895","1","0","0","0","0","0","0","1","1","0","0","0","1","0","0","1","0","1","0","0","1","0","0","1"
"Newport Pagnell","52.08731","-0.72218","3","1","0","0","1","0","0","5","1","1","2","1","5","0","3","2","0","5","2","2","1","0","0","5"
"New Port Richey","28.24418","-82.71927","2","0","0","0","0","0","0","2","0","0","2","0","2","0","0","2","0","2","0","1","1","0","0","2"
"Newquay","50.41557","-5.07319","2","0","0","0","0","0","0","2","0","0","1","0","1","0","0","2","0","2","0","1","1","0","0","2"
"New Rochelle","40.91149","-73.78235","1","0","0","0","0","0","0","1","0","0","0","0","0","0","0","1","0","1","0","1","0","0","0","1"
"Newry","54.17841","-6.33739","4","0","0","0","0","0","1","5","1","2","1","0","4","1","0","4","0","5","0","3","2","0","0","5"
"Newton Abbot","50.52858","-3.61186","13","0","0","1","0","0","1","15","3","3","6","0","12","5","4","6","0","15","2","5","7","0","1","15"
"Newton Aycliffe","54.61842","-1.5719","5","0","0","0","0","0","0","5","2","1","2","0","5","1","1","3","0","5","2","1","2","0","0","5"
"Newton-le-Willows","53.45","-2.6","3","0","0","0","0","0","0","3","1","0","0","0","1","0","2","1","0","3","0","1","2","0","0","3"
"Newton Stewart","54.95784","-4.48315","0","0","0","0","2","0","0","2","0","0","2","0","2","1","0","1","0","2","0","0","2","0","0","2"
"Newtown","39.1245","-84.36161","3","0","0","0","0","0","0","3","0","2","1","0","3","0","0","3","0","3","0","1","1","1","0","3"
"Newtown","40.22928","-74.93683","3","0","0","0","0","0","0","3","0","2","1","0","3","0","0","3","0","3","0","1","1","1","0","3"
"Newtown","41.41398","-73.30345","3","0","0","0","0","0","0","3","0","2","1","0","3","0","0","3","0","3","0","1","1","1","0","3"
"Newtown","52.51667","-3.3","3","0","0","0","0","0","0","3","0","2","1","0","3","0","0","3","0","3","0","1","1","1","0","3"
"Newtown","-38.15391","144.33507","3","0","0","0","0","0","0","3","0","2","1","0","3","0","0","3","0","3","0","1","1","1","0","3"
"Newtown","-33.89835","151.17754","3","0","0","0","0","0","0","3","0","2","1","0","3","0","0","3","0","3","0","1","1","1","0","3"
"Newtown","-27.55602","151.93255","3","0","0","0","0","0","0","3","0","2","1","0","3","0","0","3","0","3","0","1","1","1","0","3"
"Newtown","-27.6163","152.77675","3","0","0","0","0","0","0","3","0","2","1","0","3","0","0","3","0","3","0","1","1","1","0","3"
"Newtownabbey","54.65983","-5.90858","3","0","0","0","1","0","0","4","1","1","1","0","3","1","1","2","0","4","2","0","2","0","0","4"
"Newtownards","54.59236","-5.69092","4","0","0","0","0","0","0","4","1","2","1","0","4","1","2","0","1","4","2","2","0","0","0","4"
"Newville","31.42184","-85.33771","0","0","0","0","1","0","0","1","0","0","0","0","0","1","0","0","0","1","1","0","0","0","0","1"
"Newville","40.17314","-77.3986","0","0","0","0","1","0","0","1","0","0","0","0","0","1","0","0","0","1","1","0","0","0","0","1"
"New Westminster","49.20678","-122.91092","1","0","0","0","0","0","0","1","0","0","1","0","1","0","0","1","0","1","0","0","1","0","0","1"
"New York City","40.71427","-74.00597","28","2","0","2","3","0","1","36","9","7","8","0","24","7","9","20","0","36","2","3","27","2","2","36"
"Neyland","51.71014","-4.95155","4","0","0","0","0","0","1","5","2","0","0","0","2","4","0","1","0","5","3","0","2","0","0","5"
"Ngaoundéré","7.32765","13.58472","0","0","0","0","0","0","0","0","0","2","0","0","2","1","0","1","0","2","0","0","1","0","1","2"
"Ngozi","-2.9075","29.8306","1","0","0","0","0","0","0","1","0","0","0","1","1","0","0","0","1","1","0","0","0","0","1","1"
"Niagara Falls","43.10012","-79.06627","3","0","0","0","0","0","0","3","0","0","2","0","2","1","0","2","0","3","1","0","1","0","1","3"
"Niagara Falls","43.0945","-79.05671","3","0","0","0","0","0","0","3","0","0","2","0","2","1","0","2","0","3","1","0","1","0","1","3"
"Niamey","13.51366","2.1098","2","0","0","0","0","0","0","2","1","1","0","0","2","1","0","0","0","1","0","0","1","0","1","2"
"Nice","39.12323","-122.84833","1","0","0","0","0","0","0","1","0","1","0","0","1","1","0","0","0","1","0","1","0","0","0","1"
"Nice","43.70313","7.26608","1","0","0","0","0","0","0","1","0","1","0","0","1","1","0","0","0","1","0","1","0","0","0","1"
"Nicollet","44.27608","-94.18746","1","0","0","0","0","0","0","1","0","0","0","0","0","0","1","0","0","1","1","0","0","0","0","1"
"Nicosia","37.74747","14.39218","7","1","0","0","0","0","1","9","1","3","0","0","4","2","1","6","0","9","5","1","2","0","1","9"
"Nicosia","35.17531","33.3642","7","1","0","0","0","0","1","9","1","3","0","0","4","2","1","6","0","9","5","1","2","0","1","9"
"Nijmegen","51.8425","5.85278","1","0","0","0","0","0","0","1","0","0","0","0","0","1","0","0","0","1","0","0","1","0","0","1"
"Nin","44.24139","15.17833","1","0","0","0","0","0","0","1","0","0","0","0","0","0","0","1","0","1","1","0","0","0","0","1"
"Ninfield","50.88641","0.42529","1","0","0","0","0","0","0","1","0","1","0","0","1","0","0","1","0","1","0","1","0","0","0","1"
"Niono","14.2526","-5.993","1","0","0","0","0","0","0","1","0","0","0","1","1","0","0","0","1","1","1","0","0","0","0","1"
"Niš","43.32472","21.90333","7","0","0","0","1","0","0","8","5","2","2","0","9","3","0","6","0","9","2","0","5","0","2","9"
"Nizāmābād","18.67154","78.0988","1","0","0","0","0","0","0","1","1","0","0","0","1","0","0","1","0","1","0","0","1","0","0","1"
"Nizāmābād","26.05295","83.05787","1","0","0","0","0","0","0","1","1","0","0","0","1","0","0","1","0","1","0","0","1","0","0","1"
"Nizhniy Novgorod","56.32867","44.00205","1","0","0","0","0","0","0","1","0","0","0","0","0","0","0","1","0","1","0","0","1","0","0","1"
"Nizwá","22.93333","57.53333","1","0","0","0","0","0","0","1","1","0","0","0","1","0","1","0","0","1","0","0","1","0","0","1"
"Njombe","-9.34917","34.77167","2","0","0","0","0","0","0","2","0","2","0","0","2","1","0","1","0","2","1","0","0","0","1","2"
"Nnewi","6.01962","6.91729","2","0","0","0","0","0","0","2","2","0","0","0","2","1","0","1","0","2","0","0","2","0","0","2"
"Noblesville","40.04559","-86.0086","2","0","0","0","0","0","0","2","1","0","0","0","1","1","0","1","0","2","0","0","2","0","0","2"
"Nof HaGalil","32.70816","35.32469","1","0","0","0","0","0","0","1","1","0","0","0","1","0","0","1","0","1","0","0","1","0","0","1"
"Noida","28.58","77.33","3","0","0","0","0","0","0","3","1","1","0","0","2","0","1","2","0","3","0","1","1","0","1","3"
"Noosaville","-26.4","153.06667","1","0","0","0","0","0","0","1","0","0","0","0","0","1","0","0","0","1","0","1","0","0","0","1"
"Norcross","33.94121","-84.21353","1","0","0","0","0","0","0","1","0","0","0","0","0","0","0","1","0","1","0","0","1","0","0","1"
"Normanton","53.7","-1.41667","1","0","0","0","1","0","0","2","0","1","1","0","2","0","0","2","0","2","1","0","1","0","0","2"
"Normanton","-17.67183","141.07721","1","0","0","0","1","0","0","2","0","1","1","0","2","0","0","2","0","2","1","0","1","0","0","2"
"Northallerton","54.33901","-1.43243","5","0","0","0","0","0","0","5","0","1","2","0","3","2","0","3","0","5","0","2","3","0","0","5"
"Northampton","40.68621","-75.49685","73","2","0","2","6","0","6","89","23","25","29","1","78","26","14","49","0","89","16","23","46","0","3","88"
"Northampton","40.88871","-72.68954","73","2","0","2","6","0","6","89","23","25","29","1","78","26","14","49","0","89","16","23","46","0","3","88"
"Northampton","42.32509","-72.6412","73","2","0","2","6","0","6","89","23","25","29","1","78","26","14","49","0","89","16","23","46","0","3","88"
"Northampton","52.25","-0.88333","73","2","0","2","6","0","6","89","23","25","29","1","78","26","14","49","0","89","16","23","46","0","3","88"
"Northampton","-28.34994","114.63821","73","2","0","2","6","0","6","89","23","25","29","1","78","26","14","49","0","89","16","23","46","0","3","88"
"North Berwick","43.3037","-70.73339","1","0","0","1","0","0","0","2","1","0","1","0","2","0","0","2","0","2","0","0","2","0","0","2"
"North Berwick","56.05825","-2.7229","1","0","0","1","0","0","0","2","1","0","1","0","2","0","0","2","0","2","0","0","2","0","0","2"
"Northcote","-37.76667","145","2","0","0","0","0","0","0","2","0","0","0","0","0","2","0","0","0","2","0","0","2","0","0","2"
"North Ferriby","53.72124","-0.5052","2","0","0","0","0","0","0","2","0","0","2","0","2","1","0","1","0","2","0","1","1","0","0","2"
"North Lakes","-27.22426","153.02075","1","0","0","0","0","0","0","1","1","0","0","0","1","0","0","1","0","1","0","1","0","0","0","1"
"Northleach","51.82994","-1.83712","1","0","0","0","0","0","0","1","0","1","0","0","1","0","0","1","0","1","1","0","0","0","0","1"
"North Little Rock","34.76954","-92.26709","0","1","0","0","0","0","0","1","0","1","0","0","1","1","0","0","0","1","0","0","1","0","0","1"
"North Lopham","52.40352","0.99169","1","0","0","0","0","0","0","1","0","1","0","0","1","0","0","1","0","1","0","0","1","0","0","1"
"Northolt","51.54855","-0.36778","1","0","0","0","0","0","0","1","1","0","0","0","1","1","0","0","0","1","0","1","0","0","0","1"
"North Potomac","39.08289","-77.26498","1","0","0","0","0","0","0","1","0","1","0","0","1","0","1","0","0","1","0","0","1","0","0","1"
"North Shields","55.01646","-1.44925","11","0","0","0","2","0","1","14","2","2","5","0","9","4","3","7","0","14","2","6","4","0","2","14"
"North Tawton","50.79968","-3.89759","0","0","0","1","0","0","0","1","1","0","0","0","1","0","0","1","0","1","0","0","1","0","0","1"
"North Thoresby","53.46651","-0.05575","0","0","0","0","1","0","0","1","1","0","0","0","1","0","0","1","0","1","0","1","0","0","0","1"
"North Vancouver","49.31636","-123.06934","1","0","0","0","0","0","0","1","0","0","0","0","0","0","0","1","0","1","0","0","0","1","0","1"
"Northville","42.43115","-83.48327","2","0","0","0","0","0","0","2","0","0","1","0","1","1","1","0","0","2","0","1","1","0","0","2"
"Northville","43.22563","-74.17208","2","0","0","0","0","0","0","2","0","0","1","0","1","1","1","0","0","2","0","1","1","0","0","2"
"Northville","40.9701","-72.61898","2","0","0","0","0","0","0","2","0","0","1","0","1","1","1","0","0","2","0","1","1","0","0","2"
"North Walsham","52.82121","1.38746","1","0","0","0","1","0","0","2","0","0","2","0","2","0","1","1","0","2","0","1","1","0","0","2"
"Northwich","53.25882","-2.52025","14","0","0","0","2","0","1","17","3","4","9","0","16","7","0","10","0","17","2","1","13","0","1","17"
"Northwood","47.73415","-97.56675","1","1","0","0","1","0","0","3","0","1","1","0","2","2","1","0","0","3","1","0","2","0","0","3"
"Northwood","43.44412","-93.22104","1","1","0","0","1","0","0","3","0","1","1","0","2","2","1","0","0","3","1","0","2","0","0","3"
"Northwood","40.47283","-83.73243","1","1","0","0","1","0","0","3","0","1","1","0","2","2","1","0","0","3","1","0","2","0","0","3"
"Northwood","41.60727","-83.46882","1","1","0","0","1","0","0","3","0","1","1","0","2","2","1","0","0","3","1","0","2","0","0","3"
"Northwood","43.19425","-71.1509","1","1","0","0","1","0","0","3","0","1","1","0","2","2","1","0","0","3","1","0","2","0","0","3"
"Northwood","50.74102","-1.31192","1","1","0","0","1","0","0","3","0","1","1","0","2","2","1","0","0","3","1","0","2","0","0","3"
"Northwood","-33.82895","151.1803","1","1","0","0","1","0","0","3","0","1","1","0","2","2","1","0","0","3","1","0","2","0","0","3"
"North York","43.76681","-79.4163","1","0","0","0","0","0","0","1","0","0","1","0","1","0","1","0","0","1","0","0","1","0","0","1"
"North York","39.97815","-76.73302","1","0","0","0","0","0","0","1","0","0","1","0","1","0","1","0","0","1","0","0","1","0","0","1"
"Norwalk","33.90224","-118.08173","1","0","0","0","0","0","0","1","0","0","1","0","1","0","0","1","0","1","0","0","1","0","0","1"
"Norwalk","41.47555","-93.67883","1","0","0","0","0","0","0","1","0","0","1","0","1","0","0","1","0","1","0","0","1","0","0","1"
"Norwalk","43.83052","-90.62152","1","0","0","0","0","0","0","1","0","0","1","0","1","0","0","1","0","1","0","0","1","0","0","1"
"Norwalk","41.24255","-82.61573","1","0","0","0","0","0","0","1","0","0","1","0","1","0","0","1","0","1","0","0","1","0","0","1"
"Norwalk","41.1176","-73.4079","1","0","0","0","0","0","0","1","0","0","1","0","1","0","0","1","0","1","0","0","1","0","0","1"
"Norwich","42.53118","-75.52351","63","2","0","5","5","1","1","77","17","29","18","0","64","31","11","34","0","76","10","23","39","2","3","77"
"Norwich","43.71535","-72.30787","63","2","0","5","5","1","1","77","17","29","18","0","64","31","11","34","0","76","10","23","39","2","3","77"
"Norwich","41.52426","-72.07591","63","2","0","5","5","1","1","77","17","29","18","0","64","31","11","34","0","76","10","23","39","2","3","77"
"Norwich","52.62783","1.29834","63","2","0","5","5","1","1","77","17","29","18","0","64","31","11","34","0","76","10","23","39","2","3","77"
"Nottingham","43.11453","-71.09978","141","9","0","5","18","0","9","182","33","50","58","2","143","61","31","89","0","181","30","43","98","4","5","180"
"Nottingham","52.9536","-1.15047","141","9","0","5","18","0","9","182","33","50","58","2","143","61","31","89","0","181","30","43","98","4","5","180"
"Nouméa","-22.27407","166.44884","0","1","0","0","0","0","0","1","0","1","0","0","1","1","0","0","0","1","1","0","0","0","0","1"
"Novato","38.10742","-122.5697","1","0","0","0","0","0","0","1","0","0","1","0","1","0","0","1","0","1","0","0","1","0","0","1"
"Novi","42.48059","-83.47549","1","0","0","0","0","0","0","1","0","0","0","0","0","0","0","1","0","1","0","0","1","0","0","1"
"Novi Beograd","44.80556","20.42417","1","0","0","0","0","0","0","1","0","1","0","0","1","0","1","0","0","1","0","0","0","1","0","1"
"Novi Pazar","43.13667","20.51222","4","0","0","0","0","0","0","4","0","2","2","0","4","0","0","4","0","4","1","1","2","0","0","4"
"Novi Pazar","43.35","27.2","4","0","0","0","0","0","0","4","0","2","2","0","4","0","0","4","0","4","1","1","2","0","0","4"
"Novi Sad","45.25167","19.83694","13","0","0","0","0","0","0","13","2","0","3","0","5","2","2","9","0","13","4","0","8","0","1","13"
"Novo Mesto","45.80397","15.16886","2","0","0","0","0","0","0","2","1","1","0","0","2","0","1","1","0","2","1","0","1","0","0","2"
"Novo Miloševo","45.71916","20.30364","2","0","0","0","0","0","0","2","0","2","0","0","2","0","2","0","0","2","2","0","0","0","0","2"
"Novomoskovsk","54.0105","38.2846","1","0","0","0","0","0","0","1","0","1","0","0","1","0","0","0","1","1","0","0","0","0","1","1"
"Nowshera","34.01583","71.98123","4","1","0","0","0","0","0","5","1","2","1","1","5","3","1","0","1","5","1","0","4","0","0","5"
"Nowshera Cantonment","33.99829","71.99834","3","0","0","0","0","0","0","3","1","1","1","0","3","1","0","1","1","3","1","0","2","0","0","3"
"Nsukka","6.85783","7.39577","1","0","0","0","0","0","0","1","1","0","0","0","1","0","1","0","0","1","0","1","0","0","0","1"
"Nuevo Casas Grandes","30.41552","-107.91166","1","0","0","0","0","0","0","1","1","0","0","0","1","1","0","0","0","1","0","0","1","0","0","1"
"Nuneaton","52.52323","-1.46523","40","2","0","1","3","0","1","47","10","14","21","0","45","11","6","30","0","47","7","24","14","0","2","47"
"Nürnberg","49.45421","11.07752","2","0","0","0","0","0","0","2","0","0","1","0","1","1","0","1","0","2","0","0","1","1","0","2"
"Nur-Sultan","51.1801","71.44598","1","0","0","0","0","0","0","1","0","0","0","1","1","0","0","0","1","1","1","0","0","0","0","1"
"Nushki","29.55218","66.02288","1","0","0","0","0","0","0","1","0","0","1","0","1","0","0","1","0","1","0","0","1","0","0","1"
"Nyahururu","0.03813","36.36339","1","0","0","0","0","0","0","1","0","0","0","0","0","0","1","0","0","1","0","0","0","0","1","1"
"Nyeri","-0.42013","36.94759","4","0","0","0","0","0","0","4","1","3","0","0","4","2","1","1","0","4","1","1","0","1","1","4"
"Nyimba","-14.55656","30.8149","2","0","0","0","0","0","0","2","0","1","1","0","2","0","2","0","0","2","0","0","1","0","1","2"
"Nyíregyháza","47.95539","21.71671","1","0","0","0","0","0","0","1","0","0","0","0","0","0","0","1","0","1","0","0","0","0","1","1"
"Nyköping","58.753","17.00788","2","0","0","0","0","0","0","2","0","0","2","0","2","0","1","1","0","2","0","0","2","0","0","2"
"Nynäshamn","58.90337","17.94793","1","0","0","0","0","0","0","1","0","1","0","0","1","0","0","1","0","1","0","0","1","0","0","1"
"Nyon","46.38318","6.23955","1","0","0","0","0","0","0","1","1","0","0","0","1","0","0","1","0","1","0","0","1","0","0","1"
"Oakdale","37.76659","-120.84715","1","0","0","0","0","0","0","1","0","0","0","0","0","0","0","1","0","1","0","0","1","0","0","1"
"Oakdale","44.96302","-92.96494","1","0","0","0","0","0","0","1","0","0","0","0","0","0","0","1","0","1","0","0","1","0","0","1"
"Oakdale","30.81603","-92.66042","1","0","0","0","0","0","0","1","0","0","0","0","0","0","0","1","0","1","0","0","1","0","0","1"
"Oakdale","40.39812","-80.18561","1","0","0","0","0","0","0","1","0","0","0","0","0","0","0","1","0","1","0","0","1","0","0","1"
"Oakdale","40.99203","-75.9202","1","0","0","0","0","0","0","1","0","0","0","0","0","0","0","1","0","1","0","0","1","0","0","1"
"Oakdale","42.2512","-73.78013","1","0","0","0","0","0","0","1","0","0","0","0","0","0","0","1","0","1","0","0","1","0","0","1"
"Oakdale","40.74399","-73.13872","1","0","0","0","0","0","0","1","0","0","0","0","0","0","0","1","0","1","0","0","1","0","0","1"
"Oakdale","-34.0793","150.5132","1","0","0","0","0","0","0","1","0","0","0","0","0","0","0","1","0","1","0","0","1","0","0","1"
"Oakham","42.35287","-72.04535","9","0","0","1","2","0","1","13","5","3","4","1","13","6","3","4","0","13","4","3","6","0","0","13"
"Oakham","52.66667","-0.73333","9","0","0","1","2","0","1","13","5","3","4","1","13","6","3","4","0","13","4","3","6","0","0","13"
"Oakland","43.42206","-123.29841","1","0","0","0","0","0","0","1","0","0","1","0","1","1","0","0","0","1","0","0","1","0","0","1"
"Oakland","37.80437","-122.2708","1","0","0","0","0","0","0","1","0","0","1","0","1","1","0","0","0","1","0","0","1","0","0","1"
"Oakland","34.1001","-96.79389","1","0","0","0","0","0","0","1","0","0","1","0","1","1","0","0","0","1","0","0","1","0","0","1"
"Oakland","41.83583","-96.46697","1","0","0","0","0","0","0","1","0","0","1","0","1","1","0","0","0","1","0","0","1","0","0","1"
"Oakland","41.30916","-95.39667","1","0","0","0","0","0","0","1","0","0","1","0","1","1","0","0","0","1","0","0","1","0","0","1"
"Oakland","42.58109","-93.44326","1","0","0","0","0","0","0","1","0","0","1","0","1","1","0","0","0","1","0","0","1","0","0","1"
"Oakland","38.57644","-90.38567","1","0","0","0","0","0","0","1","0","0","1","0","1","1","0","0","0","1","0","0","1","0","0","1"
"Oakland","34.05567","-89.91648","1","0","0","0","0","0","0","1","0","0","1","0","1","1","0","0","0","1","0","0","1","0","0","1"
"Oakland","35.22898","-89.51508","1","0","0","0","0","0","0","1","0","0","1","0","1","1","0","0","0","1","0","0","1","0","0","1"
"Oakland","39.65392","-88.02615","1","0","0","0","0","0","0","1","0","0","1","0","1","1","0","0","0","1","0","0","1","0","0","1"
"Oakland","28.555","-81.63313","1","0","0","0","0","0","0","1","0","0","1","0","1","1","0","0","0","1","0","0","1","0","0","1"
"Oakland","33.98293","-80.48842","1","0","0","0","0","0","0","1","0","0","1","0","1","1","0","0","0","1","0","0","1","0","0","1"
"Oakland","40.98978","-80.36951","1","0","0","0","0","0","0","1","0","0","1","0","1","1","0","0","0","1","0","0","1","0","0","1"
"Oakland","39.40787","-79.40671","1","0","0","0","0","0","0","1","0","0","1","0","1","1","0","0","0","1","0","0","1","0","0","1"
"Oakland","40.30646","-78.88752","1","0","0","0","0","0","0","1","0","0","1","0","1","1","0","0","0","1","0","0","1","0","0","1"
"Oakland","41.95008","-75.6049","1","0","0","0","0","0","0","1","0","0","1","0","1","1","0","0","0","1","0","0","1","0","0","1"
"Oakland","41.01315","-74.26431","1","0","0","0","0","0","0","1","0","0","1","0","1","1","0","0","0","1","0","0","1","0","0","1"
"Oakland","44.54034","-69.72199","1","0","0","0","0","0","0","1","0","0","1","0","1","1","0","0","0","1","0","0","1","0","0","1"
"Oakley","37.99742","-121.71245","2","0","0","0","0","0","0","2","0","0","1","0","1","0","0","2","0","2","0","0","2","0","0","2"
"Oakley","42.24325","-113.88196","2","0","0","0","0","0","0","2","0","0","1","0","1","0","0","2","0","2","0","0","2","0","0","2"
"Oakley","40.71467","-111.30074","2","0","0","0","0","0","0","2","0","0","1","0","1","0","0","2","0","2","0","0","2","0","0","2"
"Oakley","39.13334","-100.86376","2","0","0","0","0","0","0","2","0","0","1","0","1","0","0","2","0","2","0","0","2","0","0","2"
"Oakley","56.08421","-3.56311","2","0","0","0","0","0","0","2","0","0","1","0","1","0","0","2","0","2","0","0","2","0","0","2"
"Oakley","51.80406","-1.07261","2","0","0","0","0","0","0","2","0","0","1","0","1","0","0","2","0","2","0","0","2","0","0","2"
"Oakley","52.16862","-0.52649","2","0","0","0","0","0","0","2","0","0","1","0","1","0","0","2","0","2","0","0","2","0","0","2"
"Oak Park","34.17917","-118.76287","0","0","0","0","1","0","0","1","0","1","0","0","1","0","0","1","0","1","0","0","1","0","0","1"
"Oak Park","41.88503","-87.7845","0","0","0","0","1","0","0","1","0","1","0","0","1","0","0","1","0","1","0","0","1","0","0","1"
"Oak Park","38.30562","-85.69635","0","0","0","0","1","0","0","1","0","1","0","0","1","0","0","1","0","1","0","0","1","0","0","1"
"Oak Park","42.45948","-83.18271","0","0","0","0","1","0","0","1","0","1","0","0","1","0","0","1","0","1","0","0","1","0","0","1"
"Oak Park","-37.71842","144.91945","0","0","0","0","1","0","0","1","0","1","0","0","1","0","0","1","0","1","0","0","1","0","0","1"
"Oakville","46.84038","-123.23237","3","0","0","0","0","0","0","3","0","1","1","0","2","0","2","1","0","3","0","2","1","0","0","3"
"Oakville","38.47005","-90.30456","3","0","0","0","0","0","0","3","0","1","1","0","2","0","2","1","0","3","0","2","1","0","0","3"
"Oakville","43.45011","-79.68292","3","0","0","0","0","0","0","3","0","1","1","0","2","0","2","1","0","3","0","2","1","0","0","3"
"Oakville","41.59343","-73.08539","3","0","0","0","0","0","0","3","0","1","1","0","2","0","2","1","0","3","0","2","1","0","0","3"
"Oakville","-33.61558","150.88006","3","0","0","0","0","0","0","3","0","1","1","0","2","0","2","1","0","3","0","2","1","0","0","3"
"Oaxaca","17.06542","-96.72365","1","0","0","0","0","0","0","1","0","1","0","0","1","1","0","0","0","1","0","0","1","0","0","1"
"Oban","56.41535","-5.47184","1","0","0","0","0","0","0","1","1","0","0","0","1","0","0","0","1","1","0","1","0","0","0","1"
"Oberammergau","47.59812","11.06692","1","0","0","0","0","0","0","1","0","1","0","0","1","0","0","1","0","1","0","0","0","0","1","1"
"Oberboihingen","48.65","9.36667","1","0","0","0","0","0","0","1","1","0","0","0","1","0","0","1","0","1","0","0","1","0","0","1"
"Oberentfelden","47.35639","8.04594","0","0","0","0","0","0","1","1","0","1","0","0","1","1","0","0","0","1","0","0","0","0","1","1"
"Oberhaching","48.02455","11.59744","1","0","0","0","0","0","0","1","0","0","1","0","1","0","0","1","0","1","0","0","1","0","0","1"
"Oberursel","50.20731","8.57747","0","0","0","0","1","0","0","1","0","1","0","0","1","1","0","0","0","1","1","0","0","0","0","1"
"Obuase","6.20228","-1.66796","2","0","0","0","0","0","0","2","0","2","0","0","2","0","1","1","0","2","1","0","1","0","0","2"
"Ocean Pines","38.39539","-75.15574","1","0","0","0","0","0","0","1","0","0","1","0","1","0","1","0","0","1","0","1","0","0","0","1"
"Oceanside","33.19587","-117.37948","2","0","0","0","0","0","0","2","0","0","0","0","0","0","1","1","0","2","1","1","0","0","0","2"
"Oceanside","40.63871","-73.64013","2","0","0","0","0","0","0","2","0","0","0","0","0","0","1","1","0","2","1","1","0","0","0","2"
"Ocho Rios","18.4076","-77.10312","1","0","0","0","0","0","0","1","0","0","0","0","0","1","0","0","0","1","0","0","1","0","0","1"
"Ockley","51.14678","-0.36366","1","0","0","0","0","0","0","1","0","0","1","0","1","1","0","0","0","1","0","0","1","0","0","1"
"Odenton","39.084","-76.70025","1","0","0","0","0","0","0","1","0","0","0","0","0","0","1","0","0","1","1","0","0","0","0","1"
"Odessa","47.3332","-118.69083","2","1","0","0","0","0","0","3","0","2","1","0","3","0","1","2","0","3","0","0","3","0","0","3"
"Odessa","31.84568","-102.36764","2","1","0","0","0","0","0","3","0","2","1","0","3","0","1","2","0","3","0","0","3","0","0","3"
"Odessa","38.99917","-93.95356","2","1","0","0","0","0","0","3","0","2","1","0","3","0","1","2","0","3","0","0","3","0","0","3"
"Odessa","28.1939","-82.59176","2","1","0","0","0","0","0","3","0","2","1","0","3","0","1","2","0","3","0","0","3","0","0","3"
"Odessa","42.33674","-76.78857","2","1","0","0","0","0","0","3","0","2","1","0","3","0","1","2","0","3","0","0","3","0","0","3"
"Odessa","46.47747","30.73262","2","1","0","0","0","0","0","3","0","2","1","0","3","0","1","2","0","3","0","0","3","0","0","3"
"Odiham","51.25407","-0.93933","1","0","0","0","0","0","0","1","1","0","0","0","1","0","0","1","0","1","0","0","1","0","0","1"
"Oeiras","-7.02528","-42.13111","1","0","0","0","0","0","0","1","0","1","0","0","1","0","0","1","0","1","1","0","0","0","0","1"
"Oeiras","38.69105","-9.31085","1","0","0","0","0","0","0","1","0","1","0","0","1","0","0","1","0","1","1","0","0","0","0","1"
"Offenburg","48.47377","7.94495","0","0","0","0","1","0","0","1","0","0","1","0","1","0","0","1","0","1","1","0","0","0","0","1"
"Ogmore Vale","51.6023","-3.54217","0","0","0","1","0","0","0","1","1","0","0","0","1","0","1","0","0","1","0","1","0","0","0","1"
"Ohrid","41.11722","20.80194","2","0","0","0","0","0","0","2","0","0","1","0","1","0","0","2","0","2","1","1","0","0","0","2"
"Oistins","13.07067","-59.54637","1","0","0","0","0","0","0","1","1","0","0","0","1","0","0","1","0","1","0","0","1","0","0","1"
"Okahandja","-21.98333","16.91667","0","0","0","0","1","0","0","1","0","1","0","0","1","0","0","0","0","0","1","0","0","0","0","1"
"Okara","30.81029","73.45155","10","1","1","0","0","0","0","12","8","2","0","0","10","3","8","0","0","11","1","0","11","0","0","12"
"Okehampton","50.73841","-4.0016","4","0","0","0","0","0","2","6","1","3","1","0","5","1","2","3","0","6","2","0","3","0","1","6"
"Oklahoma City","35.46756","-97.51643","3","0","0","0","0","0","0","3","1","1","1","0","3","1","0","2","0","3","1","1","1","0","0","3"
"Oldbury","52.5","-2.01667","2","0","0","0","0","0","0","2","0","1","0","0","1","1","0","1","0","2","1","0","1","0","0","2"
"Oldcastle","53.76648","-7.16284","1","0","0","0","0","0","0","1","0","2","0","0","2","2","0","0","0","2","0","2","0","0","0","2"
"Oldham","53.54051","-2.1183","15","0","0","0","2","0","1","18","3","7","5","1","16","5","4","9","0","18","5","3","9","0","1","18"
"Old Windsor","51.45807","-0.58674","1","1","0","0","0","0","0","2","0","1","1","0","2","1","0","1","0","2","0","0","2","0","0","2"
"Olive Branch","34.96176","-89.82953","0","0","0","0","0","0","1","1","0","1","0","0","1","0","1","0","0","1","1","0","0","0","0","1"
"Olive Branch","37.16866","-89.35175","0","0","0","0","0","0","1","1","0","1","0","0","1","0","1","0","0","1","1","0","0","0","0","1"
"Olney","33.37066","-98.75284","1","0","0","0","0","0","0","1","0","0","1","0","1","0","0","1","0","1","0","0","1","0","0","1"
"Olney","38.73088","-88.08532","1","0","0","0","0","0","0","1","0","0","1","0","1","0","0","1","0","1","0","0","1","0","0","1"
"Olney","39.15316","-77.06692","1","0","0","0","0","0","0","1","0","0","1","0","1","0","0","1","0","1","0","0","1","0","0","1"
"Olney","52.15345","-0.70201","1","0","0","0","0","0","0","1","0","0","1","0","1","0","0","1","0","1","0","0","1","0","0","1"
"Olomouc","49.59552","17.25175","1","0","0","0","0","0","0","1","0","1","0","0","1","0","1","0","0","1","1","0","0","0","0","1"
"Olympia","47.03787","-122.9007","1","0","0","0","0","0","0","1","0","0","0","0","0","1","0","0","0","1","1","0","0","0","0","1"
"Omagh","54.6","-7.3","1","0","0","0","0","0","0","1","0","0","0","0","0","0","0","1","0","1","1","0","0","0","0","1"
"Omdurman","15.64453","32.47773","2","0","0","0","0","0","0","2","0","2","0","0","2","1","1","0","0","2","0","0","0","1","0","1"
"Omu-Aran","8.13857","5.1026","1","0","0","0","0","0","0","1","0","1","0","0","1","0","1","0","0","1","0","0","0","0","1","1"
"Onchan","54.17329","-4.45324","1","0","0","0","0","0","0","1","0","1","0","0","1","1","0","0","0","1","1","0","0","0","0","1"
"Ondangwa","-17.91667","15.95","8","0","0","0","1","0","0","9","1","2","0","1","4","1","7","0","1","9","2","0","1","1","5","9"
"Ondo","7.09316","4.83528","1","0","0","0","0","0","0","1","0","0","0","1","1","1","0","0","0","1","0","0","0","1","0","1"
"Ongole","15.50357","80.04454","1","0","0","0","0","0","0","1","0","1","0","0","1","1","0","0","0","1","0","0","1","0","0","1"
"Onitsha","6.14978","6.78569","2","0","0","0","0","0","0","2","0","1","1","0","2","1","0","1","0","2","0","0","1","1","0","2"
"Ooltewah","35.07507","-85.06217","0","0","0","0","1","0","0","1","1","0","0","0","1","0","0","1","0","1","0","0","1","0","0","1"
"Opatija","45.33658","14.30782","1","0","0","0","0","0","0","1","0","0","0","0","0","0","1","0","0","1","0","0","1","0","0","1"
"Opfikon","47.43169","8.57588","1","0","0","0","0","0","0","1","0","0","0","0","0","0","0","1","0","1","0","0","1","0","0","1"
"Opuwo","-18.06068","13.83998","1","0","0","0","0","0","0","1","0","0","0","0","0","1","0","0","0","1","1","0","0","0","0","1"
"Oradea","47.0458","21.91833","14","0","0","0","0","0","0","14","6","2","0","0","8","5","4","5","0","14","8","1","5","0","0","14"
"Oran","23.97199","-102.90474","8","0","0","0","0","0","0","8","1","3","4","0","8","2","1","5","0","8","3","4","1","0","0","8"
"Oran","37.08505","-89.65536","8","0","0","0","0","0","0","8","1","3","4","0","8","2","1","5","0","8","3","4","1","0","0","8"
"Oran","35.69906","-0.63588","8","0","0","0","0","0","0","8","1","3","4","0","8","2","1","5","0","8","3","4","1","0","0","8"
"Oran","25.36882","80.7423","8","0","0","0","0","0","0","8","1","3","4","0","8","2","1","5","0","8","3","4","1","0","0","8"
"Oranjestad","12.52398","-70.02703","2","0","0","0","0","0","0","2","1","1","0","0","2","0","1","1","0","2","1","0","1","0","0","2"
"Oranjestad","17.48303","-62.9864","2","0","0","0","0","0","0","2","1","1","0","0","2","0","1","1","0","2","1","0","1","0","0","2"
"Orem","40.2969","-111.69465","1","0","0","0","0","0","0","1","1","0","0","0","1","0","0","1","0","1","0","0","1","0","0","1"
"Orenburg","51.7727","55.0988","2","1","0","0","0","0","0","3","0","1","1","0","2","1","1","1","0","3","1","0","2","0","0","3"
"Orihuela","38.08483","-0.94401","1","0","0","0","0","0","0","1","0","0","0","0","0","0","1","0","0","1","1","0","0","0","0","1"
"Orillia","44.60868","-79.42068","1","0","0","0","0","0","0","1","0","0","1","0","1","0","0","1","0","1","0","1","0","0","0","1"
"Orkanger","63.30668","9.85025","1","0","0","0","0","0","0","1","0","1","0","0","1","0","0","1","0","1","0","0","1","0","0","1"
"Orland","39.74738","-122.19637","1","0","0","0","0","0","0","1","0","0","1","0","1","0","1","0","0","1","0","1","0","0","0","1"
"Orland","44.57035","-68.73586","1","0","0","0","0","0","0","1","0","0","1","0","1","0","1","0","0","1","0","1","0","0","0","1"
"Orlando","28.53834","-81.37924","7","0","0","0","1","0","1","9","2","5","1","1","9","2","5","2","0","9","3","3","3","0","0","9"
"Orlu","5.79565","7.03513","1","0","0","0","0","0","0","1","0","0","0","1","1","1","0","0","0","1","0","0","1","0","0","1"
"Ormeau","-27.76791","153.2428","0","0","0","0","1","0","0","1","0","0","0","0","0","0","0","1","0","1","0","0","1","0","0","1"
"Ormskirk","53.56685","-2.88178","11","1","0","0","0","0","1","13","2","3","3","0","8","7","1","5","0","13","3","4","6","0","0","13"
"Oro Valley","32.39091","-110.96649","1","0","0","0","0","0","0","1","0","0","0","0","0","0","0","1","0","1","0","0","1","0","0","1"
"Orpington","51.37457","0.09785","9","0","0","1","1","0","3","14","5","3","5","0","13","1","3","10","0","14","1","3","10","0","0","14"
"Oruro","-17.98333","-67.15","1","0","0","0","0","0","0","1","0","0","1","0","1","0","1","0","0","1","0","0","1","0","0","1"
"Osh","40.52828","72.7985","4","0","0","0","1","0","0","5","5","0","0","0","5","0","2","3","0","5","0","0","5","0","0","5"
"Oshakati","-17.78833","15.70436","8","0","0","0","0","0","0","8","0","4","1","0","5","3","2","1","2","8","4","1","2","0","1","8"
"Osijek","45.55111","18.69389","1","0","0","0","0","0","0","1","0","1","0","0","1","0","0","1","0","1","1","0","0","0","0","1"
"Oslo","59.91273","10.74609","5","1","0","0","0","0","1","7","1","2","0","0","3","2","2","3","0","7","0","1","6","0","0","7"
"Osmanabad","18.18158","76.03889","1","0","0","0","0","0","0","1","0","0","1","0","1","0","0","1","0","1","0","0","0","0","1","1"
"Osmaniye","37.07417","36.24778","1","0","0","0","0","0","0","1","0","0","0","0","0","0","0","1","0","1","1","0","0","0","0","1"
"Osmate","45.78867","8.65523","1","0","0","0","0","0","0","1","0","0","1","0","1","0","0","1","0","1","0","0","1","0","0","1"
"Osorno","-40.57395","-73.13348","1","0","0","0","0","0","0","1","0","1","0","0","1","1","0","0","0","1","1","0","0","0","0","1"
"Ossett","53.67978","-1.58006","1","0","0","0","0","0","0","1","0","0","0","0","0","0","0","1","0","1","0","1","0","0","0","1"
"Ostrava","49.83465","18.28204","1","0","0","0","0","0","0","1","0","1","0","0","1","0","0","1","0","1","1","0","0","0","0","1"
"Oswestry","52.86195","-3.05497","5","0","0","0","0","0","1","6","1","1","3","0","5","3","1","2","0","6","0","2","3","0","1","6"
"Otford","51.31283","0.19046","2","0","0","0","0","0","0","2","0","1","0","0","1","0","1","1","0","2","0","0","1","1","0","2"
"Otley","53.90553","-1.69383","3","0","0","0","0","0","1","4","2","0","1","0","3","0","1","3","0","4","1","1","2","0","0","4"
"Otley","52.15134","1.22","3","0","0","0","0","0","1","4","2","0","1","0","3","0","1","3","0","4","1","1","2","0","0","4"
"Otopeni","44.55","26.06667","1","0","0","0","0","0","0","1","1","0","0","0","1","0","1","0","0","1","0","0","1","0","0","1"
"Ottawa","38.61557","-95.26775","8","0","0","0","1","0","0","9","1","3","4","0","8","3","2","4","0","9","3","1","5","0","0","9"
"Ottawa","41.34559","-88.84258","8","0","0","0","1","0","0","9","1","3","4","0","8","3","2","4","0","9","3","1","5","0","0","9"
"Ottawa","41.01922","-84.04717","8","0","0","0","1","0","0","9","1","3","4","0","8","3","2","4","0","9","3","1","5","0","0","9"
"Ottawa","45.41117","-75.69812","8","0","0","0","1","0","0","9","1","3","4","0","8","3","2","4","0","9","3","1","5","0","0","9"
"Ottershaw","51.36262","-0.52752","1","0","0","0","0","0","0","1","0","1","0","0","1","1","0","0","0","1","0","1","0","0","0","1"
"Ottery St Mary","50.75","-3.26667","1","0","0","0","0","0","0","1","0","0","1","0","1","0","0","1","0","1","0","0","1","0","0","1"
"Ouagadougou","12.36566","-1.53388","7","0","0","0","0","0","0","7","0","3","0","1","4","3","1","1","1","6","1","1","3","0","2","7"
"Ouanaminthe","19.54934","-71.72475","1","0","0","0","0","0","0","1","0","0","0","1","1","0","1","0","0","1","0","0","1","0","0","1"
"Ouargla","31.94932","5.32502","1","1","0","0","0","0","0","2","1","1","0","0","2","1","1","0","0","2","1","0","1","0","0","2"
"Ouarzazat","30.91894","-6.89341","3","0","0","0","0","0","0","3","0","2","1","1","4","0","0","4","0","4","0","0","2","0","2","4"
"Oujda-Angad","34.68139","-1.90858","2","0","0","0","0","0","0","2","2","0","0","0","2","0","0","2","0","2","0","1","1","0","0","2"
"Oulu","65.01236","25.46816","0","0","0","0","0","0","1","1","1","0","0","0","1","0","1","0","0","1","0","0","1","0","0","1"
"Oundle","52.48093","-0.46732","2","0","0","0","0","0","0","2","1","0","1","0","2","0","1","1","0","2","0","0","2","0","0","2"
"Overland Park","38.98223","-94.67079","0","0","0","0","0","0","1","1","0","0","0","0","0","0","0","0","1","1","1","0","0","0","0","1"
"Oviedo","22.04478","-98.40043","1","0","0","0","0","0","0","1","1","0","0","0","1","0","0","1","0","1","0","0","1","0","0","1"
"Oviedo","28.67","-81.20812","1","0","0","0","0","0","0","1","1","0","0","0","1","0","0","1","0","1","0","0","1","0","0","1"
"Oviedo","17.80136","-71.401","1","0","0","0","0","0","0","1","1","0","0","0","1","0","0","1","0","1","0","0","1","0","0","1"
"Oviedo","43.36029","-5.84476","1","0","0","0","0","0","0","1","1","0","0","0","1","0","0","1","0","1","0","0","1","0","0","1"
"Owerri","5.48363","7.03325","1","0","0","0","0","0","0","1","1","0","0","0","1","1","0","0","0","1","0","0","1","0","0","1"
"Owings Mills","39.41955","-76.78025","1","0","0","0","0","0","0","1","0","0","1","0","1","1","0","0","0","1","0","0","1","0","0","1"
"Oxford","40.24834","-99.63344","123","7","0","7","6","0","5","148","29","51","45","1","126","49","20","78","0","147","18","38","72","3","15","146"
"Oxford","37.27419","-97.16893","123","7","0","7","6","0","5","148","29","51","45","1","126","49","20","78","0","147","18","38","72","3","15","146"
"Oxford","36.22118","-91.92932","123","7","0","7","6","0","5","148","29","51","45","1","126","49","20","78","0","147","18","38","72","3","15","146"
"Oxford","41.72334","-91.79045","123","7","0","7","6","0","5","148","29","51","45","1","126","49","20","78","0","147","18","38","72","3","15","146"
"Oxford","43.78137","-89.57262","123","7","0","7","6","0","5","148","29","51","45","1","126","49","20","78","0","147","18","38","72","3","15","146"
"Oxford","34.3665","-89.51925","123","7","0","7","6","0","5","148","29","51","45","1","126","49","20","78","0","147","18","38","72","3","15","146"
"Oxford","40.51976","-87.24779","123","7","0","7","6","0","5","148","29","51","45","1","126","49","20","78","0","147","18","38","72","3","15","146"
"Oxford","33.61427","-85.83496","123","7","0","7","6","0","5","148","29","51","45","1","126","49","20","78","0","147","18","38","72","3","15","146"
"Oxford","39.507","-84.74523","123","7","0","7","6","0","5","148","29","51","45","1","126","49","20","78","0","147","18","38","72","3","15","146"
"Oxford","33.619","-83.86741","123","7","0","7","6","0","5","148","29","51","45","1","126","49","20","78","0","147","18","38","72","3","15","146"
"Oxford","42.82475","-83.26466","123","7","0","7","6","0","5","148","29","51","45","1","126","49","20","78","0","147","18","38","72","3","15","146"
"Oxford","36.3107","-78.59083","123","7","0","7","6","0","5","148","29","51","45","1","126","49","20","78","0","147","18","38","72","3","15","146"
"Oxford","38.68651","-76.17161","123","7","0","7","6","0","5","148","29","51","45","1","126","49","20","78","0","147","18","38","72","3","15","146"
"Oxford","39.78539","-75.97883","123","7","0","7","6","0","5","148","29","51","45","1","126","49","20","78","0","147","18","38","72","3","15","146"
"Oxford","42.44202","-75.59769","123","7","0","7","6","0","5","148","29","51","45","1","126","49","20","78","0","147","18","38","72","3","15","146"
"Oxford","40.80315","-74.98962","123","7","0","7","6","0","5","148","29","51","45","1","126","49","20","78","0","147","18","38","72","3","15","146"
"Oxford","41.43399","-73.11678","123","7","0","7","6","0","5","148","29","51","45","1","126","49","20","78","0","147","18","38","72","3","15","146"
"Oxford","42.11676","-71.86479","123","7","0","7","6","0","5","148","29","51","45","1","126","49","20","78","0","147","18","38","72","3","15","146"
"Oxford","44.13174","-70.49311","123","7","0","7","6","0","5","148","29","51","45","1","126","49","20","78","0","147","18","38","72","3","15","146"
"Oxford","45.73345","-63.86542","123","7","0","7","6","0","5","148","29","51","45","1","126","49","20","78","0","147","18","38","72","3","15","146"
"Oxford","51.75222","-1.25596","123","7","0","7","6","0","5","148","29","51","45","1","126","49","20","78","0","147","18","38","72","3","15","146"
"Oxford","-43.3","172.18333","123","7","0","7","6","0","5","148","29","51","45","1","126","49","20","78","0","147","18","38","72","3","15","146"
"Oxted","51.25687","-0.00601","9","0","0","0","0","0","0","9","2","2","2","0","6","3","0","6","0","9","2","2","4","0","1","9"
"Oyo","7.85257","3.93125","2","0","0","0","0","0","0","2","1","1","0","0","2","2","0","0","0","2","1","0","1","0","0","2"
"Oyugis","-0.50974","34.73067","2","0","0","0","0","0","0","2","0","0","0","1","1","1","0","0","0","1","0","0","0","0","1","1"
"Pābna","24.00644","89.2372","2","0","0","0","0","0","0","2","0","0","0","2","2","0","0","1","0","1","0","0","2","0","0","2"
"Paddock Wood","51.18187","0.38229","3","0","0","0","0","0","0","3","0","1","2","0","3","3","0","0","0","3","1","0","2","0","0","3"
"Paderborn","51.71905","8.75439","2","0","0","0","0","0","0","2","0","1","0","0","1","1","0","0","1","2","1","0","1","0","0","2"
"Padova","45.40797","11.88586","1","0","0","0","0","0","0","1","0","0","0","0","0","0","1","0","0","1","0","0","1","0","0","1"
"Padstow","50.53885","-4.93664","3","0","0","0","0","0","0","3","1","0","2","0","3","0","0","3","0","3","0","1","1","0","0","2"
"Padstow","-33.95687","151.03191","3","0","0","0","0","0","0","3","1","0","2","0","3","0","0","3","0","3","0","1","1","0","0","2"
"Pagadian","7.8257","123.437","1","0","0","0","0","0","0","1","0","1","0","0","1","0","0","1","0","1","0","0","0","0","0","0"
"Pagosa Springs","37.26945","-107.00976","1","0","0","0","0","0","0","1","0","0","0","0","0","0","0","1","0","1","0","1","0","0","0","1"
"Paianía","37.95527","23.85443","1","0","0","0","0","0","0","1","1","0","0","0","1","0","1","0","0","1","0","0","1","0","0","1"
"Paignton","50.43565","-3.56789","3","0","0","0","0","0","0","3","0","3","0","0","3","2","0","1","0","3","2","1","0","0","0","3"
"Painswick","51.78568","-2.19555","2","0","0","0","1","0","0","3","1","1","0","0","2","2","0","1","0","3","0","2","1","0","0","3"
"Paisley","28.9836","-81.54174","3","0","0","0","1","0","2","6","1","2","1","1","5","0","0","6","0","6","1","1","4","0","0","6"
"Paisley","44.30641","-81.27265","3","0","0","0","1","0","2","6","1","2","1","1","5","0","0","6","0","6","1","1","4","0","0","6"
"Paisley","55.83173","-4.43254","3","0","0","0","1","0","2","6","1","2","1","1","5","0","0","6","0","6","1","1","4","0","0","6"
"Pakenham","52.27051","0.82103","1","0","0","0","0","0","0","1","1","0","0","0","1","0","0","1","0","1","0","0","0","1","0","1"
"Pakenham","-38.07018","145.47411","1","0","0","0","0","0","0","1","1","0","0","0","1","0","0","1","0","1","0","0","0","1","0","1"
"Pakpattan","30.34314","73.38944","2","0","0","0","0","0","0","2","0","0","1","0","1","2","0","0","0","2","0","0","1","0","1","2"
"Palaió Fáliro","37.92812","23.70105","1","0","0","0","0","0","0","1","1","0","0","0","1","1","0","0","0","1","0","0","1","0","0","1"
"Palatine","42.1103","-88.03424","0","1","0","0","0","0","0","1","1","0","0","0","1","0","0","1","0","1","0","0","1","0","0","1"
"Palembang","-2.91673","104.7458","1","0","0","0","0","0","0","1","1","0","0","0","1","0","1","0","0","1","0","1","0","0","0","1"
"Palencia","14.66715","-90.35721","1","0","0","0","0","0","0","1","0","0","0","0","0","0","0","1","0","1","0","0","0","0","1","1"
"Palencia","42.00955","-4.52406","1","0","0","0","0","0","0","1","0","0","0","0","0","0","0","1","0","1","0","0","0","0","1","1"
"Palermo","39.43544","-121.53802","4","0","0","0","0","0","0","4","0","0","0","0","0","0","1","3","0","4","1","0","2","0","1","4"
"Palermo","2.89167","-75.4375","4","0","0","0","0","0","0","4","0","0","0","0","0","0","1","3","0","4","1","0","2","0","1","4"
"Palermo","44.40785","-69.47393","4","0","0","0","0","0","0","4","0","0","0","0","0","0","1","3","0","4","1","0","2","0","1","4"
"Palermo","38.13205","13.33561","4","0","0","0","0","0","0","4","0","0","0","0","0","0","1","3","0","4","1","0","2","0","1","4"
"Palladam","10.99175","77.28633","1","0","0","0","0","0","0","1","0","0","1","0","1","0","1","0","0","1","0","0","1","0","0","1"
"Palma","39.56939","2.65024","4","0","0","0","0","0","0","4","1","1","0","0","2","0","0","4","0","4","1","0","2","0","1","4"
"Palma","37.95388","12.5149","4","0","0","0","0","0","0","4","1","1","0","0","2","0","0","4","0","4","1","0","2","0","1","4"
"Palmanova","39.5247","2.53922","1","0","0","0","0","0","0","1","1","0","0","0","1","0","0","1","0","1","0","0","0","0","1","1"
"Palmanova","45.9054","13.30998","1","0","0","0","0","0","0","1","1","0","0","0","1","0","0","1","0","1","0","0","0","0","1","1"
"Palmela","38.56902","-8.90126","1","0","0","0","0","0","0","1","0","1","0","0","1","1","0","0","0","1","1","0","0","0","0","1"
"Palmerston North","-40.35636","175.61113","1","0","0","0","0","0","0","1","0","0","0","0","0","1","0","0","0","1","1","0","0","0","0","1"
"Palmetto Bay","25.62177","-80.32477","0","0","0","0","1","0","0","1","0","0","1","0","1","0","0","1","0","1","0","0","1","0","0","1"
"Palo Alto","37.44188","-122.14302","1","0","0","0","0","0","0","1","0","0","0","0","0","1","0","0","0","1","0","0","1","0","0","1"
"Palo Alto","20.16436","-102.92669","1","0","0","0","0","0","0","1","0","0","0","0","0","1","0","0","0","1","0","0","1","0","0","1"
"Palo Alto","21.91801","-101.96453","1","0","0","0","0","0","0","1","0","0","0","0","0","1","0","0","0","1","0","0","1","0","0","1"
"Palo Alto","20.24668","-101.30125","1","0","0","0","0","0","0","1","0","0","0","0","0","1","0","0","0","1","0","0","1","0","0","1"
"Palo Alto","20.86675","-100.39987","1","0","0","0","0","0","0","1","0","0","0","0","0","1","0","0","0","1","0","0","1","0","0","1"
"Palo Alto","20.54065","-100.2213","1","0","0","0","0","0","0","1","0","0","0","0","0","1","0","0","0","1","0","0","1","0","0","1"
"Palo Alto","40.68731","-76.17216","1","0","0","0","0","0","0","1","0","0","0","0","0","1","0","0","0","1","0","0","1","0","0","1"
"Panabo","7.30806","125.68417","1","0","0","0","0","0","0","1","0","1","0","0","1","0","1","0","0","1","0","1","0","0","0","1"
"Panadura","6.7132","79.9026","1","0","0","0","0","0","0","1","0","0","0","0","0","0","0","1","0","1","0","0","0","1","0","1"
"Panama City","30.15946","-85.65983","7","0","0","0","0","0","0","7","1","0","1","1","3","2","3","2","0","7","4","1","1","1","0","7"
"Panama City","9.33404","-79.89172","7","0","0","0","0","0","0","7","1","0","1","1","3","2","3","2","0","7","4","1","1","1","0","7"
"Panauti","27.58466","85.52122","2","0","0","0","0","0","0","2","1","0","0","0","1","1","0","0","0","1","0","0","1","0","0","1"
"Panchkula","30.69461","76.8504","1","0","0","0","0","0","0","1","0","1","0","0","1","0","1","0","0","1","0","0","1","0","0","1"
"Panevėžys","55.73333","24.35","1","0","0","0","0","0","0","1","0","0","0","0","0","0","1","0","0","1","0","0","0","0","1","1"
"Pangbourne","51.4837","-1.08519","1","0","0","0","0","0","0","1","0","0","1","0","1","0","0","1","0","1","0","1","0","0","0","1"
"Panguipulli","-39.64355","-72.33269","0","0","0","0","0","0","0","0","0","1","0","0","1","0","1","0","0","1","0","0","0","0","0","0"
"Pano Aqil","27.85619","69.11111","1","0","0","0","0","0","0","1","1","0","0","0","1","1","0","0","0","1","0","0","1","0","0","1"
"Panvel","18.98878","73.11013","1","0","0","0","0","0","0","1","1","0","0","0","1","1","0","0","0","1","0","0","0","1","0","1"
"Paoy Paet","13.65805","102.56365","1","0","0","0","0","0","0","1","0","1","0","0","1","0","1","0","0","1","0","0","1","0","0","1"
"Papágou","37.98642","23.79347","1","0","0","0","0","0","0","1","0","0","1","0","1","0","0","1","0","1","0","0","1","0","0","1"
"Paphos","34.77679","32.42451","1","0","0","0","0","0","0","1","0","0","0","0","0","0","0","1","0","1","1","0","0","0","0","1"
"Parachinar","33.89968","70.10012","1","0","0","0","0","0","0","1","0","0","0","1","1","0","1","0","0","1","0","0","1","0","0","1"
"Paradise","39.75961","-121.62192","0","1","0","0","0","0","0","1","1","0","0","0","1","0","0","1","0","1","0","1","0","0","0","1"
"Paradise","36.09719","-115.14666","0","1","0","0","0","0","0","1","1","0","0","0","1","0","0","1","0","1","0","1","0","0","0","1"
"Paradise","41.56882","-111.838","0","1","0","0","0","0","0","1","1","0","0","0","1","0","0","1","0","1","0","1","0","0","0","1"
"Paradise","40.00982","-76.12857","0","1","0","0","0","0","0","1","1","0","0","0","1","0","0","1","0","1","0","1","0","0","0","1"
"Paradise","10.65298","-61.36298","0","1","0","0","0","0","0","1","1","0","0","0","1","0","0","1","0","1","0","1","0","0","0","1"
"Paradise","-34.87361","138.66896","0","1","0","0","0","0","0","1","1","0","0","0","1","0","0","1","0","1","0","1","0","0","0","1"
"Parakou","9.33716","2.63031","2","0","0","0","0","0","0","2","0","2","0","0","2","0","2","0","0","2","2","0","0","0","0","2"
"Paramaribo","5.86638","-55.16682","7","0","0","0","0","0","0","7","0","7","0","0","7","2","0","5","0","7","6","0","0","1","0","7"
"Parbhani","19.26855","76.77081","1","0","0","0","0","1","0","2","1","0","1","0","2","0","0","1","1","2","0","0","1","0","0","1"
"Pardubice","50.04075","15.77659","1","0","0","0","0","0","0","1","1","0","0","0","1","0","0","1","0","1","0","0","1","0","0","1"
"Pariang","9.91542","29.98109","1","0","0","0","0","0","0","1","0","0","0","0","0","0","0","0","1","1","0","1","0","0","0","1"
"Paris","42.22715","-111.40104","21","1","1","2","2","0","1","28","6","3","11","0","20","11","1","16","0","28","1","2","21","2","2","28"
"Paris","33.66094","-95.55551","21","1","1","2","2","0","1","28","6","3","11","0","20","11","1","16","0","28","1","2","21","2","2","28"
"Paris","35.29203","-93.72992","21","1","1","2","2","0","1","28","6","3","11","0","20","11","1","16","0","28","1","2","21","2","2","28"
"Paris","39.48087","-92.00128","21","1","1","2","2","0","1","28","6","3","11","0","20","11","1","16","0","28","1","2","21","2","2","28"
"Paris","36.302","-88.32671","21","1","1","2","2","0","1","28","6","3","11","0","20","11","1","16","0","28","1","2","21","2","2","28"
"Paris","39.61115","-87.69614","21","1","1","2","2","0","1","28","6","3","11","0","20","11","1","16","0","28","1","2","21","2","2","28"
"Paris","38.2098","-84.25299","21","1","1","2","2","0","1","28","6","3","11","0","20","11","1","16","0","28","1","2","21","2","2","28"
"Paris","40.40368","-80.51257","21","1","1","2","2","0","1","28","6","3","11","0","20","11","1","16","0","28","1","2","21","2","2","28"
"Paris","43.2","-80.38333","21","1","1","2","2","0","1","28","6","3","11","0","20","11","1","16","0","28","1","2","21","2","2","28"
"Paris","44.25979","-70.50062","21","1","1","2","2","0","1","28","6","3","11","0","20","11","1","16","0","28","1","2","21","2","2","28"
"Paris","48.85341","2.3488","21","1","1","2","2","0","1","28","6","3","11","0","20","11","1","16","0","28","1","2","21","2","2","28"
"Parit Buntar","5.12671","100.49316","2","0","0","0","0","0","0","2","1","1","0","0","2","2","0","0","0","2","1","0","0","0","1","2"
"Parkman","45.13367","-69.4331","1","0","0","0","0","0","0","1","0","0","0","0","0","1","0","0","0","1","1","0","0","0","0","1"
"Parma","43.78516","-116.94321","1","0","0","0","0","0","0","1","0","1","0","0","1","1","0","0","0","1","1","0","0","0","0","1"
"Parma","36.61367","-89.81647","1","0","0","0","0","0","0","1","0","1","0","0","1","1","0","0","0","1","1","0","0","0","0","1"
"Parma","42.25837","-84.59969","1","0","0","0","0","0","0","1","0","1","0","0","1","1","0","0","0","1","1","0","0","0","0","1"
"Parma","41.40477","-81.72291","1","0","0","0","0","0","0","1","0","1","0","0","1","1","0","0","0","1","1","0","0","0","0","1"
"Parma","44.79935","10.32618","1","0","0","0","0","0","0","1","0","1","0","0","1","1","0","0","0","1","1","0","0","0","0","1"
"Parma","66","57.7","1","0","0","0","0","0","0","1","0","1","0","0","1","1","0","0","0","1","1","0","0","0","0","1"
"Parma Heights","41.39005","-81.75958","1","0","0","0","0","0","0","1","0","1","0","0","1","0","0","1","0","1","1","0","0","0","0","1"
"Paro","27.4305","89.41334","1","0","0","0","0","0","0","1","0","0","0","0","0","0","1","0","0","1","1","0","0","0","0","1"
"Pasadena","34.14778","-118.14452","3","0","0","0","0","0","0","3","0","2","0","0","2","1","0","2","0","3","0","1","2","0","0","3"
"Pasadena","29.69106","-95.2091","3","0","0","0","0","0","0","3","0","2","0","0","2","1","0","2","0","3","0","1","2","0","0","3"
"Pasadena","39.10733","-76.57108","3","0","0","0","0","0","0","3","0","2","0","0","2","1","0","2","0","3","0","1","2","0","0","3"
"Pasadena","49.01671","-57.59837","3","0","0","0","0","0","0","3","0","2","0","0","2","1","0","2","0","3","0","1","2","0","0","3"
"Pasadena","-35.00274","138.58862","3","0","0","0","0","0","0","3","0","2","0","0","2","1","0","2","0","3","0","1","2","0","0","3"
"Pasay","14.53748","121.00144","1","0","0","0","0","0","0","1","0","1","0","0","1","1","0","0","0","1","0","0","1","0","0","1"
"Pasay","10.11443","124.89563","1","0","0","0","0","0","0","1","0","1","0","0","1","1","0","0","0","1","0","0","1","0","0","1"
"Pascagoula","30.36576","-88.55613","1","0","0","0","0","0","0","1","0","1","0","0","1","0","1","0","0","1","0","0","1","0","0","1"
"Pasco","46.23958","-119.10057","1","0","0","0","0","0","1","2","1","1","0","0","2","1","0","1","0","2","1","0","1","0","0","2"
"Pasco","-32.74733","-63.34232","1","0","0","0","0","0","1","2","1","1","0","0","2","1","0","1","0","2","1","0","1","0","0","2"
"Pasig City","14.58691","121.0614","1","0","0","1","0","0","1","3","0","2","1","0","3","1","1","1","0","3","0","0","2","0","1","3"
"Paso Robles","35.62664","-120.691","1","0","0","0","0","0","0","1","0","0","0","0","0","1","0","0","0","1","1","0","0","0","0","1"
"Pasrur","32.26286","74.66327","1","0","0","1","0","0","0","2","0","2","0","0","2","1","0","1","0","2","0","0","2","0","0","2"
"Passerano Marmorito","45.05585","8.01873","1","0","0","0","0","0","0","1","0","1","0","0","1","0","0","1","0","1","1","0","0","0","0","1"
"Pātan","23.8507","72.12963","2","0","0","0","0","0","0","2","1","0","0","0","1","2","0","0","0","2","0","0","1","0","1","2"
"Pātan","17.37513","73.90143","2","0","0","0","0","0","0","2","1","0","0","0","1","2","0","0","0","2","0","0","1","0","1","2"
"Pātan","23.28636","79.68962","2","0","0","0","0","0","0","2","1","0","0","0","1","2","0","0","0","2","0","0","1","0","1","2"
"Pātan","21.03333","81.53333","2","0","0","0","0","0","0","2","1","0","0","0","1","2","0","0","0","2","0","0","1","0","1","2"
"Pātan","27.67658","85.31417","2","0","0","0","0","0","0","2","1","0","0","0","1","2","0","0","0","2","0","0","1","0","1","2"
"Pateros","48.05098","-119.9034","2","0","0","0","0","0","0","2","0","2","0","0","2","0","1","0","1","2","0","0","0","0","2","2"
"Pateros","14.5391","121.0726","2","0","0","0","0","0","0","2","0","2","0","0","2","0","1","0","1","2","0","0","0","0","2","2"
"Pathanāmthitta","9.26667","76.78333","2","0","0","0","0","0","0","2","2","0","0","0","2","0","2","0","0","2","0","0","2","0","0","2"
"Pathein","16.77919","94.73212","1","0","0","0","0","0","0","1","1","0","0","0","1","1","0","0","0","1","0","0","1","0","0","1"
"Patiāla","30.33625","76.3922","1","0","0","0","0","0","0","1","0","1","0","0","1","1","0","0","0","1","0","0","0","0","1","1"
"Patna","55.36406","-4.50594","8","0","0","1","0","0","0","9","4","2","0","1","7","0","4","3","2","9","2","0","5","0","2","9"
"Patna","25.59408","85.13563","8","0","0","1","0","0","0","9","4","2","0","1","7","0","4","3","2","9","2","0","5","0","2","9"
"Pattani","6.86814","101.25009","1","0","0","0","0","0","0","1","0","1","0","0","1","0","0","1","0","1","0","0","0","0","1","1"
"Pattoki","31.02021","73.85333","3","0","0","0","0","0","0","3","1","1","1","0","3","3","0","0","0","3","0","0","0","1","2","3"
"Pau","43.31117","-0.35583","0","0","0","0","0","0","1","1","0","1","0","0","1","0","0","1","0","1","1","0","0","0","0","1"
"Pau","42.31607","3.11621","0","0","0","0","0","0","1","1","0","1","0","0","1","0","0","1","0","1","1","0","0","0","0","1"
"Pau","39.79167","8.80222","0","0","0","0","0","0","1","1","0","1","0","0","1","0","0","1","0","1","1","0","0","0","0","1"
"Pau","-8.4402","120.1931","0","0","0","0","0","0","1","1","0","1","0","0","1","0","0","1","0","1","1","0","0","0","0","1"
"Pau","15.0279","120.7243","0","0","0","0","0","0","1","1","0","1","0","0","1","0","0","1","0","1","1","0","0","0","0","1"
"Pau","-8.8555","121.2993","0","0","0","0","0","0","1","1","0","1","0","0","1","0","0","1","0","1","1","0","0","0","0","1"
"Paulerspury","52.10271","-0.95023","1","0","0","0","0","0","0","1","0","0","0","0","0","1","0","0","0","1","0","0","1","0","0","1"
"Paulton","51.30472","-2.50028","1","0","0","0","0","0","0","1","0","0","1","0","1","0","0","1","0","1","0","0","1","0","0","1"
"Pavel Banya","42.6","25.2","1","0","0","0","0","0","0","1","0","0","0","0","0","1","0","0","0","1","1","0","0","0","0","1"
"Pavia","45.19205","9.15917","1","0","0","0","0","0","0","1","0","1","0","0","1","0","1","0","0","1","1","0","0","0","0","1"
"Pavia","10.77611","122.54556","1","0","0","0","0","0","0","1","0","1","0","0","1","0","1","0","0","1","1","0","0","0","0","1"
"Peacehaven","50.7927","-0.00652","4","0","0","0","1","0","0","5","2","1","2","0","5","1","1","3","0","5","1","3","1","0","0","5"
"Peace River","56.23715","-117.29176","0","1","0","0","0","0","0","1","1","0","0","0","1","0","0","1","0","1","0","0","1","0","0","1"
"Peakirk","52.64567","-0.27294","1","0","0","0","0","0","0","1","0","1","0","0","1","1","0","0","0","1","0","0","1","0","0","1"
"Pearland","29.56357","-95.28605","2","0","0","0","0","0","0","2","0","1","0","0","1","2","0","0","0","2","1","0","1","0","0","2"
"Peć","42.65913","20.28828","4","0","0","0","0","0","0","4","1","1","0","2","4","0","2","1","1","4","0","0","3","0","1","4"
"Pécs","46.0725","18.23083","1","0","0","0","0","0","0","1","0","0","0","0","0","1","0","0","0","1","0","0","1","0","0","1"
"Peebles","38.94896","-83.40575","1","0","0","0","0","0","0","1","0","0","0","0","0","1","0","0","0","1","0","0","0","0","1","1"
"Peebles","55.6519","-3.1888","1","0","0","0","0","0","0","1","0","0","0","0","0","1","0","0","0","1","0","0","0","0","1","1"
"Peel","54.22209","-4.69099","1","0","0","0","0","0","0","1","0","1","0","0","1","0","0","1","0","1","1","0","0","0","0","1"
"Pégomas","43.59662","6.93211","1","0","0","0","0","0","0","1","0","0","1","0","1","0","1","0","0","1","0","0","1","0","0","1"
"Pekanbaru","0.51667","101.44167","1","0","0","0","0","0","0","1","0","0","0","0","0","0","1","0","0","1","1","0","0","0","0","1"
"Pelham","33.28567","-86.80999","1","0","0","0","0","0","0","1","0","0","0","0","0","1","0","0","0","1","1","0","0","0","0","1"
"Pelham","31.12802","-84.15304","1","0","0","0","0","0","0","1","0","0","0","0","0","1","0","0","0","1","1","0","0","0","0","1"
"Pelham","40.90982","-73.80791","1","0","0","0","0","0","0","1","0","0","0","0","0","1","0","0","0","1","1","0","0","0","0","1"
"Pelham","42.39315","-72.4037","1","0","0","0","0","0","0","1","0","0","0","0","0","1","0","0","0","1","1","0","0","0","0","1"
"Pelham","42.73453","-71.32451","1","0","0","0","0","0","0","1","0","0","0","0","0","1","0","0","0","1","1","0","0","0","0","1"
"Pembroke","36.77588","-87.35556","93","2","0","5","11","0","1","112","26","10","11","3","50","39","19","52","2","112","40","47","24","0","1","112"
"Pembroke","32.13634","-81.62348","93","2","0","5","11","0","1","112","26","10","11","3","50","39","19","52","2","112","40","47","24","0","1","112"
"Pembroke","37.31957","-80.63895","93","2","0","5","11","0","1","112","26","10","11","3","50","39","19","52","2","112","40","47","24","0","1","112"
"Pembroke","34.68016","-79.19504","93","2","0","5","11","0","1","112","26","10","11","3","50","39","19","52","2","112","40","47","24","0","1","112"
"Pembroke","45.81681","-77.11616","93","2","0","5","11","0","1","112","26","10","11","3","50","39","19","52","2","112","40","47","24","0","1","112"
"Pembroke","43.14675","-71.45757","93","2","0","5","11","0","1","112","26","10","11","3","50","39","19","52","2","112","40","47","24","0","1","112"
"Pembroke","44.95369","-67.16193","93","2","0","5","11","0","1","112","26","10","11","3","50","39","19","52","2","112","40","47","24","0","1","112"
"Pembroke","51.67464","-4.91286","93","2","0","5","11","0","1","112","26","10","11","3","50","39","19","52","2","112","40","47","24","0","1","112"
"Pembroke","35.93056","14.47639","93","2","0","5","11","0","1","112","26","10","11","3","50","39","19","52","2","112","40","47","24","0","1","112"
"Pembroke Dock","51.69161","-4.94036","94","1","0","4","15","0","4","118","33","6","7","2","48","37","22","56","1","116","29","51","32","0","4","116"
"Penarth","51.4386","-3.17342","8","0","0","1","0","0","2","11","3","2","4","0","9","2","1","8","0","11","1","3","7","0","0","11"
"Pendleton","45.67207","-118.7886","1","0","0","0","0","0","0","1","0","0","0","0","0","0","1","0","0","1","0","0","1","0","0","1"
"Pendleton","39.99754","-85.74664","1","0","0","0","0","0","0","1","0","0","0","0","0","0","1","0","0","1","0","0","1","0","0","1"
"Pendleton","34.65177","-82.78375","1","0","0","0","0","0","0","1","0","0","0","0","0","0","1","0","0","1","0","0","1","0","0","1"
"Penicuik","55.83116","-3.22608","1","0","0","0","0","0","0","1","0","1","0","0","1","0","0","1","0","1","0","0","1","0","0","1"
"Penistone","53.52572","-1.63027","1","0","0","0","0","0","0","1","0","1","0","0","1","0","1","0","0","1","0","0","0","0","1","1"
"Penkridge","52.72556","-2.1156","1","0","0","0","0","0","0","1","0","1","0","0","1","0","0","1","0","1","0","0","1","0","0","1"
"Penn Valley","39.196","-121.19107","1","0","0","0","0","0","0","1","0","0","0","1","1","1","0","0","0","1","0","0","1","0","0","1"
"Penrhyndeudraeth","52.93333","-4.06667","1","0","0","0","0","0","0","1","0","0","1","0","1","0","0","1","0","1","0","0","1","0","0","1"
"Penrith","54.66579","-2.75757","8","1","0","0","2","0","0","11","4","3","3","0","10","4","2","5","0","11","3","2","6","0","0","11"
"Penrith","-33.75","150.7","8","1","0","0","2","0","0","11","4","3","3","0","10","4","2","5","0","11","3","2","6","0","0","11"
"Pensford","51.37111","-2.54722","1","0","0","0","0","0","0","1","0","0","0","0","0","0","0","1","0","1","0","0","1","0","0","1"
"Penshurst","51.17267","0.18282","0","0","0","0","0","0","1","1","1","0","0","0","1","0","0","1","0","1","0","0","1","0","0","1"
"Penshurst","-37.87528","142.29071","0","0","0","0","0","0","1","1","1","0","0","0","1","0","0","1","0","1","0","0","1","0","0","1"
"Penshurst","-33.96667","151.08333","0","0","0","0","0","0","1","1","1","0","0","0","1","0","0","1","0","1","0","0","1","0","0","1"
"Pentre","51.65429","-3.49133","2","0","0","0","0","0","0","2","1","0","1","0","2","1","0","1","0","2","0","2","0","0","0","2"
"Penyffordd","53.14829","-3.04584","1","0","0","0","0","0","0","1","0","0","1","0","1","0","0","1","0","1","0","1","0","0","0","1"
"Penysarn","53.38978","-4.31698","1","0","0","0","0","0","0","1","0","1","0","0","1","0","1","0","0","1","0","0","1","0","0","1"
"Penzance","50.11861","-5.53715","3","0","0","0","0","0","1","4","2","0","2","0","4","1","1","2","0","4","0","2","2","0","0","4"
"Perambalur","11.23333","78.88333","1","0","0","0","0","0","0","1","0","0","1","0","1","1","0","0","0","1","0","0","1","0","0","1"
"Pereira","4.81333","-75.69611","2","0","0","0","0","0","0","2","0","0","1","0","1","0","0","2","0","2","0","1","1","0","0","2"
"Perkasie","40.37205","-75.29268","1","0","0","0","0","0","0","1","0","0","1","0","1","0","0","1","0","1","0","0","1","0","0","1"
"Perm","58.01046","56.25017","2","0","0","0","0","0","0","2","2","0","0","0","2","1","1","0","0","2","0","0","2","0","0","2"
"Pernik","42.6","23.03333","3","0","0","0","0","0","0","3","0","1","0","0","1","3","0","0","0","3","1","0","1","0","1","3"
"Perranporth","50.34377","-5.15558","2","0","0","0","0","0","0","2","0","1","0","0","1","1","1","0","0","2","1","1","0","0","0","2"
"Perrysburg","41.557","-83.62716","1","0","0","0","0","0","0","1","1","0","0","0","1","0","0","1","0","1","0","0","1","0","0","1"
"Pershore","52.11163","-2.07586","1","2","0","0","0","0","0","3","0","3","0","0","3","1","0","2","0","3","0","0","3","0","0","3"
"Perth","44.90011","-76.24939","22","1","0","2","4","0","2","31","4","10","11","1","26","7","9","15","1","32","5","8","18","1","0","32"
"Perth","43.01757","-74.19402","22","1","0","2","4","0","2","31","4","10","11","1","26","7","9","15","1","32","5","8","18","1","0","32"
"Perth","56.39522","-3.43139","22","1","0","2","4","0","2","31","4","10","11","1","26","7","9","15","1","32","5","8","18","1","0","32"
"Perth","-31.95224","115.8614","22","1","0","2","4","0","2","31","4","10","11","1","26","7","9","15","1","32","5","8","18","1","0","32"
"Perth","-41.57231","147.17096","22","1","0","2","4","0","2","31","4","10","11","1","26","7","9","15","1","32","5","8","18","1","0","32"
"Perth city centre","-31.95289","115.85152","3","0","0","0","0","0","0","3","1","0","1","0","2","1","0","2","0","3","0","1","2","0","0","3"
"Pescara","42.4584","14.20283","1","0","0","0","0","0","0","1","0","0","0","0","0","1","0","0","0","1","1","0","0","0","0","1"
"Peshawar","34.008","71.57849","49","1","0","0","3","0","0","53","21","11","7","2","41","23","16","13","2","54","9","1","34","3","8","55"
"Peshtera","42.03372","24.29995","1","0","0","0","0","0","0","1","0","1","0","0","1","0","1","0","0","1","0","0","0","1","0","1"
"Petaẖ Tiqwa","32.08707","34.88747","1","0","0","0","1","0","0","2","1","0","0","0","1","2","0","0","0","2","0","0","2","0","0","2"
"Petaling Jaya","3.10726","101.60671","2","0","0","0","0","0","0","2","1","0","1","0","2","1","0","1","0","2","0","0","2","0","0","2"
"Petauke","-14.24117","31.31975","0","0","0","0","0","0","0","0","0","1","0","0","1","0","0","0","0","0","0","0","0","0","1","1"
"Peterborough","44.30012","-78.31623","28","0","0","0","2","0","3","33","5","8","15","0","28","10","2","22","0","34","3","7","22","2","0","34"
"Peterborough","42.87064","-71.95175","28","0","0","0","2","0","3","33","5","8","15","0","28","10","2","22","0","34","3","7","22","2","0","34"
"Peterborough","52.57364","-0.24777","28","0","0","0","2","0","3","33","5","8","15","0","28","10","2","22","0","34","3","7","22","2","0","34"
"Peterborough","-32.97205","138.84073","28","0","0","0","2","0","3","33","5","8","15","0","28","10","2","22","0","34","3","7","22","2","0","34"
"Peterhead","57.50517","-1.78435","1","0","0","0","0","0","0","1","0","0","0","0","0","0","1","0","0","1","1","0","0","0","0","1"
"Peterhead","-34.83118","138.49892","1","0","0","0","0","0","0","1","0","0","0","0","0","0","1","0","0","1","1","0","0","0","0","1"
"Peterlee","54.76032","-1.33649","9","1","0","1","0","0","0","11","1","6","2","0","9","4","2","5","0","11","3","4","4","0","0","11"
"Petersfield","18.26158","-78.07117","5","0","0","0","1","0","0","6","1","0","3","0","4","2","1","3","0","6","1","1","4","0","0","6"
"Petersfield","51.00495","-0.93375","5","0","0","0","1","0","0","6","1","0","3","0","4","2","1","3","0","6","1","1","4","0","0","6"
"Pétionville","18.5125","-72.28528","0","0","0","0","0","0","0","0","0","1","0","0","1","0","1","0","0","1","1","0","0","0","0","1"
"Petit Valley","10.69974","-61.54717","1","0","0","0","0","0","0","1","0","0","0","1","1","0","1","0","0","1","1","0","0","0","0","1"
"Petrich","41.39846","23.20702","1","0","0","0","0","0","0","1","0","0","1","0","1","0","1","0","0","1","0","0","1","0","0","1"
"Petworth","50.98669","-0.61","1","0","0","0","0","0","0","1","0","0","0","0","0","0","0","1","0","1","0","0","1","0","0","1"
"Pevensey","50.81966","0.33963","1","0","0","0","0","0","0","1","0","1","0","0","1","0","0","1","0","1","0","0","1","0","0","1"
"Pewsey","51.33855","-1.76545","1","1","1","0","0","0","1","4","0","0","2","0","2","2","0","2","0","4","1","1","2","0","0","4"
"Pflugerville","30.43937","-97.62","5","0","0","0","0","0","0","5","1","0","0","0","1","1","1","3","0","5","0","2","3","0","0","5"
"Phan Rang-Tháp Chàm","11.56432","108.98858","1","0","0","0","0","0","0","1","0","1","0","0","1","0","0","1","0","1","0","0","0","0","1","1"
"Philadelphia","32.77152","-89.11673","7","0","0","1","0","0","1","9","3","1","4","0","8","1","1","7","0","9","2","3","4","0","0","9"
"Philadelphia","35.67952","-84.40381","7","0","0","1","0","0","1","9","3","1","4","0","8","1","1","7","0","9","2","3","4","0","0","9"
"Philadelphia","44.1545","-75.70882","7","0","0","1","0","0","1","9","3","1","4","0","8","1","1","7","0","9","2","3","4","0","0","9"
"Philadelphia","39.95233","-75.16379","7","0","0","1","0","0","1","9","3","1","4","0","8","1","1","7","0","9","2","3","4","0","0","9"
"Phnom Penh","11.56245","104.91601","7","0","0","0","0","0","0","7","1","3","0","1","5","5","1","1","0","7","1","1","1","0","4","7"
"Phoenix","42.27541","-122.81809","4","0","0","0","1","0","0","5","0","2","2","0","4","3","1","1","0","5","1","2","2","0","0","5"
"Phoenix","33.44838","-112.07404","4","0","0","0","1","0","0","5","0","2","2","0","4","3","1","1","0","5","1","2","2","0","0","5"
"Phoenix","41.61115","-87.63477","4","0","0","0","1","0","0","5","0","2","2","0","4","3","1","1","0","5","1","2","2","0","0","5"
"Phoenix","43.23118","-76.30076","4","0","0","0","1","0","0","5","0","2","2","0","4","3","1","1","0","5","1","2","2","0","0","5"
"Phulbāni","20.48101","84.23063","1","0","0","0","0","0","0","1","0","0","0","0","0","0","0","1","0","1","0","0","0","0","1","1"
"Phuntsholing","26.85164","89.38837","1","0","0","0","0","0","0","1","0","0","0","0","0","0","1","0","0","1","1","0","0","0","0","1"
"Pianiga","45.45708","12.00762","1","0","0","0","0","0","0","1","0","0","0","0","0","0","0","1","0","1","1","0","0","0","0","1"
"Piaseczno","52.0814","21.02397","1","0","0","0","0","0","0","1","0","0","0","0","0","1","0","0","0","1","1","0","0","0","0","1"
"Piatra Neamţ","46.91667","26.33333","1","0","0","0","0","0","0","1","1","0","0","0","1","0","1","0","0","1","0","0","1","0","0","1"
"Pickering","43.90012","-79.13289","1","0","0","0","0","0","0","1","0","0","1","0","1","0","0","1","0","1","0","1","0","0","0","1"
"Pickering","54.25","-0.76667","1","0","0","0","0","0","0","1","0","0","1","0","1","0","0","1","0","1","0","1","0","0","0","1"
"Pico Truncado","-46.7949","-67.95731","1","0","0","0","0","0","0","1","0","1","0","0","1","0","0","1","0","1","0","0","1","0","0","1"
"Picture Butte","49.8833","-112.78516","1","0","0","0","0","0","0","1","0","0","1","0","1","0","0","1","0","1","0","1","0","0","0","1"
"Pierrefitte-sur-Seine","48.96691","2.36104","1","0","0","0","0","0","0","1","0","0","1","0","1","0","0","1","0","1","0","1","0","0","0","1"
"Pietermaritzburg","-29.61679","30.39278","1","0","0","0","0","0","1","2","1","1","0","0","2","0","0","1","1","2","1","0","1","0","0","2"
"Pilar de la Horadada","37.86591","-0.79256","0","0","0","0","0","0","1","1","0","1","0","0","1","0","1","0","0","1","1","0","0","0","0","1"
"Pimonte","40.67361","14.50984","1","0","0","0","0","0","0","1","1","0","0","0","1","0","0","1","0","1","0","0","1","0","0","1"
"Pinar del Río","22.41667","-83.69667","2","0","0","0","0","0","0","2","1","0","0","1","2","1","1","0","0","2","0","0","1","0","1","2"
"Pindamonhangaba","-22.92389","-45.46167","1","0","0","0","0","0","0","1","0","1","0","0","1","0","1","0","0","1","1","0","0","0","0","1"
"Pind Dadan Khan","32.58662","73.04456","1","0","0","0","0","0","0","1","0","1","0","0","1","1","0","0","0","1","1","0","0","0","0","1"
"Pindi Bhattian","31.89844","73.27339","1","0","0","0","0","0","0","1","1","0","0","0","1","0","0","1","0","1","0","0","1","0","0","1"
"Pineville","36.59452","-94.3841","0","0","0","0","0","0","1","1","1","0","0","0","1","1","0","0","0","1","0","1","0","0","0","1"
"Pineville","31.3224","-92.4343","0","0","0","0","0","0","1","1","1","0","0","0","1","1","0","0","0","1","0","1","0","0","0","1"
"Pineville","36.76203","-83.69492","0","0","0","0","0","0","1","1","1","0","0","0","1","1","0","0","0","1","0","1","0","0","0","1"
"Pineville","37.58317","-81.53705","0","0","0","0","0","0","1","1","1","0","0","0","1","1","0","0","0","1","0","1","0","0","0","1"
"Pineville","35.0832","-80.8923","0","0","0","0","0","0","1","1","1","0","0","0","1","1","0","0","0","1","0","1","0","0","0","1"
"Pinner","51.59384","-0.38216","4","0","0","1","0","0","0","5","2","1","1","0","4","3","1","1","0","5","2","0","3","0","0","5"
"Piraeus","37.94203","23.64619","5","0","0","0","0","0","0","5","0","1","0","0","1","3","2","0","0","5","3","0","1","0","1","5"
"Pirna","50.95843","13.93702","1","0","0","0","0","0","0","1","0","1","0","0","1","1","0","0","0","1","1","0","0","0","0","1"
"Pishin","30.58176","66.99406","1","0","0","0","0","0","0","1","1","0","0","1","2","1","0","1","0","2","0","0","2","0","0","2"
"Piteå","65.31717","21.47944","1","0","0","0","0","0","0","1","0","0","0","0","0","1","0","0","0","1","0","0","0","0","1","1"
"Piteşti","44.85","24.86667","1","0","0","0","0","0","0","1","0","1","0","0","1","1","0","0","0","1","1","0","0","0","0","1"
"Pitsea","51.56387","0.50859","1","0","0","0","0","0","0","1","0","0","0","0","0","1","0","0","0","1","0","0","1","0","0","1"
"Pitstone","51.8283","-0.63987","0","1","0","0","0","0","0","1","0","0","1","0","1","0","0","1","0","1","0","1","0","0","0","1"
"Pittsburg","38.02798","-121.88468","1","0","0","0","0","0","0","1","0","1","0","0","1","1","0","0","0","1","1","0","0","0","0","1"
"Pittsburg","32.9954","-94.96577","1","0","0","0","0","0","0","1","0","1","0","0","1","1","0","0","0","1","1","0","0","0","0","1"
"Pittsburg","37.41088","-94.70496","1","0","0","0","0","0","0","1","0","1","0","0","1","1","0","0","0","1","1","0","0","0","0","1"
"Pittsburg","37.77699","-88.84951","1","0","0","0","0","0","0","1","0","1","0","0","1","1","0","0","0","1","1","0","0","0","0","1"
"Pittsburg","45.05116","-71.39147","1","0","0","0","0","0","0","1","0","1","0","0","1","1","0","0","0","1","1","0","0","0","0","1"
"Pittsburgh","40.44062","-79.99589","3","0","0","0","0","0","0","3","1","1","1","0","3","1","0","2","0","3","1","0","2","0","0","3"
"Pittsford","43.09062","-77.515","1","0","0","0","0","0","0","1","1","0","0","0","1","0","0","1","0","1","0","1","0","0","0","1"
"Pittsford","43.70673","-73.02816","1","0","0","0","0","0","0","1","1","0","0","0","1","0","0","1","0","1","0","1","0","0","0","1"
"Plainview","36.14412","-119.134","1","0","0","0","0","0","0","1","0","1","0","0","1","1","0","0","0","1","0","0","1","0","0","1"
"Plainview","34.18479","-101.70684","1","0","0","0","0","0","0","1","0","1","0","0","1","1","0","0","0","1","0","0","1","0","0","1"
"Plainview","42.34973","-97.79201","1","0","0","0","0","0","0","1","0","1","0","0","1","1","0","0","0","1","0","0","1","0","0","1"
"Plainview","34.98954","-93.2974","1","0","0","0","0","0","0","1","0","1","0","0","1","1","0","0","0","1","0","0","1","0","0","1"
"Plainview","44.16497","-92.17156","1","0","0","0","0","0","0","1","0","1","0","0","1","1","0","0","0","1","0","0","1","0","0","1"
"Plainview","36.17731","-83.79534","1","0","0","0","0","0","0","1","0","1","0","0","1","1","0","0","0","1","0","0","1","0","0","1"
"Plainview","40.77649","-73.46735","1","0","0","0","0","0","0","1","0","1","0","0","1","1","0","0","0","1","0","0","1","0","0","1"
"Plano","33.01984","-96.69889","3","0","0","0","0","0","0","3","0","1","1","0","2","2","1","0","0","3","1","0","2","0","0","3"
"Plano","41.66281","-88.53702","3","0","0","0","0","0","0","3","0","1","1","0","2","2","1","0","0","3","1","0","2","0","0","3"
"Plano","36.88032","-86.41832","3","0","0","0","0","0","0","3","0","1","1","0","2","2","1","0","0","3","1","0","2","0","0","3"
"Plano","43.54419","16.27968","3","0","0","0","0","0","0","3","0","1","1","0","2","2","1","0","0","3","1","0","2","0","0","3"
"Plasencia","40.03116","-6.08845","1","0","0","0","0","0","0","1","0","1","0","0","1","0","0","1","0","1","1","0","0","0","0","1"
"Playa Blanca","28.86426","-13.82814","1","0","0","0","0","0","0","1","0","0","0","0","0","1","0","0","0","1","1","0","0","0","0","1"
"Pleven","43.41667","24.61667","2","0","0","1","0","0","0","3","0","1","0","0","1","1","1","1","0","3","1","0","2","0","0","3"
"Ploieşti","44.95","26.01667","1","0","0","0","0","0","0","1","1","0","0","0","1","0","0","1","0","1","0","1","0","0","0","1"
"Plovdiv","42.15","24.75","5","0","0","0","0","0","0","5","0","3","0","0","3","2","2","1","0","5","3","0","1","0","1","5"
"Plunge","55.91139","21.84417","1","0","0","0","0","0","0","1","0","0","0","0","0","1","0","0","0","1","1","0","0","0","0","1"
"Plymouth","38.48185","-120.84466","35","0","0","1","2","0","1","39","8","15","11","1","35","12","5","22","0","39","7","7","22","1","2","39"
"Plymouth","45.01052","-93.45551","35","0","0","1","2","0","1","39","8","15","11","1","35","12","5","22","0","39","7","7","22","1","2","39"
"Plymouth","43.74861","-87.97704","35","0","0","1","2","0","1","39","8","15","11","1","35","12","5","22","0","39","7","7","22","1","2","39"
"Plymouth","41.34366","-86.30973","35","0","0","1","2","0","1","39","8","15","11","1","35","12","5","22","0","39","7","7","22","1","2","39"
"Plymouth","42.37143","-83.47021","35","0","0","1","2","0","1","39","8","15","11","1","35","12","5","22","0","39","7","7","22","1","2","39"
"Plymouth","40.99561","-82.66712","35","0","0","1","2","0","1","39","8","15","11","1","35","12","5","22","0","39","7","7","22","1","2","39"
"Plymouth","35.86683","-76.74856","35","0","0","1","2","0","1","39","8","15","11","1","35","12","5","22","0","39","7","7","22","1","2","39"
"Plymouth","41.24036","-75.94464","35","0","0","1","2","0","1","39","8","15","11","1","35","12","5","22","0","39","7","7","22","1","2","39"
"Plymouth","41.67204","-73.05289","35","0","0","1","2","0","1","39","8","15","11","1","35","12","5","22","0","39","7","7","22","1","2","39"
"Plymouth","43.75702","-71.68813","35","0","0","1","2","0","1","39","8","15","11","1","35","12","5","22","0","39","7","7","22","1","2","39"
"Plymouth","41.95844","-70.66726","35","0","0","1","2","0","1","39","8","15","11","1","35","12","5","22","0","39","7","7","22","1","2","39"
"Plymouth","44.76729","-69.21033","35","0","0","1","2","0","1","39","8","15","11","1","35","12","5","22","0","39","7","7","22","1","2","39"
"Plymouth","16.70555","-62.21292","35","0","0","1","2","0","1","39","8","15","11","1","35","12","5","22","0","39","7","7","22","1","2","39"
"Plymouth","50.37153","-4.14305","35","0","0","1","2","0","1","39","8","15","11","1","35","12","5","22","0","39","7","7","22","1","2","39"
"Plympton","41.95288","-70.81448","2","0","0","0","0","0","1","3","0","0","2","0","2","1","1","1","0","3","1","0","2","0","0","3"
"Plympton","50.39074","-4.06022","2","0","0","0","0","0","1","3","0","0","2","0","2","1","1","1","0","3","1","0","2","0","0","3"
"Plympton","-34.962","138.55496","2","0","0","0","0","0","1","3","0","0","2","0","2","1","1","1","0","3","1","0","2","0","0","3"
"Plymstock","50.35999","-4.09049","2","0","0","0","0","0","0","2","0","2","0","0","2","1","1","0","0","2","1","0","1","0","0","2"
"Pocklington","53.93335","-0.78106","3","0","0","0","0","0","0","3","0","2","1","0","3","0","1","2","0","3","1","0","2","0","0","3"
"Podgorica","42.44111","19.26361","8","0","0","0","0","0","0","8","3","3","0","0","6","2","2","4","0","8","4","1","3","0","0","8"
"Podujeva","42.91056","21.19306","1","0","0","0","0","0","0","1","0","0","0","0","0","0","0","1","0","1","1","0","0","0","0","1"
"Pogradec","40.9025","20.6525","2","0","0","0","0","0","0","2","0","1","0","0","1","1","1","0","0","2","1","0","0","0","1","2"
"Pokhara","28.26689","83.96851","14","0","0","0","1","0","0","15","9","3","1","0","13","2","7","6","0","15","1","1","11","0","2","15"
"Polonnaruwa","7.93965","81.00274","2","0","0","0","0","0","0","2","1","1","0","0","2","1","1","0","0","2","1","0","1","0","0","2"
"Poltava","49.59373","34.54073","2","0","0","0","0","0","0","2","1","1","0","0","2","1","0","1","0","2","1","0","1","0","0","2"
"Pomorie","42.56326","27.62986","1","0","0","0","0","0","0","1","0","0","1","0","1","0","0","1","0","1","0","0","1","0","0","1"
"Ponda","15.40341","74.01519","1","0","0","0","0","0","0","1","0","0","0","0","0","1","0","0","0","1","0","0","1","0","0","1"
"Ponorogo","-7.8685","111.462","1","0","0","0","0","0","0","1","1","0","0","0","1","0","1","0","0","1","0","0","1","0","0","1"
"Pontarddulais","51.71423","-4.03859","0","0","0","0","0","0","1","1","1","0","0","0","1","0","0","1","0","1","0","1","0","0","0","1"
"Pontefract","53.69107","-1.31269","8","0","0","0","0","0","0","8","0","3","3","0","6","2","1","5","0","8","1","1","6","0","0","8"
"Ponteland","55.05024","-1.74532","3","0","0","0","0","0","1","4","1","0","2","0","3","0","0","4","0","4","0","1","3","0","0","4"
"Pontevedra","-34.74785","-58.70072","2","0","0","0","0","0","0","2","0","2","0","0","2","0","0","2","0","2","0","0","0","0","2","2"
"Pontevedra","42.431","-8.64435","2","0","0","0","0","0","0","2","0","2","0","0","2","0","0","2","0","2","0","0","0","0","2","2"
"Pontevedra","11.4812","122.8325","2","0","0","0","0","0","0","2","0","2","0","0","2","0","0","2","0","2","0","0","0","0","2","2"
"Pontevedra","10.3746","122.8682","2","0","0","0","0","0","0","2","0","2","0","0","2","0","0","2","0","2","0","0","0","0","2","2"
"Pontyberem","51.77826","-4.1689","0","0","0","0","1","0","0","1","0","0","1","0","1","0","0","1","0","1","0","0","1","0","0","1"
"Pontyclun","51.52162","-3.39145","6","0","0","0","1","0","0","7","4","1","2","0","7","0","2","5","0","7","0","1","6","0","0","7"
"Pontypool","51.70111","-3.04444","6","0","0","0","1","0","0","7","1","3","3","0","7","1","2","4","0","7","2","2","3","0","0","7"
"Pontypridd","51.6021","-3.34211","11","1","0","0","1","0","1","14","3","5","3","1","12","5","1","8","0","14","3","6","5","0","0","14"
"Poole","50.71429","-1.98458","23","3","0","2","4","0","1","33","2","9","15","2","28","12","6","15","0","33","9","7","15","0","2","33"
"Popayán","2.43823","-76.61316","1","0","0","0","0","0","0","1","0","1","0","0","1","0","0","1","0","1","0","0","0","0","1","1"
"Poprad","49.06144","20.29798","1","0","0","0","0","0","0","1","0","1","0","0","1","0","0","1","0","1","1","0","0","0","0","1"
"Porbandar","21.64219","69.60929","1","0","0","0","0","0","0","1","1","0","0","0","1","0","0","1","0","1","0","0","1","0","0","1"
"Pordenone","45.95689","12.66051","1","0","0","0","0","0","0","1","0","1","0","0","1","0","0","1","0","1","0","0","1","0","0","1"
"Port Alfred","-33.58601","26.88329","0","0","0","0","1","0","0","1","1","0","0","0","1","0","0","1","0","1","0","1","0","0","0","1"
"Portarlington","53.16222","-7.19111","2","0","0","0","0","0","0","2","0","1","0","0","1","2","0","0","0","2","1","0","1","0","0","2"
"Portarlington","-38.11542","144.65559","2","0","0","0","0","0","0","2","0","1","0","0","1","2","0","0","0","2","1","0","1","0","0","2"
"Port-au-Prince","18.54349","-72.33881","10","0","0","0","0","0","0","10","3","3","2","1","9","3","4","2","1","10","4","0","6","0","0","10"
"Port Erin","54.08487","-4.75099","1","0","0","0","0","0","2","3","1","0","0","1","2","2","0","1","0","3","1","0","2","0","0","3"
"Port Glasgow","55.93464","-4.6895","1","0","0","0","0","0","0","1","0","1","0","0","1","0","0","1","0","1","1","0","0","0","0","1"
"Porth","51.61306","-3.40361","9","0","0","1","0","0","1","11","2","4","5","0","11","5","3","3","0","11","0","5","6","0","0","11"
"Port Harcourt","4.77742","7.0134","7","0","0","0","0","0","0","7","4","2","0","0","6","5","2","0","0","7","1","1","3","1","2","8"
"Porthcawl","51.47903","-3.70362","0","0","0","0","0","0","1","1","1","0","0","0","1","0","0","1","0","1","1","0","0","0","0","1"
"Portimão","37.13856","-8.53775","2","0","0","0","0","0","0","2","0","0","2","0","2","0","1","1","0","2","0","2","0","0","0","2"
"Portishead","51.48199","-2.76973","3","0","0","0","0","0","0","3","0","1","2","0","3","1","0","2","0","3","0","0","3","0","0","3"
"Portland","45.52345","-122.67621","8","1","0","0","0","0","0","9","1","5","0","0","6","2","1","6","0","9","3","3","3","0","0","9"
"Portland","47.49832","-97.37037","8","1","0","0","0","0","0","9","1","5","0","0","6","2","1","6","0","9","3","3","3","0","0","9"
"Portland","27.87725","-97.32388","8","1","0","0","0","0","0","9","1","5","0","0","6","2","1","6","0","9","3","3","3","0","0","9"
"Portland","43.76886","-90.85819","8","1","0","0","0","0","0","9","1","5","0","0","6","2","1","6","0","9","3","3","3","0","0","9"
"Portland","36.58171","-86.51638","8","1","0","0","0","0","0","9","1","5","0","0","6","2","1","6","0","9","3","3","3","0","0","9"
"Portland","40.43449","-84.97775","8","1","0","0","0","0","0","9","1","5","0","0","6","2","1","6","0","9","3","3","3","0","0","9"
"Portland","42.8692","-84.90305","8","1","0","0","0","0","0","9","1","5","0","0","6","2","1","6","0","9","3","3","3","0","0","9"
"Portland","42.37978","-79.46755","8","1","0","0","0","0","0","9","1","5","0","0","6","2","1","6","0","9","3","3","3","0","0","9"
"Portland","40.92315","-75.09657","8","1","0","0","0","0","0","9","1","5","0","0","6","2","1","6","0","9","3","3","3","0","0","9"
"Portland","41.57288","-72.64065","8","1","0","0","0","0","0","9","1","5","0","0","6","2","1","6","0","9","3","3","3","0","0","9"
"Portland","43.65737","-70.2589","8","1","0","0","0","0","0","9","1","5","0","0","6","2","1","6","0","9","3","3","3","0","0","9"
"Portland","50.56748","-2.44472","8","1","0","0","0","0","0","9","1","5","0","0","6","2","1","6","0","9","3","3","3","0","0","9"
"Portland","-38.3462","141.60257","8","1","0","0","0","0","0","9","1","5","0","0","6","2","1","6","0","9","3","3","3","0","0","9"
"Portland","-33.35709","149.98148","8","1","0","0","0","0","0","9","1","5","0","0","6","2","1","6","0","9","3","3","3","0","0","9"
"Portlaoise","53.03441","-7.29979","1","0","0","0","0","0","1","2","2","0","0","0","2","1","0","1","0","2","0","1","1","0","0","2"
"Port Louis","-20.16194","57.49889","3","0","0","0","0","0","0","3","3","0","0","0","3","1","1","1","0","3","0","2","1","0","0","3"
"Port Macquarie","-31.43084","152.90894","1","0","0","0","0","0","0","1","0","0","0","0","0","1","0","0","0","1","0","1","0","0","0","1"
"Port Moresby","-9.47723","147.15089","8","0","0","0","0","0","0","8","0","4","2","1","7","6","0","2","0","8","4","0","4","0","0","8"
"Porto","-3.89333","-42.71","5","0","0","0","0","0","0","5","0","2","0","1","3","1","4","0","0","5","4","0","0","0","1","5"
"Porto","41.14961","-8.61099","5","0","0","0","0","0","0","5","0","2","0","1","3","1","4","0","0","5","4","0","0","0","1","5"
"Porto","42.16737","-6.89934","5","0","0","0","0","0","0","5","0","2","0","1","3","1","4","0","0","5","4","0","0","0","1","5"
"Porto","40.84395","14.25724","5","0","0","0","0","0","0","5","0","2","0","1","3","1","4","0","0","5","4","0","0","0","1","5"
"Porto Alegre","-30.03283","-51.23019","2","0","0","0","0","0","0","2","0","0","0","0","0","2","0","0","0","2","2","0","0","0","0","2"
"Port of Spain","10.66668","-61.51889","3","0","0","0","0","0","0","3","2","1","0","0","3","1","1","1","0","3","0","1","1","1","0","3"
"Portola Valley","37.38411","-122.23524","1","0","0","0","0","0","0","1","0","1","0","0","1","0","0","1","0","1","0","1","0","0","0","1"
"Portree","57.41288","-6.19418","1","0","0","0","2","0","0","3","0","1","1","0","2","0","1","2","0","3","1","1","1","0","0","3"
"Portrush","55.19592","-6.6493","2","0","0","0","0","0","0","2","0","1","1","0","2","1","0","1","0","2","0","1","1","0","0","2"
"Port Said","31.26531","32.3019","1","0","0","0","2","0","0","3","1","2","0","0","3","0","0","1","2","3","0","0","3","0","0","3"
"Port Saint John’s","-31.62291","29.54477","1","0","0","0","0","0","0","1","0","1","0","0","1","0","1","0","0","1","0","0","0","0","1","1"
"Port Saint Mary","54.07405","-4.73858","1","0","0","0","1","0","0","2","0","1","1","0","2","2","0","0","0","2","0","0","2","0","0","2"
"Portsmouth","38.73174","-82.99767","56","0","0","1","4","0","3","64","15","23","21","0","59","22","8","34","0","64","9","13","34","4","4","64"
"Portsmouth","36.83543","-76.29827","56","0","0","1","4","0","3","64","15","23","21","0","59","22","8","34","0","64","9","13","34","4","4","64"
"Portsmouth","41.60232","-71.25033","56","0","0","1","4","0","3","64","15","23","21","0","59","22","8","34","0","64","9","13","34","4","4","64"
"Portsmouth","43.07704","-70.75766","56","0","0","1","4","0","3","64","15","23","21","0","59","22","8","34","0","64","9","13","34","4","4","64"
"Portsmouth","15.58333","-61.46667","56","0","0","1","4","0","3","64","15","23","21","0","59","22","8","34","0","64","9","13","34","4","4","64"
"Portsmouth","50.79899","-1.09125","56","0","0","1","4","0","3","64","15","23","21","0","59","22","8","34","0","64","9","13","34","4","4","64"
"Portstewart","55.18132","-6.71402","2","0","0","0","0","0","0","2","0","0","1","0","1","1","0","1","0","2","0","2","0","0","0","2"
"Port Talbot","51.59241","-3.78019","14","0","0","0","0","0","1","15","3","9","3","0","15","5","3","7","0","15","8","2","5","0","0","15"
"Port Washington","43.38722","-87.87564","1","0","0","0","0","0","0","1","0","0","1","0","1","1","0","0","0","1","0","0","1","0","0","1"
"Port Washington","40.32812","-81.52067","1","0","0","0","0","0","0","1","0","0","1","0","1","1","0","0","0","1","0","0","1","0","0","1"
"Port Washington","40.82566","-73.69819","1","0","0","0","0","0","0","1","0","0","1","0","1","1","0","0","0","1","0","0","1","0","0","1"
"Potiskum","11.71391","11.08108","1","0","0","0","0","0","0","1","0","0","1","0","1","1","0","0","0","1","0","0","1","0","0","1"
"Potlogi","44.55","25.58333","1","0","0","0","0","0","0","1","0","0","0","1","1","0","0","1","0","1","1","0","0","0","0","1"
"Potosí","11.49416","-85.8568","1","0","0","0","0","0","0","1","1","0","0","0","1","0","1","0","0","1","1","0","0","0","0","1"
"Potosí","0.80739","-77.57216","1","0","0","0","0","0","0","1","1","0","0","0","1","0","1","0","0","1","1","0","0","0","0","1"
"Potosí","-19.58361","-65.75306","1","0","0","0","0","0","0","1","1","0","0","0","1","0","1","0","0","1","1","0","0","0","0","1"
"Potsdam","44.66978","-74.98131","0","0","0","1","0","0","0","1","0","1","0","0","1","1","0","0","0","1","0","0","1","0","0","1"
"Potsdam","52.39886","13.06566","0","0","0","1","0","0","0","1","0","1","0","0","1","1","0","0","0","1","0","0","1","0","0","1"
"Potters Bar","51.69353","-0.17835","5","0","0","0","0","0","0","5","0","0","2","0","2","2","0","3","0","5","1","1","3","0","0","5"
"Potton","52.12911","-0.21561","1","0","0","1","0","0","0","2","1","0","1","0","2","0","0","2","0","2","0","0","2","0","0","2"
"Poulton-le-Fylde","53.83333","-2.98333","4","0","0","0","0","0","0","4","2","1","0","0","3","2","0","2","0","4","1","0","3","0","0","4"
"Powell River","49.83278","-124.52368","1","0","0","0","0","0","0","1","0","1","0","0","1","0","0","1","0","1","0","1","0","0","0","1"
"Poynton","53.35","-2.11667","2","0","0","0","0","0","0","2","0","1","0","0","1","2","0","0","0","2","0","0","2","0","0","2"
"Poznań","52.40692","16.92993","1","0","0","0","1","0","0","2","0","1","0","0","1","1","0","1","0","2","2","0","1","0","0","3"
"Prague","35.48674","-96.68502","8","0","0","0","0","0","0","8","1","2","2","0","5","2","5","1","0","8","0","0","6","2","0","8"
"Prague","50.08804","14.42076","8","0","0","0","0","0","0","8","1","2","2","0","5","2","5","1","0","8","0","0","6","2","0","8"
"Pratāpgarh","24.03215","74.78162","1","0","0","0","0","0","0","1","1","0","0","0","1","0","1","0","0","1","0","0","0","0","0","0"
"Pratāpgarh","25.89509","81.9424","1","0","0","0","0","0","0","1","1","0","0","0","1","0","1","0","0","1","0","0","0","0","0","0"
"Preesall","53.9182","-2.96633","1","0","0","0","0","0","0","1","0","1","0","0","1","0","1","0","0","1","1","0","0","0","0","1"
"Prenton","53.36762","-3.05479","2","0","0","0","0","0","0","2","0","2","0","0","2","1","0","1","0","2","2","0","0","0","0","2"
"Prescot","53.42948","-2.80031","0","1","0","0","0","0","0","1","1","0","0","0","1","0","0","1","0","1","0","0","1","0","0","1"
"Prescott","34.54002","-112.4685","1","0","0","0","0","0","0","1","0","0","1","0","1","1","0","0","0","1","0","0","1","0","0","1"
"Prescott","33.80261","-93.38101","1","0","0","0","0","0","0","1","0","0","1","0","1","1","0","0","0","1","0","0","1","0","0","1"
"Prescott","44.74886","-92.80215","1","0","0","0","0","0","0","1","0","0","1","0","1","1","0","0","0","1","0","0","1","0","0","1"
"Prescott","44.71681","-75.51604","1","0","0","0","0","0","0","1","0","0","1","0","1","1","0","0","0","1","0","0","1","0","0","1"
"Preševo","42.30917","21.64917","2","0","0","2","0","0","0","4","1","1","2","0","4","1","3","0","0","4","0","1","3","0","0","4"
"Prestatyn","53.33748","-3.40776","1","0","0","0","0","0","0","1","0","1","0","0","1","0","1","0","0","1","1","0","0","0","0","1"
"Prestbury","41.78329","-88.41764","1","0","0","0","0","0","0","1","0","0","0","0","0","0","0","1","0","1","0","0","1","0","0","1"
"Prestbury","53.28333","-2.15","1","0","0","0","0","0","0","1","0","0","0","0","0","0","0","1","0","1","0","0","1","0","0","1"
"Preston","42.09631","-111.87662","50","2","0","1","2","0","0","55","8","12","23","1","44","18","14","21","2","55","14","12","25","0","4","55"
"Preston","33.88232","-96.63305","50","2","0","1","2","0","0","55","8","12","23","1","44","18","14","21","2","55","14","12","25","0","4","55"
"Preston","43.67024","-92.08322","50","2","0","1","2","0","0","55","8","12","23","1","44","18","14","21","2","55","14","12","25","0","4","55"
"Preston","42.0503","-90.41402","50","2","0","1","2","0","0","55","8","12","23","1","44","18","14","21","2","55","14","12","25","0","4","55"
"Preston","32.06599","-84.53742","50","2","0","1","2","0","0","55","8","12","23","1","44","18","14","21","2","55","14","12","25","0","4","55"
"Preston","38.71262","-75.90994","50","2","0","1","2","0","0","55","8","12","23","1","44","18","14","21","2","55","14","12","25","0","4","55"
"Preston","53.76282","-2.70452","50","2","0","1","2","0","0","55","8","12","23","1","44","18","14","21","2","55","14","12","25","0","4","55"
"Preston","52.61264","-0.71437","50","2","0","1","2","0","0","55","8","12","23","1","44","18","14","21","2","55","14","12","25","0","4","55"
"Preston","53.75663","-0.19775","50","2","0","1","2","0","0","55","8","12","23","1","44","18","14","21","2","55","14","12","25","0","4","55"
"Preston","-37.75","145.01667","50","2","0","1","2","0","0","55","8","12","23","1","44","18","14","21","2","55","14","12","25","0","4","55"
"Preston","-27.66037","151.98658","50","2","0","1","2","0","0","55","8","12","23","1","44","18","14","21","2","55","14","12","25","0","4","55"
"Preston Candover","51.17057","-1.13372","1","0","0","0","0","0","0","1","0","0","1","0","1","1","0","0","0","1","0","1","0","0","0","1"
"Prestonpans","55.95939","-2.98038","3","0","0","0","0","0","0","3","0","2","1","0","3","0","0","3","0","3","0","0","3","0","0","3"
"Prestwich","53.53333","-2.28333","1","0","0","0","0","0","0","1","0","0","1","0","1","1","0","0","0","1","0","1","0","0","0","1"
"Prestwick","55.48333","-4.61667","1","0","0","0","1","0","0","2","0","2","0","0","2","0","2","0","0","2","2","0","0","0","0","2"
"Pretoria","-25.74486","28.18783","6","0","0","0","0","0","0","6","0","2","1","0","3","5","1","0","0","6","3","0","2","1","0","6"
"Prey Veng","11.48682","105.32533","1","0","0","0","0","0","0","1","1","0","0","0","1","0","1","0","0","1","0","0","1","0","0","1"
"Priego de Córdoba","37.43807","-4.19523","0","0","0","0","0","0","0","0","0","0","0","0","0","0","0","0","0","0","0","0","0","0","0","0"
"Prilep","42.5075","20.31778","1","1","0","0","0","0","0","2","0","1","0","0","1","0","2","0","0","2","0","0","0","0","2","2"
"Prilep","41.34514","21.55504","1","1","0","0","0","0","0","2","0","1","0","0","1","0","2","0","0","2","0","0","0","0","2","2"
"Princes Risborough","51.72549","-0.83144","4","0","0","0","0","0","1","5","1","1","2","1","5","2","1","2","0","5","1","0","4","0","0","5"
"Princes Town","10.27184","-61.37103","1","0","0","0","0","0","0","1","0","1","0","0","1","0","0","1","0","1","0","0","1","0","0","1"
"Priocca","44.78624","8.06424","1","0","0","0","0","0","0","1","0","1","0","0","1","0","0","1","0","1","1","0","0","0","0","1"
"Prior Lake","44.7133","-93.42273","1","0","0","0","0","0","0","1","1","0","0","0","1","0","0","1","0","1","0","0","1","0","0","1"
"Pristina","42.67272","21.16688","6","4","0","0","0","1","1","12","6","2","2","0","10","5","2","5","0","12","3","1","7","0","0","11"
"Prizren","42.21389","20.73972","1","0","0","0","0","0","0","1","1","0","0","0","1","1","0","0","0","1","0","0","0","0","1","1"
"Providence","41.70632","-111.81717","2","0","0","0","0","0","0","2","0","1","1","0","2","0","1","1","0","2","0","0","2","0","0","2"
"Providence","33.2334","-96.96158","2","0","0","0","0","0","0","2","0","1","1","0","2","0","1","1","0","2","0","0","2","0","0","2"
"Providence","37.39755","-87.76279","2","0","0","0","0","0","0","2","0","1","1","0","2","0","1","1","0","2","0","0","2","0","0","2"
"Providence","38.57451","-85.22107","2","0","0","0","0","0","0","2","0","1","1","0","2","0","1","1","0","2","0","0","2","0","0","2"
"Providence","41.82399","-71.41283","2","0","0","0","0","0","0","2","0","1","1","0","2","0","1","1","0","2","0","0","2","0","0","2"
"Providence","-20.24472","57.61222","2","0","0","0","0","0","0","2","0","1","1","0","2","0","1","1","0","2","0","0","2","0","0","2"
"Providencia","27.51219","-109.9908","2","0","0","0","0","0","0","2","1","0","1","0","2","1","1","0","0","2","0","1","1","0","0","2"
"Providencia","23.16713","-102.01035","2","0","0","0","0","0","0","2","1","0","1","0","2","1","1","0","0","2","0","1","1","0","0","2"
"Providencia","22.35727","-101.83063","2","0","0","0","0","0","0","2","1","0","1","0","2","1","1","0","0","2","0","1","1","0","0","2"
"Providencia","20.35439","-101.01895","2","0","0","0","0","0","0","2","1","0","1","0","2","1","1","0","0","2","0","1","1","0","0","2"
"Providencia","21.42944","-100.765","2","0","0","0","0","0","0","2","1","0","1","0","2","1","1","0","0","2","0","1","1","0","0","2"
"Providencia","-6.2975","-78.24","2","0","0","0","0","0","0","2","1","0","1","0","2","1","1","0","0","2","0","1","1","0","0","2"
"Providencia","1.23907","-77.59721","2","0","0","0","0","0","0","2","1","0","1","0","2","1","1","0","0","2","0","1","1","0","0","2"
"Providencia","1.56976","-77.464","2","0","0","0","0","0","0","2","1","0","1","0","2","1","1","0","0","2","0","1","1","0","0","2"
"Providencia","-33.43107","-70.60454","2","0","0","0","0","0","0","2","1","0","1","0","2","1","1","0","0","2","0","1","1","0","0","2"
"Provins","48.55897","3.29939","1","0","0","0","0","0","0","1","1","0","0","0","1","0","0","1","0","1","0","0","1","0","0","1"
"Prozor","43.82222","17.60917","0","1","0","0","0","0","0","1","1","0","0","0","1","0","0","1","0","1","0","0","1","0","0","1"
"Prudhoe","54.96154","-1.85168","2","0","0","0","2","0","0","4","1","1","1","0","3","0","1","3","0","4","1","0","3","0","0","4"
"Puckeridge","51.89013","0.01309","1","0","0","0","0","0","0","1","0","0","1","0","1","1","0","0","0","1","0","0","1","0","0","1"
"Pudsey","53.79538","-1.66134","0","0","0","0","2","0","1","3","1","0","2","0","3","2","0","1","0","3","0","0","3","0","0","3"
"Puducherry","11.93381","79.82979","2","0","0","0","0","0","1","3","1","1","1","0","3","0","1","2","0","3","0","0","3","0","0","3"
"Puebla","32.56654","-115.3534","2","0","0","0","0","0","0","2","0","0","0","0","0","0","0","2","0","2","1","0","1","0","0","2"
"Puebla","19.03793","-98.20346","2","0","0","0","0","0","0","2","0","0","0","0","0","0","0","2","0","2","1","0","1","0","0","2"
"Puebla","16.91583","-92.50389","2","0","0","0","0","0","0","2","0","0","0","0","0","0","0","2","0","2","1","0","1","0","0","2"
"Puerto La Cruz","10.21382","-64.6328","1","0","0","0","0","0","0","1","0","0","0","0","0","0","1","0","0","1","0","1","0","0","0","1"
"Puerto Plata","19.79344","-70.6884","1","1","0","0","0","0","0","2","0","1","0","0","1","0","2","0","0","2","1","1","0","0","0","2"
"Pulborough","50.95753","-0.5128","5","0","0","0","0","0","2","7","2","2","2","0","6","1","1","5","0","7","1","4","2","0","0","7"
"Pully","46.51027","6.66183","2","0","0","0","0","0","0","2","0","0","2","0","2","0","1","1","0","2","0","1","1","0","0","2"
"Pulwama","33.87405","74.89955","2","0","0","0","0","0","0","2","1","1","0","0","2","1","1","0","0","2","0","0","2","0","0","2"
"Pune","18.51957","73.85535","11","0","0","0","0","0","0","11","4","0","1","1","6","3","2","5","1","11","0","0","9","1","1","11"
"Punta Arenas","-53.15483","-70.91129","1","0","0","0","0","0","0","1","0","2","0","0","2","0","1","1","0","2","2","0","0","0","0","2"
"Puntarenas","9.97625","-84.83836","1","0","0","0","0","0","0","1","0","0","0","0","0","0","0","1","0","1","1","0","0","0","0","1"
"Purley","51.33678","-0.11201","11","0","0","0","3","0","2","16","4","5","5","1","15","4","5","7","0","16","4","6","6","0","0","16"
"Pursat","12.53878","103.9192","1","0","0","0","0","0","0","1","0","1","0","0","1","1","0","0","0","1","0","0","0","0","1","1"
"Puttalam","8.0362","79.8283","2","0","0","0","0","0","0","2","1","0","0","0","1","1","0","0","1","2","1","0","1","0","0","2"
"Pwllheli","52.8899","-4.41451","1","1","0","0","0","0","0","2","1","0","0","0","1","0","0","2","0","2","1","0","1","0","0","2"
"Pyatigorsk","44.04861","43.05944","1","0","0","0","0","0","0","1","1","0","0","0","1","0","1","0","0","1","0","0","1","0","0","1"
"Pyin Oo Lwin","22.03501","96.45683","1","0","0","0","0","0","0","1","0","0","0","0","0","0","0","1","0","1","0","1","0","0","0","1"
"Pyu","18.4813","96.43742","1","0","0","0","0","0","0","1","0","0","1","0","1","0","0","1","0","1","0","0","1","0","0","1"
"Qacha’s Nek","-30.11537","28.68936","1","0","0","0","0","0","0","1","0","0","0","0","0","0","0","0","1","1","0","0","1","0","0","1"
"Qala","36.03611","14.30944","1","0","0","0","0","0","0","1","0","0","1","0","1","0","0","1","0","1","0","0","1","0","0","1"
"Qala","40.44256","50.16759","1","0","0","0","0","0","0","1","0","0","1","0","1","0","0","1","0","1","0","0","1","0","0","1"
"Qalqīlyah","32.18966","34.97063","1","0","0","0","0","0","0","1","0","1","0","0","1","0","1","0","0","1","1","0","0","0","0","1"
"Qalyūb","30.17922","31.2056","2","0","0","0","1","0","1","4","1","1","0","0","2","2","1","1","0","4","1","0","3","0","0","4"
"Qinā","26.16418","32.72671","6","0","0","0","0","0","1","7","5","1","0","0","6","1","3","1","1","6","0","1","5","1","0","7"
"Qom","34.6401","50.8764","1","0","0","0","0","0","0","1","0","0","0","0","0","0","1","0","0","1","1","0","0","0","0","1"
"Qormi","35.87601","14.472","2","0","0","0","0","0","0","2","0","0","2","0","2","0","0","2","0","2","0","0","0","0","2","2"
"Quainton","51.87408","-0.91727","1","0","0","0","0","0","0","1","0","1","0","0","1","0","0","1","0","1","1","0","0","0","0","1"
"Quakers Hill","-33.73333","150.88333","1","0","0","0","0","0","0","1","0","0","0","0","0","1","0","0","0","1","1","0","0","0","0","1"
"Quang Nam","15.88853","108.25447","8","0","0","0","0","0","0","8","0","7","0","1","8","2","5","1","0","8","1","0","0","0","7","8"
"Quarteira","37.06946","-8.10064","1","0","0","0","0","0","0","1","0","0","0","0","0","1","0","0","0","1","1","0","0","0","0","1"
"Quarto","44.99688","9.6635","1","0","0","0","0","0","0","1","1","0","0","0","1","0","0","1","0","1","0","1","0","0","0","1"
"Quarto","40.87822","14.14352","1","0","0","0","0","0","0","1","1","0","0","0","1","0","0","1","0","1","0","1","0","0","0","1"
"Queensferry","55.99089","-3.39847","1","0","0","0","0","0","0","1","0","1","0","0","1","0","0","1","0","1","0","0","1","0","0","1"
"Queensferry","53.2","-3.03333","1","0","0","0","0","0","0","1","0","1","0","0","1","0","0","1","0","1","0","0","1","0","0","1"
"Quelimane","-17.87861","36.88833","2","0","0","0","0","0","0","2","0","0","1","0","1","1","1","0","0","2","1","0","1","0","0","2"
"Quetta","30.18414","67.00141","10","3","0","0","0","0","0","13","7","3","0","0","10","5","2","6","0","13","3","2","3","0","4","12"
"Quezon","9.24111","118.03139","0","1","0","0","0","0","0","1","0","0","0","0","0","0","1","0","0","1","1","0","0","0","0","1"
"Quezon","15.5512","120.8147","0","1","0","0","0","0","0","1","0","0","0","0","0","0","1","0","0","1","1","0","0","0","0","1"
"Quezon","16.5","121.26667","0","1","0","0","0","0","0","1","0","0","0","0","0","0","1","0","0","1","1","0","0","0","0","1"
"Quezon","17.31303","121.60654","0","1","0","0","0","0","0","1","0","0","0","0","0","0","1","0","0","1","1","0","0","0","0","1"
"Quezon","14.0057","122.1838","0","1","0","0","0","0","0","1","0","0","0","0","0","0","1","0","0","1","1","0","0","0","0","1"
"Quezon","10.43617","123.2604","0","1","0","0","0","0","0","1","0","0","0","0","0","0","1","0","0","1","1","0","0","0","0","1"
"Quezon","12.6","123.95","0","1","0","0","0","0","0","1","0","0","0","0","0","0","1","0","0","1","1","0","0","0","0","1"
"Quezon","7.73028","125.09889","0","1","0","0","0","0","0","1","0","0","0","0","0","0","1","0","0","1","1","0","0","0","0","1"
"Quezon City","14.6488","121.0509","6","0","0","0","0","0","0","6","3","0","1","0","4","2","2","1","0","5","1","1","2","1","0","5"
"Quilmes","-34.72904","-58.26374","1","0","0","0","0","0","0","1","0","1","0","0","1","0","0","1","0","1","0","0","1","0","0","1"
"Quincy","39.93682","-120.94647","2","0","0","0","0","0","0","2","1","1","0","0","2","2","0","0","0","2","0","1","1","0","0","2"
"Quincy","47.2343","-119.85255","2","0","0","0","0","0","0","2","1","1","0","0","2","2","0","0","0","2","0","1","1","0","0","2"
"Quincy","39.9356","-91.40987","2","0","0","0","0","0","0","2","1","1","0","0","2","2","0","0","0","2","0","1","1","0","0","2"
"Quincy","41.94421","-84.88385","2","0","0","0","0","0","0","2","1","1","0","0","2","2","0","0","0","2","0","1","1","0","0","2"
"Quincy","30.58714","-84.58325","2","0","0","0","0","0","0","2","1","1","0","0","2","2","0","0","0","2","0","1","1","0","0","2"
"Quincy","40.29922","-83.96883","2","0","0","0","0","0","0","2","1","1","0","0","2","2","0","0","0","2","0","1","1","0","0","2"
"Quincy","42.25288","-71.00227","2","0","0","0","0","0","0","2","1","1","0","0","2","2","0","0","0","2","0","1","1","0","0","2"
"Quincy","47.13276","2.15705","2","0","0","0","0","0","0","2","1","1","0","0","2","2","0","0","0","2","0","1","1","0","0","2"
"Qui Nhon","13.77648","109.22367","1","0","0","0","0","0","0","1","0","0","1","0","1","1","0","0","0","1","0","0","1","0","0","1"
"Quirino","17.15556","120.67","1","0","0","0","0","0","0","1","1","0","0","0","1","0","0","1","0","1","0","0","1","0","0","1"
"Quirino","17.13333","121.7","1","0","0","0","0","0","0","1","1","0","0","0","1","0","0","1","0","1","0","0","1","0","0","1"
"Quito","-0.22985","-78.52495","12","1","0","0","0","0","0","13","7","2","1","0","10","2","1","10","0","13","3","1","10","0","0","14"
"Quţūr","30.97225","30.95614","1","0","0","0","0","0","0","1","0","0","0","0","0","0","0","1","0","1","0","0","1","0","0","1"
"Rabat","34.01325","-6.83255","8","0","0","0","0","0","0","8","3","3","0","0","6","2","1","4","1","8","5","1","2","0","0","8"
"Rabat","35.88152","14.39872","8","0","0","0","0","0","0","8","3","3","0","0","6","2","1","4","1","8","5","1","2","0","0","8"
"Răcari","44.63333","25.73333","1","0","0","0","0","0","0","1","1","0","0","0","1","1","0","0","0","1","0","0","1","0","0","1"
"Râchaïya el Ouadi","33.50089","35.8437","1","0","0","0","0","0","0","1","0","0","0","0","0","0","1","0","0","1","1","0","0","0","0","1"
"Radcliffe","42.31526","-93.43438","3","0","0","0","0","0","0","3","0","2","0","0","2","2","0","1","0","3","0","2","1","0","0","3"
"Radcliffe","53.56178","-2.32455","3","0","0","0","0","0","0","3","0","2","0","0","2","2","0","1","0","3","0","2","1","0","0","3"
"Radès","36.76946","10.27468","1","0","0","0","0","0","0","1","0","0","0","0","0","0","0","1","0","1","0","0","0","1","0","1"
"Radešínská Svratka","49.50845","16.08504","1","0","0","0","0","0","0","1","0","0","1","0","1","1","0","0","0","1","0","0","1","0","0","1"
"Radlett","51.68593","-0.31868","7","0","0","1","2","0","0","10","1","2","1","0","4","7","1","2","0","10","1","1","8","0","0","10"
"Radley","51.68746","-1.24025","1","0","0","0","0","0","0","1","0","0","1","0","1","1","0","0","0","1","0","0","1","0","0","1"
"Radovis","41.63833","22.46472","1","0","0","0","0","0","0","1","0","0","0","1","1","0","0","1","0","1","1","0","0","0","0","1"
"Radstock","51.28862","-2.46003","8","1","0","0","1","0","2","12","4","1","2","0","7","6","1","5","0","12","1","3","8","0","0","12"
"Radzionków","50.40026","18.90232","1","0","0","0","0","0","0","1","0","0","1","0","1","0","0","1","0","1","0","0","1","0","0","1"
"Rafaḩ","31.28204","34.23869","2","0","0","0","0","0","0","2","0","1","0","0","1","2","0","0","0","2","1","0","0","0","1","2"
"Rafaḩ","31.29722","34.24357","2","0","0","0","0","0","0","2","0","1","0","0","1","2","0","0","0","2","1","0","0","0","1","2"
"Rafrāf","37.19043","10.18365","1","0","0","0","0","0","0","1","0","1","0","0","1","1","0","0","0","1","0","0","1","0","0","1"
"Rahat","31.39547","34.75699","1","0","0","0","0","0","0","1","0","0","0","0","0","0","1","0","0","1","1","0","0","0","0","1"
"Rahim Yar Khan","28.41987","70.30345","6","3","0","0","0","0","0","9","2","2","0","3","7","3","2","3","2","10","3","1","4","1","1","10"
"Rainham","51.36323","0.60893","5","0","0","0","0","0","0","5","0","2","3","0","5","0","2","3","0","5","0","3","1","1","0","5"
"Raipur","26.04259","74.02373","3","0","0","0","0","0","0","3","3","0","0","0","3","2","1","0","0","3","0","0","3","0","0","3"
"Raipur","21.23333","81.63333","3","0","0","0","0","0","0","3","3","0","0","0","3","2","1","0","0","3","0","0","3","0","0","3"
"Rajanpur","29.10408","70.32969","2","0","0","0","0","0","0","2","1","1","0","0","2","0","1","1","0","2","0","0","1","0","1","2"
"Rājbirāj","26.53968","86.74796","4","0","0","0","1","0","0","5","2","0","2","0","4","1","4","0","0","5","0","0","5","0","0","5"
"Rajo Khanani","24.98391","68.8537","1","0","0","0","0","0","0","1","0","1","0","0","1","0","1","0","0","1","0","1","0","0","0","1"
"Rājshāhi","24.374","88.60114","5","0","0","0","0","0","0","5","2","1","1","1","5","3","1","0","1","5","0","1","3","0","1","5"
"Rakvere","59.34639","26.35583","1","0","0","0","0","0","0","1","0","0","0","0","0","0","1","0","0","1","0","1","0","0","0","1"
"Raleigh","32.03349","-89.52229","0","0","0","0","1","0","1","2","0","1","0","0","1","2","0","0","0","2","0","0","2","0","0","2"
"Raleigh","35.7721","-78.63861","0","0","0","0","1","0","1","2","0","1","0","0","1","2","0","0","0","2","0","0","2","0","0","2"
"Raleigh","-30.43957","152.97115","0","0","0","0","1","0","1","2","0","1","0","0","1","2","0","0","0","2","0","0","2","0","0","2"
"Ramadi","33.42056","43.30778","1","0","0","0","0","0","0","1","1","0","0","0","1","0","0","0","1","1","0","0","1","0","0","1"
"Ramallah","31.89964","35.20422","6","1","0","0","0","0","0","7","4","1","0","0","5","6","0","1","0","7","2","1","4","0","0","7"
"Rameswaram","9.2885","79.31271","1","0","0","0","0","0","0","1","1","0","0","0","1","1","0","0","0","1","0","0","1","0","0","1"
"Rāmganj","23.1006","90.84989","1","0","0","0","0","0","0","1","0","0","0","1","1","1","0","0","0","1","1","0","0","0","0","1"
"Râmnicu Vâlcea","45.1","24.36667","1","0","0","0","0","0","0","1","0","1","0","0","1","0","1","0","0","1","1","0","0","0","0","1"
"Ramonchamp","47.89429","6.74171","1","0","0","0","0","0","0","1","0","1","0","0","1","1","0","0","0","1","0","1","0","0","0","1"
"Ramsgate","51.33568","1.41797","1","0","0","0","0","0","0","1","0","0","0","0","0","1","0","0","0","1","0","1","0","0","0","1"
"Ramsgate","-33.9822","151.14","1","0","0","0","0","0","0","1","0","0","0","0","0","1","0","0","0","1","0","1","0","0","0","1"
"Rancho Cordova","38.58907","-121.30273","0","0","0","1","0","0","0","1","1","0","0","0","1","0","0","1","0","1","0","1","0","0","0","1"
"Rancho Cucamonga","34.1064","-117.59311","0","1","0","0","0","0","1","2","1","0","1","0","2","0","1","1","0","2","0","0","2","0","0","2"
"Rancho Mirage","33.73974","-116.41279","1","0","0","0","0","0","0","1","0","0","1","0","1","0","1","0","0","1","0","0","1","0","0","1"
"Randburg","-26.0941","28.00123","1","0","0","0","0","0","0","1","0","0","1","0","1","1","0","0","0","1","0","0","1","0","0","1"
"Randfontein","-26.1844","27.70203","1","0","0","0","0","0","0","1","0","0","1","0","1","1","0","0","0","1","0","1","0","0","0","1"
"Randleman","35.81791","-79.80309","1","0","0","0","0","0","0","1","0","1","0","0","1","0","0","1","0","1","1","0","0","0","0","1"
"Randolph","41.66578","-111.18214","1","0","0","0","0","0","0","1","0","0","1","0","1","0","0","1","0","1","0","1","0","0","0","1"
"Randolph","42.37861","-97.357","1","0","0","0","0","0","0","1","0","0","1","0","1","0","0","1","0","1","0","1","0","0","0","1"
"Randolph","43.53915","-89.00678","1","0","0","0","0","0","0","1","0","0","1","0","1","0","0","1","0","1","0","1","0","0","0","1"
"Randolph","42.16201","-78.97532","1","0","0","0","0","0","0","1","0","0","1","0","1","0","0","1","0","1","0","1","0","0","0","1"
"Randolph","40.84829","-74.58148","1","0","0","0","0","0","0","1","0","0","1","0","1","0","0","1","0","1","0","1","0","0","0","1"
"Randolph","43.92507","-72.66594","1","0","0","0","0","0","0","1","0","0","1","0","1","0","0","1","0","1","0","1","0","0","0","1"
"Randolph","42.1626","-71.04116","1","0","0","0","0","0","0","1","0","0","1","0","1","0","0","1","0","1","0","1","0","0","0","1"
"Randolph","44.23035","-69.76671","1","0","0","0","0","0","0","1","0","0","1","0","1","0","0","1","0","1","0","1","0","0","0","1"
"Randwick","-33.91439","151.24895","0","0","0","0","1","0","0","1","0","0","0","0","0","1","0","0","0","1","0","0","1","0","0","1"
"Rangpur","25.74664","89.25166","9","2","0","0","0","0","0","11","4","3","3","0","10","6","2","3","0","11","0","1","6","1","3","11"
"Ranilug","42.49222","21.59889","1","0","0","0","0","0","0","1","0","1","0","0","1","0","0","1","0","1","0","0","1","0","0","1"
"Rapid City","44.08054","-103.23101","0","0","0","0","1","0","0","1","1","0","0","0","1","1","0","0","0","1","0","0","1","0","0","1"
"Rapid City","44.83445","-85.28256","0","0","0","0","1","0","0","1","1","0","0","0","1","1","0","0","0","1","0","0","1","0","0","1"
"Räpina","58.09806","27.46361","1","0","0","0","0","0","0","1","0","1","0","0","1","1","0","0","0","1","1","0","0","0","0","1"
"Rapolano Terme","43.29498","11.60264","1","0","0","0","0","0","0","1","0","0","0","0","0","0","0","1","0","1","1","0","0","0","0","1"
"Ras Al Khaimah City","25.78953","55.9432","1","0","0","0","0","0","0","1","0","0","0","1","1","0","1","0","0","1","0","0","1","0","0","1"
"Ratchathewi","13.759","100.53358","1","0","0","0","0","0","0","1","0","1","0","0","1","1","0","0","0","1","1","0","0","0","0","1"
"Rathmore","52.08333","-9.21667","0","0","0","0","0","0","0","0","0","0","0","0","0","0","0","0","0","0","0","0","0","0","0","0"
"Ravenna","41.02612","-98.91258","1","0","0","0","0","0","0","1","0","0","1","0","1","0","0","1","0","1","0","0","1","0","0","1"
"Ravenna","43.18947","-85.93699","1","0","0","0","0","0","0","1","0","0","1","0","1","0","0","1","0","1","0","0","1","0","0","1"
"Ravenna","37.68453","-83.95298","1","0","0","0","0","0","0","1","0","0","1","0","1","0","0","1","0","1","0","0","1","0","0","1"
"Ravenna","41.15756","-81.24205","1","0","0","0","0","0","0","1","0","0","1","0","1","0","0","1","0","1","0","0","1","0","0","1"
"Ravenna","44.41344","12.20121","1","0","0","0","0","0","0","1","0","0","1","0","1","0","0","1","0","1","0","0","1","0","0","1"
"Rawalpindi","33.59733","73.0479","31","1","0","0","1","0","0","33","12","7","4","1","24","10","11","10","1","32","11","4","15","1","2","33"
"Rawang","3.3213","101.5767","0","1","0","0","0","0","0","1","0","1","0","0","1","0","0","1","0","1","1","0","0","0","0","1"
"Rawtenstall","53.70076","-2.28442","1","0","0","0","0","0","0","1","0","0","0","0","0","1","0","0","0","1","0","0","1","0","0","1"
"Rayleigh","51.58571","0.60459","5","0","0","0","0","0","2","7","0","3","3","0","6","4","0","3","0","7","0","2","5","0","0","7"
"Reading","41.83949","-84.74801","84","1","0","1","7","0","7","100","18","24","43","1","86","24","12","63","1","100","9","20","67","0","4","100"
"Reading","39.22367","-84.44216","84","1","0","1","7","0","7","100","18","24","43","1","86","24","12","63","1","100","9","20","67","0","4","100"
"Reading","40.33565","-75.92687","84","1","0","1","7","0","7","100","18","24","43","1","86","24","12","63","1","100","9","20","67","0","4","100"
"Reading","42.52565","-71.09533","84","1","0","1","7","0","7","100","18","24","43","1","86","24","12","63","1","100","9","20","67","0","4","100"
"Reading","51.45625","-0.97113","84","1","0","1","7","0","7","100","18","24","43","1","86","24","12","63","1","100","9","20","67","0","4","100"
"Rebstein","47.39812","9.58503","1","0","0","0","0","0","0","1","1","0","0","0","1","0","0","1","0","1","0","0","1","0","0","1"
"Recife","-8.05389","-34.88111","2","0","0","1","0","0","0","3","0","2","1","0","3","0","2","1","0","3","2","0","1","0","0","3"
"Redcar","54.61657","-1.05999","3","0","0","0","1","0","1","5","1","1","2","0","4","2","2","1","0","5","2","2","1","0","0","5"
"Red Deer","52.26682","-113.802","0","0","0","0","1","0","0","1","1","0","0","0","1","1","0","0","0","1","0","1","0","0","0","1"
"Redditch","52.3065","-1.94569","8","0","0","1","1","0","0","10","3","4","0","0","7","4","0","6","0","10","0","2","8","0","0","10"
"Redhill","51.24048","-0.17044","7","0","0","0","0","0","2","9","0","4","4","0","8","2","0","7","0","9","1","4","3","1","0","9"
"Redmond","47.67399","-122.12151","2","0","0","0","0","0","0","2","1","0","0","0","1","1","0","1","0","2","0","0","2","0","0","2"
"Redmond","44.27262","-121.17392","2","0","0","0","0","0","0","2","1","0","0","0","1","1","0","1","0","2","0","0","2","0","0","2"
"Redmond","39.00607","-111.86187","2","0","0","0","0","0","0","2","1","0","0","0","1","1","0","1","0","2","0","0","2","0","0","2"
"Redondo Beach","33.84918","-118.38841","0","0","0","0","1","0","0","1","0","1","0","0","1","1","0","0","0","1","1","0","0","0","0","1"
"Redruth","50.23315","-5.22434","2","0","0","0","0","0","1","3","1","0","2","0","3","1","0","2","0","3","1","1","1","0","0","3"
"Reggio Calabria","38.11047","15.66129","1","0","0","0","0","0","0","1","0","0","0","0","0","0","1","0","0","1","0","0","0","0","1","1"
"Reggio nell'Emilia","44.69825","10.63125","0","1","0","0","0","0","0","1","1","0","0","0","1","1","0","0","0","1","0","0","1","0","0","1"
"Reghin","46.7742","24.70216","1","0","0","0","0","0","0","1","0","0","1","0","1","1","0","0","0","1","0","0","1","0","0","1"
"Regina","50.45008","-104.6178","1","0","0","0","0","0","0","1","0","0","1","0","1","1","0","0","0","1","1","0","0","0","0","1"
"Reigate","51.23736","-0.20582","10","0","0","0","0","0","0","10","3","3","3","0","9","4","2","4","0","10","0","3","7","0","0","10"
"Renfrew","45.46681","-76.68272","2","0","0","0","0","0","1","3","2","0","1","0","3","2","1","0","0","3","0","1","2","0","0","3"
"Renfrew","55.87197","-4.39253","2","0","0","0","0","0","1","3","2","0","1","0","3","2","1","0","0","3","0","1","2","0","0","3"
"Repentigny","45.74222","-73.45008","1","0","0","0","0","0","0","1","0","0","0","0","0","0","0","1","0","1","0","0","1","0","0","1"
"Resen","41.08934","21.01092","1","0","0","0","0","0","0","1","1","0","0","0","1","0","0","1","0","1","0","0","1","0","0","1"
"Retford","53.32213","-0.94315","5","0","0","0","0","0","0","5","0","1","4","0","5","5","0","0","0","5","1","2","2","0","0","5"
"Reus","41.15612","1.10687","1","0","0","0","0","0","0","1","0","1","0","0","1","0","0","1","0","1","1","0","0","0","0","1"
"Reykjavík","64.13548","-21.89541","0","1","0","0","0","0","0","1","0","0","0","0","0","0","1","0","0","1","0","1","0","0","0","1"
"Reynoldsburg","39.95479","-82.81212","1","0","0","0","0","0","0","1","0","1","0","0","1","1","0","0","0","1","1","0","0","0","0","1"
"Rhayader","52.30154","-3.51146","3","0","0","0","0","0","0","3","2","0","1","0","3","0","1","1","1","3","0","1","1","0","1","3"
"Rheinau","48.66602","7.93659","1","0","0","0","0","0","0","1","0","0","1","0","1","0","0","1","0","1","0","0","1","0","0","1"
"Rheinau","48.87173","8.19133","1","0","0","0","0","0","0","1","0","0","1","0","1","0","0","1","0","1","0","0","1","0","0","1"
"Rhondda","51.65896","-3.44885","26","1","0","2","3","0","1","33","12","9","11","0","32","5","7","21","0","33","7","7","18","1","0","33"
"Rhymney","51.75998","-3.28553","5","0","0","0","0","0","0","5","0","4","1","0","5","3","2","0","0","5","4","1","0","0","0","5"
"Ribaute-les-Tavernes","44.03724","4.08046","1","0","0","0","0","0","0","1","0","0","1","0","1","1","0","0","0","1","0","1","0","0","0","1"
"Ribeira Grande","38.51667","-28.7","1","0","0","0","0","0","0","1","0","1","0","0","1","0","0","1","0","1","1","0","0","0","0","1"
"Ribeira Grande","37.82175","-25.52141","1","0","0","0","0","0","0","1","0","1","0","0","1","0","0","1","0","1","1","0","0","0","0","1"
"Ribeira Grande","17.1825","-25.065","1","0","0","0","0","0","0","1","0","1","0","0","1","0","0","1","0","1","1","0","0","0","0","1"
"Richards Bay","-28.78301","32.03768","1","0","0","0","0","0","0","1","0","0","0","0","0","1","0","0","0","1","1","0","0","0","0","1"
"Richmond","49.17003","-123.13683","27","1","0","8","1","0","4","41","12","10","7","0","29","18","6","17","0","41","3","8","28","1","1","41"
"Richmond","37.93576","-122.34775","27","1","0","8","1","0","4","41","12","10","7","0","29","18","6","17","0","41","3","8","28","1","1","41"
"Richmond","41.92271","-111.81356","27","1","0","8","1","0","4","41","12","10","7","0","29","18","6","17","0","41","3","8","28","1","1","41"
"Richmond","29.58218","-95.76078","27","1","0","8","1","0","4","41","12","10","7","0","29","18","6","17","0","41","3","8","28","1","1","41"
"Richmond","45.45413","-94.51833","27","1","0","8","1","0","4","41","12","10","7","0","29","18","6","17","0","41","3","8","28","1","1","41"
"Richmond","39.27862","-93.97689","27","1","0","8","1","0","4","41","12","10","7","0","29","18","6","17","0","41","3","8","28","1","1","41"
"Richmond","32.38792","-91.18205","27","1","0","8","1","0","4","41","12","10","7","0","29","18","6","17","0","41","3","8","28","1","1","41"
"Richmond","40.36087","-89.36898","27","1","0","8","1","0","4","41","12","10","7","0","29","18","6","17","0","41","3","8","28","1","1","41"
"Richmond","42.71473","-88.74927","27","1","0","8","1","0","4","41","12","10","7","0","29","18","6","17","0","41","3","8","28","1","1","41"
"Richmond","42.47585","-88.30593","27","1","0","8","1","0","4","41","12","10","7","0","29","18","6","17","0","41","3","8","28","1","1","41"
"Richmond","39.82894","-84.89024","27","1","0","8","1","0","4","41","12","10","7","0","29","18","6","17","0","41","3","8","28","1","1","41"
"Richmond","37.74786","-84.29465","27","1","0","8","1","0","4","41","12","10","7","0","29","18","6","17","0","41","3","8","28","1","1","41"
"Richmond","42.8092","-82.75576","27","1","0","8","1","0","4","41","12","10","7","0","29","18","6","17","0","41","3","8","28","1","1","41"
"Richmond","37.55376","-77.46026","27","1","0","8","1","0","4","41","12","10","7","0","29","18","6","17","0","41","3","8","28","1","1","41"
"Richmond","18.25478","-76.88799","27","1","0","8","1","0","4","41","12","10","7","0","29","18","6","17","0","41","3","8","28","1","1","41"
"Richmond","45.1834","-75.83266","27","1","0","8","1","0","4","41","12","10","7","0","29","18","6","17","0","41","3","8","28","1","1","41"
"Richmond","42.37314","-73.36761","27","1","0","8","1","0","4","41","12","10","7","0","29","18","6","17","0","41","3","8","28","1","1","41"
"Richmond","44.40533","-72.9929","27","1","0","8","1","0","4","41","12","10","7","0","29","18","6","17","0","41","3","8","28","1","1","41"
"Richmond","42.75481","-72.27175","27","1","0","8","1","0","4","41","12","10","7","0","29","18","6","17","0","41","3","8","28","1","1","41"
"Richmond","45.66677","-72.1491","27","1","0","8","1","0","4","41","12","10","7","0","29","18","6","17","0","41","3","8","28","1","1","41"
"Richmond","44.0873","-69.79893","27","1","0","8","1","0","4","41","12","10","7","0","29","18","6","17","0","41","3","8","28","1","1","41"
"Richmond","54.4036","-1.73434","27","1","0","8","1","0","4","41","12","10","7","0","29","18","6","17","0","41","3","8","28","1","1","41"
"Richmond","51.46171","-0.30633","27","1","0","8","1","0","4","41","12","10","7","0","29","18","6","17","0","41","3","8","28","1","1","41"
"Richmond","-29.87196","30.27235","27","1","0","8","1","0","4","41","12","10","7","0","29","18","6","17","0","41","3","8","28","1","1","41"
"Richmond","-34.94199","138.56322","27","1","0","8","1","0","4","41","12","10","7","0","29","18","6","17","0","41","3","8","28","1","1","41"
"Richmond","-20.73243","143.14355","27","1","0","8","1","0","4","41","12","10","7","0","29","18","6","17","0","41","3","8","28","1","1","41"
"Richmond","-37.81819","145.00176","27","1","0","8","1","0","4","41","12","10","7","0","29","18","6","17","0","41","3","8","28","1","1","41"
"Richmond","-42.73554","147.43833","27","1","0","8","1","0","4","41","12","10","7","0","29","18","6","17","0","41","3","8","28","1","1","41"
"Richmond","-33.59956","150.75142","27","1","0","8","1","0","4","41","12","10","7","0","29","18","6","17","0","41","3","8","28","1","1","41"
"Richmond","-41.33333","173.18333","27","1","0","8","1","0","4","41","12","10","7","0","29","18","6","17","0","41","3","8","28","1","1","41"
"Richmond Hill","31.93827","-81.30344","1","0","0","0","0","0","0","1","1","0","0","0","1","1","0","0","0","1","0","1","0","0","0","1"
"Richmond Hill","43.87111","-79.43725","1","0","0","0","0","0","0","1","1","0","0","0","1","1","0","0","0","1","0","1","0","0","0","1"
"Richmond Hill","40.69983","-73.83125","1","0","0","0","0","0","0","1","1","0","0","0","1","1","0","0","0","1","0","1","0","0","0","1"
"Rickmansworth","51.63898","-0.47718","11","0","0","1","2","0","2","16","7","2","3","0","12","5","1","10","0","16","2","3","11","0","0","16"
"Riga","56.946","24.10589","8","0","0","0","0","0","0","8","0","1","2","0","3","3","1","4","0","8","3","0","5","0","0","8"
"Rijeka","45.32673","14.44241","1","0","0","0","0","0","0","1","0","0","0","0","0","1","0","0","0","1","0","0","1","0","0","1"
"Rimini","44.05755","12.56528","1","0","0","0","0","0","0","1","0","0","0","0","0","0","0","1","0","1","1","0","0","0","0","1"
"Ringwood","36.37948","-98.24535","3","0","0","0","0","0","0","3","1","1","1","0","3","0","1","2","0","3","1","2","0","0","0","3"
"Ringwood","42.39224","-88.29703","3","0","0","0","0","0","0","3","1","1","1","0","3","0","1","2","0","3","1","2","0","0","0","3"
"Ringwood","41.11343","-74.24543","3","0","0","0","0","0","0","3","1","1","1","0","3","0","1","2","0","3","1","2","0","0","0","3"
"Ringwood","50.84541","-1.78871","3","0","0","0","0","0","0","3","1","1","1","0","3","0","1","2","0","3","1","2","0","0","0","3"
"Ringwood","-37.81667","145.23333","3","0","0","0","0","0","0","3","1","1","1","0","3","0","1","2","0","3","1","2","0","0","0","3"
"Riobamba","-1.67098","-78.64712","1","0","0","0","0","0","0","1","0","0","0","0","0","0","0","1","0","1","0","1","0","0","0","1"
"Río Ceballos","-31.16486","-64.32241","1","0","0","0","0","0","0","1","0","0","0","0","0","0","0","1","0","1","0","0","1","0","0","1"
"Rio de Janeiro","-22.90642","-43.18223","4","0","0","0","0","0","1","5","3","0","0","0","3","0","2","3","0","5","1","0","4","0","0","5"
"Riohacha","11.54444","-72.90722","1","0","0","0","0","0","0","1","1","0","0","0","1","0","1","0","0","1","0","1","0","0","0","1"
"Rio Rancho","35.23338","-106.66447","1","0","0","0","0","0","0","1","0","1","0","0","1","0","0","1","0","1","0","0","1","0","0","1"
"Rio Tinto","-6.80306","-35.08056","1","0","0","0","0","0","0","1","0","0","1","0","1","1","0","0","0","1","0","0","1","0","0","1"
"Rio Tinto","41.17872","-8.55953","1","0","0","0","0","0","0","1","0","0","1","0","1","1","0","0","0","1","0","0","1","0","0","1"
"Rio Vista","38.16389","-121.69583","1","0","0","0","0","0","0","1","0","0","0","0","0","1","0","0","0","1","0","0","0","0","1","1"
"Rio Vista","32.23348","-97.37446","1","0","0","0","0","0","0","1","0","0","0","0","0","1","0","0","0","1","0","0","0","0","1","1"
"Ripley","33.5253","-114.65607","2","0","0","0","0","0","0","2","0","0","1","0","1","1","0","1","0","2","0","1","1","0","0","2"
"Ripley","35.74536","-89.5298","2","0","0","0","0","0","0","2","0","0","1","0","1","1","0","1","0","2","0","1","1","0","0","2"
"Ripley","34.72982","-88.95062","2","0","0","0","0","0","0","2","0","0","1","0","1","1","0","1","0","2","0","1","1","0","0","2"
"Ripley","38.74563","-83.84492","2","0","0","0","0","0","0","2","0","0","1","0","1","1","0","1","0","2","0","1","1","0","0","2"
"Ripley","38.8187","-81.71069","2","0","0","0","0","0","0","2","0","0","1","0","1","1","0","1","0","2","0","1","1","0","0","2"
"Ripley","42.267","-79.7106","2","0","0","0","0","0","0","2","0","0","1","0","1","1","0","1","0","2","0","1","1","0","0","2"
"Ripley","53.03333","-1.4","2","0","0","0","0","0","0","2","0","0","1","0","1","1","0","1","0","2","0","1","1","0","0","2"
"Ripley","51.29907","-0.49164","2","0","0","0","0","0","0","2","0","0","1","0","1","1","0","1","0","2","0","1","1","0","0","2"
"Ripley","-27.71667","152.83333","2","0","0","0","0","0","0","2","0","0","1","0","1","1","0","1","0","2","0","1","1","0","0","2"
"Ripon","37.74159","-121.12438","6","0","0","1","0","0","0","7","2","2","3","0","7","2","2","3","0","7","2","0","5","0","0","7"
"Ripon","43.8422","-88.83594","6","0","0","1","0","0","0","7","2","2","3","0","7","2","2","3","0","7","2","0","5","0","0","7"
"Ripon","54.13579","-1.52826","6","0","0","1","0","0","0","7","2","2","3","0","7","2","2","3","0","7","2","0","5","0","0","7"
"Ripponden","53.67449","-1.94183","2","0","0","0","0","0","0","2","0","1","1","0","2","1","0","1","0","2","1","0","1","0","0","2"
"Risca","51.60799","-3.10081","2","0","0","0","0","0","0","2","0","2","0","0","2","1","0","1","0","2","1","0","0","0","1","2"
"Rishīkesh","30.10778","78.29255","1","0","0","0","0","0","0","1","1","0","0","0","1","0","0","1","0","1","0","1","0","0","0","1"
"Rishon LeẔiyyon","31.97102","34.78939","1","0","0","0","0","0","0","1","0","1","0","0","1","0","1","0","0","1","1","0","0","0","0","1"
"Rivas","11.43716","-85.82632","1","0","0","0","0","0","0","1","0","1","0","0","1","1","0","0","0","1","0","0","1","0","0","1"
"Riverdale","36.43106","-119.85958","1","0","0","0","1","0","0","2","0","2","0","0","2","1","0","1","0","2","0","1","1","0","0","2"
"Riverdale","41.17689","-112.00383","1","0","0","0","1","0","0","2","0","2","0","0","2","1","0","1","0","2","0","1","1","0","0","2"
"Riverdale","41.63337","-87.6331","1","0","0","0","1","0","0","2","0","2","0","0","2","1","0","1","0","2","0","1","1","0","0","2"
"Riverdale","33.57261","-84.41326","1","0","0","0","1","0","0","2","0","2","0","0","2","1","0","1","0","2","0","1","1","0","0","2"
"Riverdale","36.68736","-78.90001","1","0","0","0","1","0","0","2","0","2","0","0","2","1","0","1","0","2","0","1","1","0","0","2"
"Riverdale","40.99399","-74.30348","1","0","0","0","1","0","0","2","0","2","0","0","2","1","0","1","0","2","0","1","1","0","0","2"
"Riverdale","40.90056","-73.90639","1","0","0","0","1","0","0","2","0","2","0","0","2","1","0","1","0","2","0","1","1","0","0","2"
"Riverside","33.95335","-117.39616","2","0","0","0","0","0","0","2","1","1","0","0","2","0","1","1","0","2","2","0","0","0","0","2"
"Riverside","43.19686","-112.43526","2","0","0","0","0","0","0","2","1","1","0","0","2","0","1","1","0","2","2","0","0","0","0","2"
"Riverside","41.78882","-112.14884","2","0","0","0","0","0","0","2","1","1","0","0","2","0","1","1","0","2","2","0","0","0","0","2"
"Riverside","30.85297","-95.40355","2","0","0","0","0","0","0","2","1","1","0","0","2","0","1","1","0","2","2","0","0","0","0","2"
"Riverside","39.1775","-94.61301","2","0","0","0","0","0","0","2","1","1","0","0","2","0","1","1","0","2","2","0","0","0","0","2"
"Riverside","41.47974","-91.58128","2","0","0","0","0","0","0","2","1","1","0","0","2","0","1","1","0","2","2","0","0","0","0","2"
"Riverside","38.28672","-90.38012","2","0","0","0","0","0","0","2","1","1","0","0","2","0","1","1","0","2","2","0","0","0","0","2"
"Riverside","41.83503","-87.82284","2","0","0","0","0","0","0","2","1","1","0","0","2","0","1","1","0","2","2","0","0","0","0","2"
"Riverside","33.60621","-86.20442","2","0","0","0","0","0","0","2","1","1","0","0","2","0","1","1","0","2","2","0","0","0","0","2"
"Riverside","39.77978","-84.1241","2","0","0","0","0","0","0","2","1","1","0","0","2","0","1","1","0","2","2","0","0","0","0","2"
"Riverside","39.17344","-76.88525","2","0","0","0","0","0","0","2","1","1","0","0","2","0","1","1","0","2","2","0","0","0","0","2"
"Riverside","40.95536","-76.62885","2","0","0","0","0","0","0","2","1","1","0","0","2","0","1","1","0","2","2","0","0","0","0","2"
"Riverside","39.47372","-76.24134","2","0","0","0","0","0","0","2","1","1","0","0","2","0","1","1","0","2","2","0","0","0","0","2"
"Riverside","41.03371","-73.57818","2","0","0","0","0","0","0","2","1","1","0","0","2","0","1","1","0","2","2","0","0","0","0","2"
"Riverside","40.88121","-72.67787","2","0","0","0","0","0","0","2","1","1","0","0","2","0","1","1","0","2","2","0","0","0","0","2"
"Riverside","-41.42105","147.05086","2","0","0","0","0","0","0","2","1","1","0","0","2","0","1","1","0","2","2","0","0","0","0","2"
"Rivière du Rempart","-20.10306","57.68472","1","0","0","0","0","0","0","1","0","1","0","0","1","1","0","0","0","1","0","1","0","0","0","1"
"Rivne","50.62308","26.22743","1","0","0","0","0","0","0","1","1","0","0","0","1","0","0","1","0","1","0","1","0","0","0","1"
"Rivne","46.01753","29.1398","1","0","0","0","0","0","0","1","1","0","0","0","1","0","0","1","0","1","0","1","0","0","0","1"
"Rivne","48.24742","31.75432","1","0","0","0","0","0","0","1","1","0","0","0","1","0","0","1","0","1","0","1","0","0","0","1"
"Riyadh","24.68773","46.72185","34","2","0","0","2","0","1","39","10","7","0","3","20","14","11","13","1","39","18","2","12","3","4","39"
"Rizal","12.46667","120.96667","2","0","0","0","0","0","1","3","0","1","2","0","3","1","2","0","0","3","0","2","0","0","1","3"
"Rizal","15.7118","121.1061","2","0","0","0","0","0","1","3","0","1","2","0","3","1","2","0","0","3","0","2","0","0","1","3"
"Rizal","13.8765","121.159","2","0","0","0","0","0","1","3","0","1","2","0","3","1","2","0","0","3","0","2","0","0","1","3"
"Rizal","17.8486","121.3466","2","0","0","0","0","0","1","3","0","1","2","0","3","1","2","0","0","3","0","2","0","0","1","3"
"Rizal","14.10944","121.3936","2","0","0","0","0","0","1","3","0","1","2","0","3","1","2","0","0","3","0","2","0","0","1","3"
"Rizal","16.71861","121.55528","2","0","0","0","0","0","1","3","0","1","2","0","3","1","2","0","0","3","0","2","0","0","1","3"
"Rizal","13.95","122.28333","2","0","0","0","0","0","1","3","0","1","2","0","3","1","2","0","0","3","0","2","0","0","1","3"
"Rizal","10.68333","122.63333","2","0","0","0","0","0","1","3","0","1","2","0","3","1","2","0","0","3","0","2","0","0","1","3"
"Rizal","11.4454","122.8607","2","0","0","0","0","0","1","3","0","1","2","0","3","1","2","0","0","3","0","2","0","0","1","3"
"Rizal","10.8807","123.4178","2","0","0","0","0","0","1","3","0","1","2","0","3","1","2","0","0","3","0","2","0","0","1","3"
"Rizal","12.97722","123.91417","2","0","0","0","0","0","1","3","0","1","2","0","3","1","2","0","0","3","0","2","0","0","1","3"
"Rizal","12.8864","124.1343","2","0","0","0","0","0","1","3","0","1","2","0","3","1","2","0","0","3","0","2","0","0","1","3"
"Rizal","11.17639","124.57944","2","0","0","0","0","0","1","3","0","1","2","0","3","1","2","0","0","3","0","2","0","0","1","3"
"Rizal","8.92917","125.39861","2","0","0","0","0","0","1","3","0","1","2","0","3","1","2","0","0","3","0","2","0","0","1","3"
"Rizal","9.7804","125.4643","2","0","0","0","0","0","1","3","0","1","2","0","3","1","2","0","0","3","0","2","0","0","1","3"
"Robbinsville","35.32287","-83.8074","1","0","0","0","0","0","0","1","1","0","0","0","1","0","0","1","0","1","0","0","1","0","0","1"
"Robbinsville","40.21455","-74.61932","1","0","0","0","0","0","0","1","1","0","0","0","1","0","0","1","0","1","0","0","1","0","0","1"
"Robertsonpet","12.95629","78.27539","1","0","0","0","0","0","0","1","0","1","0","0","1","1","0","0","0","1","0","0","0","0","1","1"
"Rochdale","53.61766","-2.1552","11","0","0","0","2","0","3","16","2","5","6","0","13","10","2","4","0","16","4","1","10","1","0","16"
"Rochester","46.82177","-123.09625","5","1","0","0","1","0","0","7","1","4","0","0","5","2","2","3","0","7","1","3","3","0","0","7"
"Rochester","44.02163","-92.4699","5","1","0","0","1","0","0","7","1","4","0","0","5","2","2","3","0","7","1","3","3","0","0","7"
"Rochester","39.74949","-89.53176","5","1","0","0","1","0","0","7","1","4","0","0","5","2","2","3","0","7","1","3","3","0","0","7"
"Rochester","42.74141","-88.22426","5","1","0","0","1","0","0","7","1","4","0","0","5","2","2","3","0","7","1","3","3","0","0","7"
"Rochester","41.06476","-86.21583","5","1","0","0","1","0","0","7","1","4","0","0","5","2","2","3","0","7","1","3","3","0","0","7"
"Rochester","42.68059","-83.13382","5","1","0","0","1","0","0","7","1","4","0","0","5","2","2","3","0","7","1","3","3","0","0","7"
"Rochester","40.70229","-80.28645","5","1","0","0","1","0","0","7","1","4","0","0","5","2","2","3","0","7","1","3","3","0","0","7"
"Rochester","43.15478","-77.61556","5","1","0","0","1","0","0","7","1","4","0","0","5","2","2","3","0","7","1","3","3","0","0","7"
"Rochester","43.30453","-70.97562","5","1","0","0","1","0","0","7","1","4","0","0","5","2","2","3","0","7","1","3","3","0","0","7"
"Rochester","41.73177","-70.82004","5","1","0","0","1","0","0","7","1","4","0","0","5","2","2","3","0","7","1","3","3","0","0","7"
"Rochester","55.2752","-2.2649","5","1","0","0","1","0","0","7","1","4","0","0","5","2","2","3","0","7","1","3","3","0","0","7"
"Rochester","51.38764","0.50546","5","1","0","0","1","0","0","7","1","4","0","0","5","2","2","3","0","7","1","3","3","0","0","7"
"Rochester","-36.36352","144.70077","5","1","0","0","1","0","0","7","1","4","0","0","5","2","2","3","0","7","1","3","3","0","0","7"
"Rochford","51.58198","0.70673","4","0","0","0","0","0","1","5","1","3","1","0","5","1","2","2","0","5","1","1","2","0","1","5"
"Rockford","45.0883","-93.73441","1","0","0","0","0","0","0","1","0","0","0","1","1","1","0","0","0","1","1","0","0","0","0","1"
"Rockford","43.05219","-92.94853","1","0","0","0","0","0","0","1","0","0","0","1","1","1","0","0","0","1","1","0","0","0","0","1"
"Rockford","42.27113","-89.094","1","0","0","0","0","0","0","1","0","0","0","1","1","1","0","0","0","1","1","0","0","0","0","1"
"Rockford","32.88957","-86.21969","1","0","0","0","0","0","0","1","0","0","0","1","1","1","0","0","0","1","1","0","0","0","0","1"
"Rockford","43.12003","-85.56003","1","0","0","0","0","0","0","1","0","0","0","1","1","1","0","0","0","1","1","0","0","0","0","1"
"Rockford","40.68783","-84.64663","1","0","0","0","0","0","0","1","0","0","0","1","1","1","0","0","0","1","1","0","0","0","0","1"
"Rockford","35.82758","-83.94074","1","0","0","0","0","0","0","1","0","0","0","1","1","1","0","0","0","1","1","0","0","0","0","1"
"Rockford","40.47701","-81.30844","1","0","0","0","0","0","0","1","0","0","0","1","1","1","0","0","0","1","1","0","0","0","0","1"
"Rockville Centre","40.65871","-73.64124","1","0","0","0","0","0","0","1","0","0","1","0","1","1","0","0","0","1","0","0","1","0","0","1"
"Rockwall","32.93123","-96.45971","1","0","0","0","0","0","0","1","1","0","0","0","1","1","0","0","0","1","0","1","0","0","0","1"
"Roeser","49.53721","6.14629","0","0","0","0","1","0","0","1","1","0","0","0","1","1","0","0","0","1","0","0","1","0","0","1"
"Rohtak","28.89447","76.58917","3","0","0","0","0","0","0","3","1","0","0","0","1","1","0","2","0","3","1","0","2","0","0","3"
"Rokietnica","52.51245","16.7457","1","0","0","0","0","0","0","1","0","1","0","0","1","0","1","0","0","1","1","0","0","0","0","1"
"Rokietnica","49.89983","22.64171","1","0","0","0","0","0","0","1","0","1","0","0","1","0","1","0","0","1","1","0","0","0","0","1"
"Rome","44.2206","-89.80843","16","0","0","0","0","0","1","17","3","5","0","1","9","4","5","8","0","17","6","1","9","0","1","17"
"Rome","40.88309","-89.50259","16","0","0","0","0","0","1","17","3","5","0","1","9","4","5","8","0","17","6","1","9","0","1","17"
"Rome","42.98029","-88.63121","16","0","0","0","0","0","1","17","3","5","0","1","9","4","5","8","0","17","6","1","9","0","1","17"
"Rome","34.25704","-85.16467","16","0","0","0","0","0","1","17","3","5","0","1","9","4","5","8","0","17","6","1","9","0","1","17"
"Rome","43.21285","-75.45573","16","0","0","0","0","0","1","17","3","5","0","1","9","4","5","8","0","17","6","1","9","0","1","17"
"Rome","44.58506","-69.86922","16","0","0","0","0","0","1","17","3","5","0","1","9","4","5","8","0","17","6","1","9","0","1","17"
"Rome","41.89193","12.51133","16","0","0","0","0","0","1","17","3","5","0","1","9","4","5","8","0","17","6","1","9","0","1","17"
"Romford","51.57515","0.18582","18","2","0","1","4","0","1","26","7","7","10","0","24","8","2","15","1","26","1","8","14","2","1","26"
"Romsey","50.98906","-1.49989","7","0","0","0","0","0","1","8","1","2","4","0","7","2","4","2","0","8","3","3","2","0","0","8"
"Romsey","-37.35075","144.743","7","0","0","0","0","0","1","8","1","2","4","0","7","2","4","2","0","8","3","3","2","0","0","8"
"Romsley","52.45","-2.31667","3","0","0","0","1","0","0","4","0","4","0","0","4","3","0","1","0","4","3","0","1","0","0","4"
"Romsley","52.41996","-2.05695","3","0","0","0","1","0","0","4","0","4","0","0","4","3","0","1","0","4","3","0","1","0","0","4"
"Rongai","-0.17344","35.86313","1","0","0","0","0","0","0","1","0","1","0","0","1","1","0","0","0","1","0","1","0","0","0","1"
"Roni","12.65862","8.26505","1","0","0","0","0","0","0","1","0","1","0","0","1","1","0","0","0","1","0","0","0","0","1","1"
"Roosky","53.83333","-7.91667","1","0","0","0","0","0","0","1","0","0","1","0","1","0","0","1","0","1","0","0","1","0","0","1"
"Ropar","30.96896","76.52695","1","0","0","0","0","0","0","1","0","1","0","0","1","1","0","0","0","1","0","0","0","0","1","1"
"Rosario","27.84111","-109.36806","3","0","0","0","0","0","0","3","1","0","1","0","2","1","0","2","0","3","0","0","3","0","0","3"
"Rosario","17.08921","-93.24288","3","0","0","0","0","0","0","3","1","0","1","0","2","1","0","2","0","3","0","0","3","0","0","3"
"Rosario","-32.94682","-60.63932","3","0","0","0","0","0","0","3","1","0","1","0","2","1","0","2","0","3","0","0","3","0","0","3"
"Rosario","-34.31667","-57.35","3","0","0","0","0","0","0","3","1","0","1","0","2","1","0","2","0","3","0","0","3","0","0","3"
"Rosario","39.29104","16.23125","3","0","0","0","0","0","0","3","1","0","1","0","2","1","0","2","0","3","0","0","3","0","0","3"
"Rosario","16.2304","120.4863","3","0","0","0","0","0","0","3","1","0","1","0","2","1","0","2","0","3","0","0","3","0","0","3"
"Rosario","14.41827","120.8577","3","0","0","0","0","0","0","3","1","0","1","0","2","1","0","2","0","3","0","0","3","0","0","3"
"Rosario","13.84544","121.20478","3","0","0","0","0","0","0","3","1","0","1","0","2","1","0","2","0","3","0","0","3","0","0","3"
"Rosario","13.8635","122.2731","3","0","0","0","0","0","0","3","1","0","1","0","2","1","0","2","0","3","0","0","3","0","0","3"
"Rosario","11.5832","122.3019","3","0","0","0","0","0","0","3","1","0","1","0","2","1","0","2","0","3","0","0","3","0","0","3"
"Rosario","12.5223","124.425","3","0","0","0","0","0","0","3","1","0","1","0","2","1","0","2","0","3","0","0","3","0","0","3"
"Rosario","8.38694","126.00333","3","0","0","0","0","0","0","3","1","0","1","0","2","1","0","2","0","3","0","0","3","0","0","3"
"Roseau","48.84609","-95.76277","1","0","0","0","0","0","0","1","0","0","0","0","0","0","1","0","0","1","0","0","1","0","0","1"
"Roseau","15.30174","-61.38808","1","0","0","0","0","0","0","1","0","0","0","0","0","0","1","0","0","1","0","0","1","0","0","1"
"Rossendale","53.68456","-2.2769","1","0","0","0","0","0","0","1","0","1","0","0","1","0","0","1","0","1","1","0","0","0","0","1"
"Ross on Wye","51.91667","-2.56667","3","0","0","0","0","0","0","3","0","1","2","0","3","1","0","2","0","3","1","0","2","0","0","3"
"Rostock","54.0887","12.14049","1","0","0","0","0","0","0","1","0","0","1","0","1","0","0","1","0","1","0","0","1","0","0","1"
"Rostov-na-Donu","47.23135","39.72328","1","0","0","0","0","0","0","1","0","0","0","0","0","1","0","0","0","1","0","0","1","0","0","1"
"Roswell","33.39437","-104.52491","1","0","0","0","0","0","0","1","0","0","0","0","0","0","1","0","0","1","0","0","1","0","0","1"
"Roswell","34.02316","-84.36159","1","0","0","0","0","0","0","1","0","0","0","0","0","0","1","0","0","1","0","0","1","0","0","1"
"Rotherfield Peppard","51.53064","-0.97847","1","0","0","0","0","0","0","1","0","0","0","0","0","0","0","1","0","1","0","0","1","0","0","1"
"Rotherham","53.43012","-1.35678","21","1","0","0","0","0","0","22","7","3","9","0","19","7","0","15","0","22","6","8","8","0","0","22"
"Rothley","55.18333","-1.91667","0","0","0","0","1","0","0","1","1","0","0","0","1","0","0","1","0","1","0","0","1","0","0","1"
"Rothley","52.70916","-1.13739","0","0","0","0","1","0","0","1","1","0","0","0","1","0","0","1","0","1","0","0","1","0","0","1"
"Rotterdam","42.78702","-73.97096","2","0","0","0","0","1","0","3","1","0","2","0","3","0","0","3","0","3","0","0","2","0","1","3"
"Rotterdam","51.9225","4.47917","2","0","0","0","0","1","0","3","1","0","2","0","3","0","0","3","0","3","0","0","2","0","1","3"
"Rottingdean","50.80984","-0.05939","1","0","0","0","0","0","0","1","0","0","1","0","1","1","0","0","0","1","0","0","1","0","0","1"
"Round Rock","36.51306","-109.47344","2","0","0","0","0","0","0","2","0","0","0","0","0","1","0","1","0","2","0","0","2","0","0","2"
"Round Rock","30.50826","-97.6789","2","0","0","0","0","0","0","2","0","0","0","0","0","1","0","1","0","2","0","0","2","0","0","2"
"Roundwood","53.05861","-6.22611","1","0","0","0","0","0","0","1","0","1","0","0","1","0","0","1","0","1","0","0","1","0","0","1"
"Rowlands Gill","54.91922","-1.74489","1","0","0","0","0","0","0","1","0","0","1","0","1","0","1","0","0","1","0","0","1","0","0","1"
"Roxas City","11.58528","122.75111","0","1","0","0","0","0","0","1","1","0","0","0","1","1","0","0","0","1","1","0","0","0","0","1"
"Royal Leamington Spa","52.2852","-1.52","2","0","0","0","0","0","0","2","0","0","1","0","1","1","0","1","0","2","0","0","2","0","0","2"
"Royal Tunbridge Wells","51.13321","0.26256","5","0","0","0","0","0","2","7","2","2","3","0","7","4","0","3","0","7","0","1","4","0","2","7"
"Royal Wootton Bassett","51.5419","-1.9045","2","0","0","0","0","0","0","2","0","1","1","0","2","1","0","1","0","2","0","1","1","0","0","2"
"Roydon","51.7718","0.0403","1","0","0","0","0","0","0","1","0","0","1","0","1","0","0","1","0","1","0","0","1","0","0","1"
"Royse City","32.97512","-96.33248","1","0","0","0","0","0","0","1","0","0","1","0","1","0","1","0","0","1","0","0","1","0","0","1"
"Royston","49.64703","-124.9467","8","0","0","1","0","0","1","10","2","3","4","0","9","1","0","9","0","10","0","2","8","0","0","10"
"Royston","34.28705","-83.11015","8","0","0","1","0","0","1","10","2","3","4","0","9","1","0","9","0","10","0","2","8","0","0","10"
"Royston","53.6","-1.45","8","0","0","1","0","0","1","10","2","3","4","0","9","1","0","9","0","10","0","2","8","0","0","10"
"Royston","52.04832","-0.02438","8","0","0","1","0","0","1","10","2","3","4","0","9","1","0","9","0","10","0","2","8","0","0","10"
"Rubí de Bracamonte","41.21421","-4.92491","1","0","0","0","0","0","0","1","0","0","0","0","0","0","0","1","0","1","1","0","0","0","0","1"
"Rubizhne","49.01229","38.37967","1","0","0","0","0","0","0","1","0","0","0","0","0","0","0","0","1","1","0","0","1","0","0","1"
"Ruderatshofen","47.81667","10.58333","1","0","0","0","0","0","0","1","0","0","0","0","0","1","0","0","0","1","0","0","1","0","0","1"
"Rugby","48.36889","-99.99625","15","1","0","2","1","0","1","20","2","6","8","0","16","6","3","11","0","20","7","2","11","0","0","20"
"Rugby","52.37092","-1.26417","15","1","0","2","1","0","1","20","2","6","8","0","16","6","3","11","0","20","7","2","11","0","0","20"
"Rugeley","52.7593","-1.93694","6","0","0","0","0","0","0","6","1","2","3","0","6","1","1","4","0","6","1","4","1","0","0","6"
"Ruislip","51.57344","-0.42341","4","0","0","2","0","0","0","6","3","1","2","0","6","2","0","4","0","6","0","3","3","0","0","6"
"Ruma","12.8626","7.23469","0","1","0","0","0","0","0","1","1","0","0","0","1","0","0","0","1","1","0","0","1","0","0","1"
"Ruma","45.00806","19.82222","0","1","0","0","0","0","0","1","1","0","0","0","1","0","0","0","1","1","0","0","1","0","0","1"
"Rumenka","45.294","19.74306","1","0","0","0","0","0","0","1","0","1","0","0","1","0","0","1","0","1","1","0","0","0","0","1"
"Rumonge","-3.9736","29.4386","1","0","0","0","0","0","0","1","0","0","0","1","1","0","0","0","1","1","0","1","0","0","0","1"
"Runcorn","53.34174","-2.73124","6","1","0","0","1","0","1","9","3","3","3","0","9","4","2","3","0","9","3","2","4","0","0","9"
"Runcorn","-27.59756","153.07699","6","1","0","0","1","0","1","9","3","3","3","0","9","4","2","3","0","9","3","2","4","0","0","9"
"Rundu","-17.93333","19.76667","1","0","0","0","0","0","0","1","0","0","0","1","1","0","1","0","0","1","1","0","0","0","0","1"
"Rushden","52.28927","-0.60184","4","1","0","0","1","0","0","6","1","2","2","0","5","3","1","2","0","6","2","2","2","0","0","6"
"Ruskington","53.04544","-0.38692","0","0","0","0","1","0","0","1","1","0","0","0","1","0","1","0","0","1","0","1","0","0","0","1"
"Rustavi","41.56271","44.9787","1","0","0","0","0","0","0","1","0","0","0","1","1","0","0","0","1","1","1","0","0","0","0","1"
"Rusthall","51.13643","0.22931","1","0","0","0","0","0","0","1","0","1","0","0","1","1","0","0","0","1","0","1","0","0","0","1"
"Rustington","50.81027","-0.50674","2","0","0","0","0","0","0","2","0","1","0","0","1","1","1","0","0","2","1","0","1","0","0","2"
"Ruthin","53.11368","-3.31782","5","0","0","0","0","0","0","5","0","3","2","0","5","0","2","3","0","5","2","2","1","0","0","5"
"Ryazan’","54.6269","39.6916","1","0","0","0","0","0","0","1","0","0","1","0","1","0","0","1","0","1","0","0","1","0","0","1"
"Ryde","50.72999","-1.1621","3","0","0","0","0","0","0","3","0","1","1","1","3","1","0","2","0","3","2","0","1","0","0","3"
"Ryde","-33.8188","151.1062","3","0","0","0","0","0","0","3","0","1","1","1","3","1","0","2","0","3","2","0","1","0","0","3"
"Rye","40.98065","-73.68374","7","0","0","0","0","0","0","7","1","2","1","0","4","3","0","4","0","7","0","2","5","0","0","7"
"Rye","43.01342","-70.77089","7","0","0","0","0","0","0","7","1","2","1","0","4","3","0","4","0","7","0","2","5","0","0","7"
"Rye","50.95114","0.7337","7","0","0","0","0","0","0","7","1","2","1","0","4","3","0","4","0","7","0","2","5","0","0","7"
"Rye","-38.38528","144.81221","7","0","0","0","0","0","0","7","1","2","1","0","4","3","0","4","0","7","0","2","5","0","0","7"
"Ryton","52.61667","-2.35","1","0","0","0","0","0","0","1","0","1","0","0","1","0","0","1","0","1","0","0","1","0","0","1"
"Šabac","44.74667","19.69","1","0","0","0","0","0","0","1","0","0","0","0","0","0","1","0","0","1","0","0","1","0","0","1"
"Şabāḩ as Sālim","29.25722","48.05722","1","0","0","0","0","0","1","2","1","1","0","0","2","0","0","2","0","2","2","0","0","0","0","2"
"Sabanilla","17.28384","-92.55315","1","0","0","0","0","0","0","1","0","0","1","0","1","0","0","1","0","1","0","0","1","0","0","1"
"Sabanilla","10.07404","-84.21551","1","0","0","0","0","0","0","1","0","0","1","0","1","0","0","1","0","1","0","0","1","0","0","1"
"Sabanilla","9.94522","-84.03927","1","0","0","0","0","0","0","1","0","0","1","0","1","0","0","1","0","1","0","0","1","0","0","1"
"Sabhā","27.03766","14.42832","1","0","0","0","0","0","0","1","0","0","0","1","1","0","0","1","0","1","0","0","1","0","0","1"
"Şabrātah","32.79335","12.48845","1","0","0","0","0","0","0","1","1","0","0","0","1","0","0","1","0","1","0","1","0","0","0","1"
"Şabyā","17.1495","42.62537","1","0","0","0","0","0","0","1","0","1","0","0","1","0","1","0","0","1","0","0","0","0","1","1"
"Sacramento","38.58157","-121.4944","1","0","0","0","1","0","0","2","0","1","0","0","1","1","0","1","0","2","1","0","1","0","0","2"
"Sacramento","27.00264","-101.72463","1","0","0","0","1","0","0","2","0","1","0","0","1","1","0","1","0","2","1","0","1","0","0","2"
"Sacramento","23.61408","-100.67481","1","0","0","0","1","0","0","2","0","1","0","0","1","1","0","1","0","2","1","0","1","0","0","2"
"Sacramento","-19.86528","-47.44","1","0","0","0","1","0","0","2","0","1","0","0","1","1","0","1","0","2","1","0","1","0","0","2"
"Sa'dah","16.94021","43.76393","0","0","0","0","0","0","0","0","0","0","0","0","0","0","0","0","0","0","0","0","0","0","0","0"
"Saddiqabad","28.3091","70.12652","3","0","0","0","0","0","0","3","3","0","0","0","3","0","2","1","0","3","0","1","2","0","0","3"
"Safety Harbor","27.99085","-82.69316","0","0","0","1","0","0","0","1","0","0","0","0","0","1","0","0","0","1","1","0","0","0","0","1"
"Saffron Walden","52.02337","0.24234","9","1","0","0","0","0","0","10","3","1","3","0","7","3","2","5","0","10","0","4","5","0","1","10"
"Şafwá","26.6497","49.95522","1","0","0","0","0","0","0","1","0","0","1","0","1","1","0","0","0","1","0","0","1","0","0","1"
"Sagamihara","35.56707","139.24167","1","0","0","0","0","0","0","1","0","0","1","0","1","1","0","0","0","1","0","1","0","0","0","1"
"Sag Harbor","40.99788","-72.29258","0","1","0","0","0","0","0","1","0","0","1","0","1","0","0","1","0","1","0","0","1","0","0","1"
"Saginaw","32.86013","-97.36391","1","0","0","0","0","0","0","1","0","0","0","0","0","0","0","1","0","1","0","0","1","0","0","1"
"Saginaw","43.41947","-83.95081","1","0","0","0","0","0","0","1","0","0","0","0","0","0","0","1","0","1","0","0","1","0","0","1"
"Sahāranpur","29.9679","77.54522","1","0","0","0","0","0","0","1","1","0","0","0","1","0","0","1","0","1","0","0","1","0","0","1"
"Saharsa","25.87498","86.59611","2","0","0","0","0","0","0","2","1","0","0","0","1","1","0","1","0","2","0","0","2","0","0","2"
"Sahiwal","31.97386","72.33109","4","0","0","0","0","0","0","4","0","2","0","0","2","1","1","2","0","4","0","0","3","0","1","4"
"Sahiwal","30.66595","73.10186","4","0","0","0","0","0","0","4","0","2","0","0","2","1","1","2","0","4","0","0","3","0","1","4"
"Saidpur","28.61089","77.90896","1","0","0","0","0","0","1","2","0","1","0","0","1","1","0","1","0","2","1","0","1","0","0","2"
"Saidpur","25.53749","83.22378","1","0","0","0","0","0","1","2","0","1","0","0","1","1","0","1","0","2","1","0","1","0","0","2"
"Saidpur","25.77769","88.89169","1","0","0","0","0","0","1","2","0","1","0","0","1","1","0","1","0","2","1","0","1","0","0","2"
"Saidu Sharif","34.74655","72.35568","3","0","0","0","1","0","0","4","0","2","1","0","3","3","1","0","0","4","2","0","2","0","0","4"
"Saint Albans","38.38565","-81.83624","1","0","0","0","0","0","0","1","0","0","1","0","1","0","0","1","0","1","0","1","0","0","0","1"
"Saint Albans","44.81088","-73.08319","1","0","0","0","0","0","0","1","0","0","1","0","1","0","0","1","0","1","0","1","0","0","0","1"
"Saint Albans","44.91006","-69.41005","1","0","0","0","0","0","0","1","0","0","1","0","1","0","0","1","0","1","0","1","0","0","0","1"
"Saint Albans","-37.73333","144.8","1","0","0","0","0","0","0","1","0","0","1","0","1","0","0","1","0","1","0","1","0","0","0","1"
"Saint Andrews","34.04543","-81.12926","1","0","0","0","0","0","0","1","0","0","1","0","1","1","0","0","0","1","0","0","1","0","0","1"
"Saint Andrews","45.0737","-67.05312","1","0","0","0","0","0","0","1","0","0","1","0","1","1","0","0","0","1","0","0","1","0","0","1"
"Saint Andrews","56.33871","-2.79902","1","0","0","0","0","0","0","1","0","0","1","0","1","1","0","0","0","1","0","0","1","0","0","1"
"Saint Andrews","-37.60151","145.27235","1","0","0","0","0","0","0","1","0","0","1","0","1","1","0","0","0","1","0","0","1","0","0","1"
"Saint Asaph","53.25815","-3.44524","1","0","0","0","0","0","0","1","0","1","0","0","1","0","1","0","0","1","0","0","1","0","0","1"
"Saint George's","12.05288","-61.75226","1","0","0","0","0","0","0","1","0","0","0","0","0","0","0","1","0","1","1","0","0","0","0","1"
"Saint Helier","49.18804","-2.10491","2","0","0","0","1","0","0","3","0","1","1","0","2","3","0","0","0","3","0","1","2","0","0","3"
"Saint-Joseph","45.95817","-73.22025","1","0","0","0","0","0","0","1","1","0","0","0","1","1","0","0","0","1","0","0","1","0","0","1"
"Saint-Joseph","14.67099","-61.03905","1","0","0","0","0","0","0","1","1","0","0","0","1","1","0","0","0","1","0","0","1","0","0","1"
"Saint-Joseph","49.53381","-1.53095","1","0","0","0","0","0","0","1","1","0","0","0","1","1","0","0","0","1","0","0","1","0","0","1"
"Saint-Joseph","45.55757","4.62076","1","0","0","0","0","0","0","1","1","0","0","0","1","1","0","0","0","1","0","0","1","0","0","1"
"Saint-Joseph","43.34617","5.37976","1","0","0","0","0","0","0","1","1","0","0","0","1","1","0","0","0","1","0","0","1","0","0","1"
"Saint-Joseph","-21.3777","55.61691","1","0","0","0","0","0","0","1","1","0","0","0","1","1","0","0","0","1","0","0","1","0","0","1"
"Saint Louis","43.40836","-84.60667","3","0","0","0","1","0","0","4","1","2","1","0","4","2","1","1","0","4","2","0","2","0","0","4"
"Saint-Louis","16.01793","-16.48962","1","0","0","0","0","0","0","1","1","0","0","0","1","1","0","0","0","1","0","0","1","0","0","1"
"Saint-Louis","43.34809","5.35463","1","0","0","0","0","0","0","1","1","0","0","0","1","1","0","0","0","1","0","0","1","0","0","1"
"Saint-Louis","48.71609","7.18874","1","0","0","0","0","0","0","1","1","0","0","0","1","1","0","0","0","1","0","0","1","0","0","1"
"Saint-Louis","47.59206","7.55923","1","0","0","0","0","0","0","1","1","0","0","0","1","1","0","0","0","1","0","0","1","0","0","1"
"Saint-Louis","-21.28585","55.41124","1","0","0","0","0","0","0","1","1","0","0","0","1","1","0","0","0","1","0","0","1","0","0","1"
"Saint Louis Park","44.9483","-93.34801","1","0","0","0","0","0","0","1","1","0","0","0","1","0","0","1","0","1","0","0","1","0","0","1"
"Saint Lucia Estuary","-28.37622","32.41181","1","0","0","0","0","0","0","1","0","1","0","0","1","0","1","0","0","1","1","0","0","0","0","1"
"Saint Neots","52.21667","-0.26667","3","0","0","0","0","0","1","4","1","0","1","0","2","3","0","1","0","4","0","1","3","0","0","4"
"Saint Peter Port","49.45981","-2.53527","4","0","0","0","0","0","1","5","0","0","3","0","3","1","2","2","0","5","1","0","4","0","0","5"
"Saint Peters","38.80033","-90.62651","1","0","0","0","0","0","0","1","0","1","0","0","1","1","0","0","0","1","0","0","1","0","0","1"
"Saint Peters","16.7727","-62.21729","1","0","0","0","0","0","0","1","0","1","0","0","1","1","0","0","0","1","0","0","1","0","0","1"
"Saint Peters","51.36667","1.41667","1","0","0","0","0","0","0","1","0","1","0","0","1","1","0","0","0","1","0","0","1","0","0","1"
"Saint Peters","-33.91667","151.18333","1","0","0","0","0","0","0","1","0","1","0","0","1","1","0","0","0","1","0","0","1","0","0","1"
"Saint Petersburg","59.93863","30.31413","3","0","0","1","0","0","0","4","0","1","2","1","4","1","1","1","1","4","2","1","1","0","0","4"
"Saint Simons Island","31.15051","-81.36954","1","0","0","0","0","0","0","1","0","0","1","0","1","1","0","0","0","1","0","1","0","0","0","1"
"Šakiai","54.95339","23.04779","1","0","0","0","0","0","0","1","1","0","0","0","1","0","0","1","0","1","0","1","0","0","0","1"
"Sakrand","26.13845","68.27444","1","0","0","0","0","0","0","1","1","0","0","0","1","0","0","0","1","1","0","0","1","0","0","1"
"Şalālah","17.01505","54.09237","2","0","0","0","0","0","0","2","1","2","0","0","3","2","0","1","0","3","2","0","1","0","0","3"
"Salcombe","50.23743","-3.76874","1","0","0","0","0","0","0","1","0","1","0","0","1","1","0","0","0","1","1","0","0","0","0","1"
"Sale","34.0531","-6.79846","8","0","0","0","1","0","1","10","5","2","1","0","8","2","3","5","0","10","2","1","7","0","0","10"
"Sale","53.42519","-2.32443","8","0","0","0","1","0","1","10","5","2","1","0","8","2","3","5","0","10","2","1","7","0","0","10"
"Sale","44.97932","8.80963","8","0","0","0","1","0","1","10","5","2","1","0","8","2","3","5","0","10","2","1","7","0","0","10"
"Sale","-6.8619","111.6043","8","0","0","0","1","0","1","10","5","2","1","0","8","2","3","5","0","10","2","1","7","0","0","10"
"Sale","-38.11095","147.06802","8","0","0","0","1","0","1","10","5","2","1","0","8","2","3","5","0","10","2","1","7","0","0","10"
"Salem","44.9429","-123.0351","4","0","0","0","0","0","0","4","4","0","0","0","4","2","1","1","0","4","0","1","2","0","1","4"
"Salem","40.05301","-111.67354","4","0","0","0","0","0","0","4","4","0","0","0","4","2","1","1","0","4","0","1","2","0","1","4"
"Salem","32.70758","-107.21308","4","0","0","0","0","0","0","4","4","0","0","0","4","2","1","1","0","4","0","1","2","0","1","4"
"Salem","43.72415","-97.38895","4","0","0","0","0","0","0","4","4","0","0","0","4","2","1","1","0","4","0","1","2","0","1","4"
"Salem","34.62898","-92.55822","4","0","0","0","0","0","0","4","4","0","0","0","4","2","1","1","0","4","0","1","2","0","1","4"
"Salem","36.37118","-91.82265","4","0","0","0","0","0","0","4","4","0","0","0","4","2","1","1","0","4","0","1","2","0","1","4"
"Salem","37.6456","-91.53598","4","0","0","0","0","0","0","4","4","0","0","0","4","2","1","1","0","4","0","1","2","0","1","4"
"Salem","38.62699","-88.94562","4","0","0","0","0","0","0","4","4","0","0","0","4","2","1","1","0","4","0","1","2","0","1","4"
"Salem","37.2645","-88.2442","4","0","0","0","0","0","0","4","4","0","0","0","4","2","1","1","0","4","0","1","2","0","1","4"
"Salem","42.55474","-88.11092","4","0","0","0","0","0","0","4","4","0","0","0","4","2","1","1","0","4","0","1","2","0","1","4"
"Salem","38.60561","-86.10109","4","0","0","0","0","0","0","4","4","0","0","0","4","2","1","1","0","4","0","1","2","0","1","4"
"Salem","37.06896","-84.98551","4","0","0","0","0","0","0","4","4","0","0","0","4","2","1","1","0","4","0","1","2","0","1","4"
"Salem","35.69874","-81.69704","4","0","0","0","0","0","0","4","4","0","0","0","4","2","1","1","0","4","0","1","2","0","1","4"
"Salem","40.90089","-80.85675","4","0","0","0","0","0","0","4","4","0","0","0","4","2","1","1","0","4","0","1","2","0","1","4"
"Salem","39.28287","-80.55899","4","0","0","0","0","0","0","4","4","0","0","0","4","2","1","1","0","4","0","1","2","0","1","4"
"Salem","37.29347","-80.05476","4","0","0","0","0","0","0","4","4","0","0","0","4","2","1","1","0","4","0","1","2","0","1","4"
"Salem","39.57178","-75.46714","4","0","0","0","0","0","0","4","4","0","0","0","4","2","1","1","0","4","0","1","2","0","1","4"
"Salem","43.1723","-73.32761","4","0","0","0","0","0","0","4","4","0","0","0","4","2","1","1","0","4","0","1","2","0","1","4"
"Salem","41.49038","-72.27536","4","0","0","0","0","0","0","4","4","0","0","0","4","2","1","1","0","4","0","1","2","0","1","4"
"Salem","42.78842","-71.20089","4","0","0","0","0","0","0","4","4","0","0","0","4","2","1","1","0","4","0","1","2","0","1","4"
"Salem","42.51954","-70.89672","4","0","0","0","0","0","0","4","4","0","0","0","4","2","1","1","0","4","0","1","2","0","1","4"
"Salem","16.75095","-62.22175","4","0","0","0","0","0","0","4","4","0","0","0","4","2","1","1","0","4","0","1","2","0","1","4"
"Salem","47.76258","9.29031","4","0","0","0","0","0","0","4","4","0","0","0","4","2","1","1","0","4","0","1","2","0","1","4"
"Salem","53.656","10.82632","4","0","0","0","0","0","0","4","4","0","0","0","4","2","1","1","0","4","0","1","2","0","1","4"
"Salem","11.65376","78.15538","4","0","0","0","0","0","0","4","4","0","0","0","4","2","1","1","0","4","0","1","2","0","1","4"
"Salem","-7.1825","108.8059","4","0","0","0","0","0","0","4","4","0","0","0","4","2","1","1","0","4","0","1","2","0","1","4"
"Salerno","40.67545","14.79328","1","0","0","0","0","0","0","1","0","0","0","0","0","1","0","0","0","1","1","0","0","0","0","1"
"Salfīt","32.08371","35.18079","1","0","0","0","0","0","0","1","0","1","0","0","1","0","0","1","0","1","1","0","0","0","0","1"
"Salford","53.48771","-2.29042","17","0","0","0","3","0","0","20","1","6","10","0","17","7","4","9","0","20","3","5","12","0","0","20"
"Salisbury","39.42392","-92.80158","20","1","0","1","6","0","0","28","7","12","5","1","25","9","3","16","0","28","6","6","16","0","0","28"
"Salisbury","35.67097","-80.47423","20","1","0","1","6","0","0","28","7","12","5","1","25","9","3","16","0","28","6","6","16","0","0","28"
"Salisbury","39.75286","-79.08086","20","1","0","1","6","0","0","28","7","12","5","1","25","9","3","16","0","28","6","6","16","0","0","28"
"Salisbury","38.36067","-75.59937","20","1","0","1","6","0","0","28","7","12","5","1","25","9","3","16","0","28","6","6","16","0","0","28"
"Salisbury","40.74566","-73.56013","20","1","0","1","6","0","0","28","7","12","5","1","25","9","3","16","0","28","6","6","16","0","0","28"
"Salisbury","43.89645","-73.09984","20","1","0","1","6","0","0","28","7","12","5","1","25","9","3","16","0","28","6","6","16","0","0","28"
"Salisbury","43.38008","-71.71702","20","1","0","1","6","0","0","28","7","12","5","1","25","9","3","16","0","28","6","6","16","0","0","28"
"Salisbury","42.84176","-70.86061","20","1","0","1","6","0","0","28","7","12","5","1","25","9","3","16","0","28","6","6","16","0","0","28"
"Salisbury","46.03905","-65.04628","20","1","0","1","6","0","0","28","7","12","5","1","25","9","3","16","0","28","6","6","16","0","0","28"
"Salisbury","15.43689","-61.43637","20","1","0","1","6","0","0","28","7","12","5","1","25","9","3","16","0","28","6","6","16","0","0","28"
"Salisbury","51.06931","-1.79569","20","1","0","1","6","0","0","28","7","12","5","1","25","9","3","16","0","28","6","6","16","0","0","28"
"Salisbury","-34.76667","138.63333","20","1","0","1","6","0","0","28","7","12","5","1","25","9","3","16","0","28","6","6","16","0","0","28"
"Salisbury","-27.55145","153.0325","20","1","0","1","6","0","0","28","7","12","5","1","25","9","3","16","0","28","6","6","16","0","0","28"
"Sallanches","45.94423","6.63162","1","0","0","0","0","0","0","1","1","0","0","0","1","0","0","1","0","1","0","1","0","0","0","1"
"Salta","-24.7859","-65.41166","1","0","0","0","0","0","0","1","1","0","0","0","1","0","0","1","0","1","0","0","1","0","0","1"
"Saltash","50.40959","-4.22514","2","0","0","0","0","0","0","2","0","0","2","0","2","1","0","1","0","2","0","2","0","0","0","2"
"Saltburn-by-the-Sea","54.58237","-0.97367","1","0","0","0","1","0","0","2","1","0","1","0","2","0","0","2","0","2","0","0","2","0","0","2"
"Saltcoats","55.63616","-4.78588","1","0","0","0","0","0","0","1","0","1","0","0","1","0","1","0","0","1","0","0","1","0","0","1"
"Saltillo","25.42321","-101.0053","2","0","0","0","0","0","0","2","1","0","0","0","1","0","0","2","0","2","0","0","2","0","0","2"
"Saltillo","19.29644","-97.29661","2","0","0","0","0","0","0","2","1","0","0","0","1","0","0","2","0","2","0","0","2","0","0","2"
"Saltillo","18.15893","-94.85325","2","0","0","0","0","0","0","2","1","0","0","0","1","0","0","2","0","2","0","0","2","0","0","2"
"Saltillo","16.39359","-91.9489","2","0","0","0","0","0","0","2","1","0","0","0","1","0","0","2","0","2","0","0","2","0","0","2"
"Saltillo","34.37649","-88.68172","2","0","0","0","0","0","0","2","1","0","0","0","1","0","0","2","0","2","0","0","2","0","0","2"
"Saltillo","35.37785","-88.20948","2","0","0","0","0","0","0","2","1","0","0","0","1","0","0","2","0","2","0","0","2","0","0","2"
"Salt Lake City","40.76078","-111.89105","3","0","0","0","0","0","0","3","0","1","0","0","1","1","1","1","0","3","2","0","1","0","0","3"
"Salto","-34.29292","-60.25455","1","0","0","0","0","0","0","1","0","0","1","0","1","0","1","0","0","1","0","0","1","0","0","1"
"Salto","-31.38333","-57.96667","1","0","0","0","0","0","0","1","0","0","1","0","1","0","1","0","0","1","0","0","1","0","0","1"
"Salto","-23.20083","-47.28694","1","0","0","0","0","0","0","1","0","0","1","0","1","0","1","0","0","1","0","0","1","0","0","1"
"Salvador","-12.97111","-38.51083","2","0","0","0","0","0","0","2","0","1","0","0","1","0","1","1","0","2","2","0","0","0","0","2"
"Salvador","7.89528","123.84361","2","0","0","0","0","0","0","2","0","1","0","0","1","0","1","1","0","2","2","0","0","0","0","2"
"Salwá","29.29583","48.07861","2","0","0","0","0","0","0","2","1","1","0","0","2","0","1","1","0","2","2","0","0","0","0","2"
"Samannūd","30.9616","31.24069","1","0","0","0","0","0","0","1","0","0","0","0","0","1","0","0","0","1","0","0","1","0","0","1"
"Samāstipur","25.86222","85.77953","1","0","0","0","0","0","0","1","1","0","0","0","1","1","0","0","0","1","0","0","1","0","0","1"
"Sambir","49.5183","23.19752","1","0","0","0","0","0","0","1","0","0","0","0","0","1","0","0","0","1","0","1","0","0","0","1"
"Samdrup Jongkhar","26.80069","91.50519","1","0","0","0","0","0","0","1","0","1","0","0","1","0","1","0","0","1","1","0","0","0","0","1"
"Same","-4.06667","37.73333","0","0","0","0","0","1","0","1","0","0","0","1","1","1","0","0","0","1","1","0","0","0","0","1"
"Same","-9.00417","125.64861","0","0","0","0","0","1","0","1","0","0","0","1","1","1","0","0","0","1","1","0","0","0","0","1"
"Samsun","41.27976","36.3361","1","0","0","0","0","0","1","2","0","0","0","1","1","1","0","1","0","2","2","0","0","0","0","2"
"Sanaa","15.35472","44.20667","14","0","0","0","0","0","0","14","3","9","0","1","13","8","3","2","0","13","6","1","5","1","1","14"
"Sanandaj","35.31495","46.99883","1","0","0","0","0","0","0","1","0","0","0","0","0","0","1","0","0","1","0","0","1","0","0","1"
"San Antonio Heights","34.15556","-117.65644","1","0","0","0","0","0","0","1","0","0","0","0","0","1","0","0","0","1","1","0","0","0","0","1"
"San Carlos","37.50716","-122.26052","1","0","0","0","0","0","0","1","1","0","0","0","1","0","1","0","0","1","0","0","1","0","0","1"
"San Carlos","33.34588","-111.8507","1","0","0","0","0","0","0","1","1","0","0","0","1","0","1","0","0","1","0","0","1","0","0","1"
"San Carlos","27.95749","-111.04354","1","0","0","0","0","0","0","1","1","0","0","0","1","0","1","0","0","1","0","0","1","0","0","1"
"San Carlos","33.34562","-110.45504","1","0","0","0","0","0","0","1","1","0","0","0","1","0","1","0","0","1","0","0","1","0","0","1"
"San Carlos","29.10665","-103.90722","1","0","0","0","0","0","0","1","1","0","0","0","1","0","1","0","0","1","0","0","1","0","0","1"
"San Carlos","29.02844","-100.90217","1","0","0","0","0","0","0","1","1","0","0","0","1","0","1","0","0","1","0","0","1","0","0","1"
"San Carlos","24.58223","-98.94208","1","0","0","0","0","0","0","1","1","0","0","0","1","0","1","0","0","1","0","0","1","0","0","1"
"San Carlos","18.51349","-98.51796","1","0","0","0","0","0","0","1","1","0","0","0","1","0","1","0","0","1","0","0","1","0","0","1"
"San Carlos","26.29563","-98.07195","1","0","0","0","0","0","0","1","1","0","0","0","1","0","1","0","0","1","0","0","1","0","0","1"
"San Carlos","19.43882","-97.69035","1","0","0","0","0","0","0","1","1","0","0","0","1","0","1","0","0","1","0","0","1","0","0","1"
"San Carlos","17.68111","-94.70667","1","0","0","0","0","0","0","1","1","0","0","0","1","0","1","0","0","1","0","0","1","0","0","1"
"San Carlos","17.83326","-92.52977","1","0","0","0","0","0","0","1","1","0","0","0","1","0","1","0","0","1","0","0","1","0","0","1"
"San Carlos","17.55221","-91.15408","1","0","0","0","0","0","0","1","1","0","0","0","1","0","1","0","0","1","0","0","1","0","0","1"
"San Carlos","11.1236","-84.77795","1","0","0","0","0","0","0","1","1","0","0","0","1","0","1","0","0","1","0","0","1","0","0","1"
"San Carlos","8.51663","-82.50906","1","0","0","0","0","0","0","1","1","0","0","0","1","0","1","0","0","1","0","0","1","0","0","1"
"San Carlos","8.47323","-79.96104","1","0","0","0","0","0","0","1","1","0","0","0","1","0","1","0","0","1","0","0","1","0","0","1"
"San Carlos","-5.96667","-77.93333","1","0","0","0","0","0","0","1","1","0","0","0","1","0","1","0","0","1","0","0","1","0","0","1"
"San Carlos","8.74372","-75.71331","1","0","0","0","0","0","0","1","1","0","0","0","1","0","1","0","0","1","0","0","1","0","0","1"
"San Carlos","8.79577","-75.69947","1","0","0","0","0","0","0","1","1","0","0","0","1","0","1","0","0","1","0","0","1","0","0","1"
"San Carlos","6.18789","-74.99315","1","0","0","0","0","0","0","1","1","0","0","0","1","0","1","0","0","1","0","0","1","0","0","1"
"San Carlos","7.79177","-74.77316","1","0","0","0","0","0","0","1","1","0","0","0","1","0","1","0","0","1","0","0","1","0","0","1"
"San Carlos","-36.42477","-71.958","1","0","0","0","0","0","0","1","1","0","0","0","1","0","1","0","0","1","0","0","1","0","0","1"
"San Carlos","18.48333","-69.9","1","0","0","0","0","0","0","1","1","0","0","0","1","0","1","0","0","1","0","0","1","0","0","1"
"San Carlos","9.66124","-68.58268","1","0","0","0","0","0","0","1","1","0","0","0","1","0","1","0","0","1","0","0","1","0","0","1"
"San Carlos","-25.88618","-65.92941","1","0","0","0","0","0","0","1","1","0","0","0","1","0","1","0","0","1","0","0","1","0","0","1"
"San Carlos","-31.17761","-65.10245","1","0","0","0","0","0","0","1","1","0","0","0","1","0","1","0","0","1","0","0","1","0","0","1"
"San Carlos","-17.4","-63.75","1","0","0","0","0","0","0","1","1","0","0","0","1","0","1","0","0","1","0","0","1","0","0","1"
"San Carlos","-22.26667","-57.3","1","0","0","0","0","0","0","1","1","0","0","0","1","0","1","0","0","1","0","0","1","0","0","1"
"San Carlos","-27.74586","-55.89731","1","0","0","0","0","0","0","1","1","0","0","0","1","0","1","0","0","1","0","0","1","0","0","1"
"San Carlos","-34.79123","-54.91824","1","0","0","0","0","0","0","1","1","0","0","0","1","0","1","0","0","1","0","0","1","0","0","1"
"San Carlos","15.03966","120.76285","1","0","0","0","0","0","0","1","1","0","0","0","1","0","1","0","0","1","0","0","1","0","0","1"
"San Carlos","15.5448","120.8931","1","0","0","0","0","0","0","1","1","0","0","0","1","0","1","0","0","1","0","0","1","0","0","1"
"San Carlos","13.8422","121.2416","1","0","0","0","0","0","0","1","1","0","0","0","1","0","1","0","0","1","0","0","1","0","0","1"
"San Carlos","7.95972","125.0775","1","0","0","0","0","0","0","1","1","0","0","0","1","0","1","0","0","1","0","0","1","0","0","1"
"San Cristóbal","23.17609","-103.05606","2","0","0","0","0","0","0","2","2","0","0","0","2","0","0","2","0","2","1","1","0","0","0","2"
"San Cristóbal","22.59085","-102.2339","2","0","0","0","0","0","0","2","2","0","0","0","2","0","0","2","0","2","1","1","0","0","0","2"
"San Cristóbal","21.68159","-101.94093","2","0","0","0","0","0","0","2","2","0","0","0","2","0","0","2","0","2","1","1","0","0","0","2"
"San Cristóbal","20.97777","-101.69969","2","0","0","0","0","0","0","2","2","0","0","0","2","0","0","2","0","2","1","1","0","0","0","2"
"San Cristóbal","20.65787","-101.47683","2","0","0","0","0","0","0","2","2","0","0","0","2","0","0","2","0","2","1","1","0","0","0","2"
"San Cristóbal","20.39094","-101.3973","2","0","0","0","0","0","0","2","2","0","0","0","2","0","0","2","0","2","1","1","0","0","0","2"
"San Cristóbal","20.50388","-100.61522","2","0","0","0","0","0","0","2","2","0","0","0","2","0","0","2","0","2","1","1","0","0","0","2"
"San Cristóbal","18.17029","-100.48692","2","0","0","0","0","0","0","2","2","0","0","0","2","0","0","2","0","2","1","1","0","0","0","2"
"San Cristóbal","17.27575","-99.93946","2","0","0","0","0","0","0","2","2","0","0","0","2","0","0","2","0","2","1","1","0","0","0","2"
"San Cristóbal","20.64104","-98.82943","2","0","0","0","0","0","0","2","2","0","0","0","2","0","0","2","0","2","1","1","0","0","0","2"
"San Cristóbal","20.95595","-98.66177","2","0","0","0","0","0","0","2","2","0","0","0","2","0","0","2","0","2","1","1","0","0","0","2"
"San Cristóbal","16.82221","-98.40283","2","0","0","0","0","0","0","2","2","0","0","0","2","0","0","2","0","2","1","1","0","0","0","2"
"San Cristóbal","16.48405","-97.86578","2","0","0","0","0","0","0","2","2","0","0","0","2","0","0","2","0","2","1","1","0","0","0","2"
"San Cristóbal","18.82979","-97.12392","2","0","0","0","0","0","0","2","2","0","0","0","2","0","0","2","0","2","1","1","0","0","0","2"
"San Cristóbal","16.44491","-95.53192","2","0","0","0","0","0","0","2","2","0","0","0","2","0","0","2","0","2","1","1","0","0","0","2"
"San Cristóbal","17.80871","-94.54032","2","0","0","0","0","0","0","2","2","0","0","0","2","0","0","2","0","2","1","1","0","0","0","2"
"San Cristóbal","9.28129","-82.26763","2","0","0","0","0","0","0","2","2","0","0","0","2","0","0","2","0","2","1","1","0","0","0","2"
"San Cristóbal","9.87809","-75.25248","2","0","0","0","0","0","0","2","2","0","0","0","2","0","0","2","0","2","1","1","0","0","0","2"
"San Cristóbal","10.39523","-75.06562","2","0","0","0","0","0","0","2","2","0","0","0","2","0","0","2","0","2","1","1","0","0","0","2"
"San Cristóbal","7.76694","-72.225","2","0","0","0","0","0","0","2","2","0","0","0","2","0","0","2","0","2","1","1","0","0","0","2"
"San Cristóbal","18.41667","-70.1","2","0","0","0","0","0","0","2","2","0","0","0","2","0","0","2","0","2","1","1","0","0","0","2"
"San Cristóbal","-30.31053","-61.23724","2","0","0","0","0","0","0","2","2","0","0","0","2","0","0","2","0","2","1","1","0","0","0","2"
"Sandakan","5.8402","118.1179","1","0","0","0","0","0","0","1","0","1","0","0","1","0","1","0","0","1","0","0","1","0","0","1"
"Sandbach","53.14515","-2.36251","3","0","0","0","0","0","0","3","1","1","1","0","3","2","0","1","0","3","0","2","0","0","1","3"
"Sandhurst","51.34675","-0.78655","6","0","0","0","0","0","0","6","0","5","1","0","6","0","2","4","0","6","3","0","3","0","0","6"
"Sandhurst","-38.081","145.20767","6","0","0","0","0","0","0","6","0","5","1","0","6","0","2","4","0","6","3","0","3","0","0","6"
"San Diego","32.71571","-117.16472","4","0","0","1","1","0","0","6","2","2","2","0","6","2","0","4","0","6","1","0","4","1","0","6"
"San Diego","24.3825","-107.33135","4","0","0","1","1","0","0","6","2","2","2","0","6","2","0","4","0","6","1","0","4","1","0","6"
"San Diego","20.88838","-101.40973","4","0","0","1","1","0","0","6","2","2","2","0","6","2","0","4","0","6","1","0","4","1","0","6"
"San Diego","21.91692","-100.101","4","0","0","1","1","0","0","6","2","2","2","0","6","2","0","4","0","6","1","0","4","1","0","6"
"San Diego","19.00833","-99.65434","4","0","0","1","1","0","0","6","2","2","2","0","6","2","0","4","0","6","1","0","4","1","0","6"
"San Diego","18.97291","-99.5853","4","0","0","1","1","0","0","6","2","2","2","0","6","2","0","4","0","6","1","0","4","1","0","6"
"San Diego","27.76391","-98.2389","4","0","0","1","1","0","0","6","2","2","2","0","6","2","0","4","0","6","1","0","4","1","0","6"
"San Diego","21.14688","-98.19064","4","0","0","1","1","0","0","6","2","2","2","0","6","2","0","4","0","6","1","0","4","1","0","6"
"San Diego","19.85667","-97.36111","4","0","0","1","1","0","0","6","2","2","2","0","6","2","0","4","0","6","1","0","4","1","0","6"
"San Diego","16.11299","-91.96188","4","0","0","1","1","0","0","6","2","2","2","0","6","2","0","4","0","6","1","0","4","1","0","6"
"San Diego","14.78979","-89.77639","4","0","0","1","1","0","0","6","2","2","2","0","6","2","0","4","0","6","1","0","4","1","0","6"
"San Diego","19.84495","-88.72935","4","0","0","1","1","0","0","6","2","2","2","0","6","2","0","4","0","6","1","0","4","1","0","6"
"San Diego","14.05","-86.46667","4","0","0","1","1","0","0","6","2","2","2","0","6","2","0","4","0","6","1","0","4","1","0","6"
"San Diego","9.89898","-84.00287","4","0","0","1","1","0","0","6","2","2","2","0","6","2","0","4","0","6","1","0","4","1","0","6"
"San Diego","10.33623","-73.18203","4","0","0","1","1","0","0","6","2","2","2","0","6","2","0","4","0","6","1","0","4","1","0","6"
"San Diego","10.26057","-67.95363","4","0","0","1","1","0","0","6","2","2","2","0","6","2","0","4","0","6","1","0","4","1","0","6"
"San Diego","14.0422","120.6255","4","0","0","1","1","0","0","6","2","2","2","0","6","2","0","4","0","6","1","0","4","1","0","6"
"San Diego","14.1872","121.4867","4","0","0","1","1","0","0","6","2","2","2","0","6","2","0","4","0","6","1","0","4","1","0","6"
"San Diego de la Unión","21.46749","-100.8731","1","0","0","0","0","0","0","1","0","1","0","0","1","1","0","0","0","1","1","0","0","0","0","1"
"Sandwich","41.64586","-88.62174","1","0","0","0","0","0","0","1","0","0","0","0","0","0","0","1","0","1","0","1","0","0","0","1"
"Sandwich","43.79035","-71.41118","1","0","0","0","0","0","0","1","0","0","0","0","0","0","0","1","0","1","0","1","0","0","0","1"
"Sandwich","41.759","-70.49392","1","0","0","0","0","0","0","1","0","0","0","0","0","0","0","1","0","1","0","1","0","0","0","1"
"Sandwich","51.27223","1.33776","1","0","0","0","0","0","0","1","0","0","0","0","0","0","0","1","0","1","0","1","0","0","0","1"
"Sandwīp","22.51409","91.45491","0","0","0","0","0","0","1","1","1","0","0","0","1","0","0","0","1","1","0","1","0","0","0","1"
"Sandy","45.39734","-122.26148","5","0","0","0","0","0","0","5","1","1","3","0","5","2","1","2","0","5","0","2","2","1","0","5"
"Sandy","40.59161","-111.8841","5","0","0","0","0","0","0","5","1","1","3","0","5","2","1","2","0","5","0","2","2","1","0","5"
"Sandy","41.10784","-78.77114","5","0","0","0","0","0","0","5","1","1","3","0","5","2","1","2","0","5","0","2","2","1","0","5"
"Sandy","52.12927","-0.28925","5","0","0","0","0","0","0","5","1","1","3","0","5","2","1","2","0","5","0","2","2","1","0","5"
"San Fernando","34.28195","-118.43897","4","0","0","0","0","0","0","4","0","1","2","0","3","2","0","2","0","4","3","0","1","0","0","4"
"San Fernando","25.55881","-108.60948","4","0","0","0","0","0","0","4","0","1","2","0","3","2","0","2","0","4","3","0","1","0","0","4"
"San Fernando","21.57851","-104.78569","4","0","0","0","0","0","0","4","0","1","2","0","3","2","0","2","0","4","3","0","1","0","0","4"
"San Fernando","18.96646","-99.75922","4","0","0","0","0","0","0","4","0","1","2","0","3","2","0","2","0","4","3","0","1","0","0","4"
"San Fernando","24.84749","-98.14828","4","0","0","0","0","0","0","4","0","1","2","0","3","2","0","2","0","4","3","0","1","0","0","4"
"San Fernando","20.89885","-97.87316","4","0","0","0","0","0","0","4","0","1","2","0","3","2","0","2","0","4","3","0","1","0","0","4"
"San Fernando","18.269","-94.88483","4","0","0","0","0","0","0","4","0","1","2","0","3","2","0","2","0","4","3","0","1","0","0","4"
"San Fernando","16.87153","-93.20759","4","0","0","0","0","0","0","4","0","1","2","0","3","2","0","2","0","4","3","0","1","0","0","4"
"San Fernando","16.68056","-92.29444","4","0","0","0","0","0","0","4","0","1","2","0","3","2","0","2","0","4","3","0","1","0","0","4"
"San Fernando","14.68333","-89.11667","4","0","0","0","0","0","0","4","0","1","2","0","3","2","0","2","0","4","3","0","1","0","0","4"
"San Fernando","13.67755","-86.31486","4","0","0","0","0","0","0","4","0","1","2","0","3","2","0","2","0","4","3","0","1","0","0","4"
"San Fernando","9.27972","-74.53389","4","0","0","0","0","0","0","4","0","1","2","0","3","2","0","2","0","4","3","0","1","0","0","4"
"San Fernando","9.21093","-74.31797","4","0","0","0","0","0","0","4","0","1","2","0","3","2","0","2","0","4","3","0","1","0","0","4"
"San Fernando","10.27969","-61.46835","4","0","0","0","0","0","0","4","0","1","2","0","3","2","0","2","0","4","3","0","1","0","0","4"
"San Fernando","36.4759","-6.19817","4","0","0","0","0","0","0","4","0","1","2","0","3","2","0","2","0","4","3","0","1","0","0","4"
"San Fernando","16.61591","120.31663","4","0","0","0","0","0","0","4","0","1","2","0","3","2","0","2","0","4","3","0","1","0","0","4"
"San Fernando","15.03425","120.68445","4","0","0","0","0","0","0","4","0","1","2","0","3","2","0","2","0","4","3","0","1","0","0","4"
"San Fernando","16.3892","121.1324","4","0","0","0","0","0","0","4","0","1","2","0","3","2","0","2","0","4","3","0","1","0","0","4"
"San Fernando","12.30364","122.60041","4","0","0","0","0","0","0","4","0","1","2","0","3","2","0","2","0","4","3","0","1","0","0","4"
"San Fernando","10.709","123.0695","4","0","0","0","0","0","0","4","0","1","2","0","3","2","0","2","0","4","3","0","1","0","0","4"
"San Fernando","13.5656","123.1453","4","0","0","0","0","0","0","4","0","1","2","0","3","2","0","2","0","4","3","0","1","0","0","4"
"San Fernando","11.4585","123.2499","4","0","0","0","0","0","0","4","0","1","2","0","3","2","0","2","0","4","3","0","1","0","0","4"
"San Fernando","10.1624","123.7076","4","0","0","0","0","0","0","4","0","1","2","0","3","2","0","2","0","4","3","0","1","0","0","4"
"San Fernando","12.4833","123.7622","4","0","0","0","0","0","0","4","0","1","2","0","3","2","0","2","0","4","3","0","1","0","0","4"
"San Francisco","37.77493","-122.41942","13","1","0","1","0","0","1","16","3","4","1","0","8","4","2","9","1","16","1","2","13","0","0","16"
"San Francisco","27.645","-113.41917","13","1","0","1","0","0","1","16","3","4","1","0","8","4","2","9","1","16","1","2","13","0","0","16"
"San Francisco","20.90196","-105.41279","13","1","0","1","0","0","1","16","3","4","1","0","8","4","2","9","1","16","1","2","13","0","0","16"
"San Francisco","22.28809","-104.49941","13","1","0","1","0","0","1","16","3","4","1","0","8","4","2","9","1","16","1","2","13","0","0","16"
"San Francisco","19.71806","-103.1937","13","1","0","1","0","0","1","16","3","4","1","0","8","4","2","9","1","16","1","2","13","0","0","16"
"San Francisco","17.97526","-102.12986","13","1","0","1","0","0","1","16","3","4","1","0","8","4","2","9","1","16","1","2","13","0","0","16"
"San Francisco","23.00083","-101.93125","13","1","0","1","0","0","1","16","3","4","1","0","8","4","2","9","1","16","1","2","13","0","0","16"
"San Francisco","21.99897","-101.15915","13","1","0","1","0","0","1","16","3","4","1","0","8","4","2","9","1","16","1","2","13","0","0","16"
"San Francisco","21.63387","-101.05884","13","1","0","1","0","0","1","16","3","4","1","0","8","4","2","9","1","16","1","2","13","0","0","16"
"San Francisco","20.58139","-100.13444","13","1","0","1","0","0","1","16","3","4","1","0","8","4","2","9","1","16","1","2","13","0","0","16"
"San Francisco","20.35342","-99.95854","13","1","0","1","0","0","1","16","3","4","1","0","8","4","2","9","1","16","1","2","13","0","0","16"
"San Francisco","18.90788","-99.9292","13","1","0","1","0","0","1","16","3","4","1","0","8","4","2","9","1","16","1","2","13","0","0","16"
"San Francisco","22.07479","-99.86001","13","1","0","1","0","0","1","16","3","4","1","0","8","4","2","9","1","16","1","2","13","0","0","16"
"San Francisco","20.4741","-99.73273","13","1","0","1","0","0","1","16","3","4","1","0","8","4","2","9","1","16","1","2","13","0","0","16"
"San Francisco","18.94931","-99.64723","13","1","0","1","0","0","1","16","3","4","1","0","8","4","2","9","1","16","1","2","13","0","0","16"
"San Francisco","17.00583","-99.28306","13","1","0","1","0","0","1","16","3","4","1","0","8","4","2","9","1","16","1","2","13","0","0","16"
"San Francisco","21.27958","-98.89056","13","1","0","1","0","0","1","16","3","4","1","0","8","4","2","9","1","16","1","2","13","0","0","16"
"San Francisco","21.01819","-98.48699","13","1","0","1","0","0","1","16","3","4","1","0","8","4","2","9","1","16","1","2","13","0","0","16"
"San Francisco","20.55254","-98.00209","13","1","0","1","0","0","1","16","3","4","1","0","8","4","2","9","1","16","1","2","13","0","0","16"
"San Francisco","21.2888","-97.95316","13","1","0","1","0","0","1","16","3","4","1","0","8","4","2","9","1","16","1","2","13","0","0","16"
"San Francisco","19.77722","-97.32806","13","1","0","1","0","0","1","16","3","4","1","0","8","4","2","9","1","16","1","2","13","0","0","16"
"San Francisco","16.60282","-91.7353","13","1","0","1","0","0","1","16","3","4","1","0","8","4","2","9","1","16","1","2","13","0","0","16"
"San Francisco","16.8","-89.93333","13","1","0","1","0","0","1","16","3","4","1","0","8","4","2","9","1","16","1","2","13","0","0","16"
"San Francisco","13.7","-88.1","13","1","0","1","0","0","1","16","3","4","1","0","8","4","2","9","1","16","1","2","13","0","0","16"
"San Francisco","20.82084","-87.50361","13","1","0","1","0","0","1","16","3","4","1","0","8","4","2","9","1","16","1","2","13","0","0","16"
"San Francisco","12.82613","-87.44557","13","1","0","1","0","0","1","16","3","4","1","0","8","4","2","9","1","16","1","2","13","0","0","16"
"San Francisco","15.65","-87.05","13","1","0","1","0","0","1","16","3","4","1","0","8","4","2","9","1","16","1","2","13","0","0","16"
"San Francisco","13.36667","-86.9","13","1","0","1","0","0","1","16","3","4","1","0","8","4","2","9","1","16","1","2","13","0","0","16"
"San Francisco","9.99299","-84.12934","13","1","0","1","0","0","1","16","3","4","1","0","8","4","2","9","1","16","1","2","13","0","0","16"
"San Francisco","8.63374","-82.72862","13","1","0","1","0","0","1","16","3","4","1","0","8","4","2","9","1","16","1","2","13","0","0","16"
"San Francisco","8.06667","-81.36667","13","1","0","1","0","0","1","16","3","4","1","0","8","4","2","9","1","16","1","2","13","0","0","16"
"San Francisco","8.24652","-80.97472","13","1","0","1","0","0","1","16","3","4","1","0","8","4","2","9","1","16","1","2","13","0","0","16"
"San Francisco","1.17644","-76.87838","13","1","0","1","0","0","1","16","3","4","1","0","8","4","2","9","1","16","1","2","13","0","0","16"
"San Francisco","6.11667","-75.98333","13","1","0","1","0","0","1","16","3","4","1","0","8","4","2","9","1","16","1","2","13","0","0","16"
"San Francisco","5.96426","-75.10165","13","1","0","1","0","0","1","16","3","4","1","0","8","4","2","9","1","16","1","2","13","0","0","16"
"San Francisco","4.97876","-74.2927","13","1","0","1","0","0","1","16","3","4","1","0","8","4","2","9","1","16","1","2","13","0","0","16"
"San Francisco","-12.6","-73.81667","13","1","0","1","0","0","1","16","3","4","1","0","8","4","2","9","1","16","1","2","13","0","0","16"
"San Francisco","10.55363","-71.70364","13","1","0","1","0","0","1","16","3","4","1","0","8","4","2","9","1","16","1","2","13","0","0","16"
"San Francisco","-20.71667","-64.7","13","1","0","1","0","0","1","16","3","4","1","0","8","4","2","9","1","16","1","2","13","0","0","16"
"San Francisco","-31.42797","-62.08266","13","1","0","1","0","0","1","16","3","4","1","0","8","4","2","9","1","16","1","2","13","0","0","16"
"San Francisco","15.6289","120.43637","13","1","0","1","0","0","1","16","3","4","1","0","8","4","2","9","1","16","1","2","13","0","0","16"
"San Francisco","14.96154","120.54526","13","1","0","1","0","0","1","16","3","4","1","0","8","4","2","9","1","16","1","2","13","0","0","16"
"San Francisco","15.35566","120.84001","13","1","0","1","0","0","1","16","3","4","1","0","8","4","2","9","1","16","1","2","13","0","0","16"
"San Francisco","13.89806","121.24806","13","1","0","1","0","0","1","16","3","4","1","0","8","4","2","9","1","16","1","2","13","0","0","16"
"San Francisco","11.31961","122.05051","13","1","0","1","0","0","1","16","3","4","1","0","8","4","2","9","1","16","1","2","13","0","0","16"
"San Francisco","13.7911","122.2876","13","1","0","1","0","0","1","16","3","4","1","0","8","4","2","9","1","16","1","2","13","0","0","16"
"San Francisco","13.31667","123.75","13","1","0","1","0","0","1","16","3","4","1","0","8","4","2","9","1","16","1","2","13","0","0","16"
"San Francisco","13.0367","123.7832","13","1","0","1","0","0","1","16","3","4","1","0","8","4","2","9","1","16","1","2","13","0","0","16"
"San Francisco","12.72472","123.90639","13","1","0","1","0","0","1","16","3","4","1","0","8","4","2","9","1","16","1","2","13","0","0","16"
"San Francisco","10.16018","124.31098","13","1","0","1","0","0","1","16","3","4","1","0","8","4","2","9","1","16","1","2","13","0","0","16"
"San Francisco","10.6461","124.3816","13","1","0","1","0","0","1","16","3","4","1","0","8","4","2","9","1","16","1","2","13","0","0","16"
"San Francisco","10.06","125.16056","13","1","0","1","0","0","1","16","3","4","1","0","8","4","2","9","1","16","1","2","13","0","0","16"
"San Francisco","9.77694","125.42472","13","1","0","1","0","0","1","16","3","4","1","0","8","4","2","9","1","16","1","2","13","0","0","16"
"San Francisco","9.52806","125.48556","13","1","0","1","0","0","1","16","3","4","1","0","8","4","2","9","1","16","1","2","13","0","0","16"
"San Francisco","8.53556","125.95","13","1","0","1","0","0","1","16","3","4","1","0","8","4","2","9","1","16","1","2","13","0","0","16"
"San Francisco de Macorís","19.30099","-70.25259","1","0","0","0","0","0","0","1","0","1","0","0","1","0","1","0","0","1","1","0","0","0","0","1"
"Sanghar","26.04694","68.94917","3","0","0","0","0","0","0","3","0","2","0","0","2","2","0","1","0","3","0","0","1","0","2","3"
"San Ġiljan","35.91839","14.48977","0","1","0","0","0","0","0","1","1","0","0","0","1","0","1","0","0","1","0","0","1","0","0","1"
"San Ignacio","27.28232","-112.89637","1","0","0","0","0","0","0","1","0","0","0","0","0","0","1","0","0","1","1","0","0","0","0","1"
"San Ignacio","30.69695","-110.92207","1","0","0","0","0","0","0","1","0","0","0","0","0","0","1","0","0","1","1","0","0","0","0","1"
"San Ignacio","23.94105","-106.42467","1","0","0","0","0","0","0","1","0","0","0","0","0","0","1","0","0","1","1","0","0","0","0","1"
"San Ignacio","20.84636","-105.42123","1","0","0","0","0","0","0","1","0","0","0","0","0","0","1","0","0","1","1","0","0","0","0","1"
"San Ignacio","27.74812","-105.18702","1","0","0","0","0","0","0","1","0","0","0","0","0","0","1","0","0","1","1","0","0","0","0","1"
"San Ignacio","25.73643","-103.09049","1","0","0","0","0","0","0","1","0","0","0","0","0","0","1","0","0","1","1","0","0","0","0","1"
"San Ignacio","23.327","-102.99531","1","0","0","0","0","0","0","1","0","0","0","0","0","0","1","0","0","1","1","0","0","0","0","1"
"San Ignacio","21.89269","-102.33974","1","0","0","0","0","0","0","1","0","0","0","0","0","0","1","0","0","1","1","0","0","0","0","1"
"San Ignacio","20.91491","-101.35889","1","0","0","0","0","0","0","1","0","0","0","0","0","0","1","0","0","1","1","0","0","0","0","1"
"San Ignacio","21.28194","-100.53722","1","0","0","0","0","0","0","1","0","0","0","0","0","0","1","0","0","1","1","0","0","0","0","1"
"San Ignacio","23.19071","-100.17849","1","0","0","0","0","0","0","1","0","0","0","0","0","0","1","0","0","1","1","0","0","0","0","1"
"San Ignacio","21.15988","-89.6559","1","0","0","0","0","0","0","1","0","0","0","0","0","0","1","0","0","1","1","0","0","0","0","1"
"San Ignacio","17.1588","-89.0696","1","0","0","0","0","0","0","1","0","0","0","0","0","0","1","0","0","1","1","0","0","0","0","1"
"San Ignacio","14.65","-87.03333","1","0","0","0","0","0","0","1","0","0","0","0","0","0","1","0","0","1","1","0","0","0","0","1"
"San Ignacio","9.79853","-84.16173","1","0","0","0","0","0","0","1","0","0","0","0","0","0","1","0","0","1","1","0","0","0","0","1"
"San Ignacio","-5.14583","-79.00139","1","0","0","0","0","0","0","1","0","0","0","0","0","0","1","0","0","1","1","0","0","0","0","1"
"San Ignacio","-27.25586","-55.5339","1","0","0","0","0","0","0","1","0","0","0","0","0","0","1","0","0","1","1","0","0","0","0","1"
"San Ignacio","7.1189","126.48838","1","0","0","0","0","0","0","1","0","0","0","0","0","0","1","0","0","1","1","0","0","0","0","1"
"San Isidro","25.97722","-109.25111","1","0","0","0","0","0","0","1","1","0","0","0","1","0","1","0","0","1","0","0","1","0","0","1"
"San Isidro","25.42868","-108.11596","1","0","0","0","0","0","0","1","1","0","0","0","1","0","1","0","0","1","0","0","1","0","0","1"
"San Isidro","31.54683","-106.27868","1","0","0","0","0","0","0","1","1","0","0","0","1","0","1","0","0","1","0","0","1","0","0","1"
"San Isidro","20.79111","-103.35111","1","0","0","0","0","0","0","1","1","0","0","0","1","0","1","0","0","1","0","0","1","0","0","1"
"San Isidro","25.36722","-103.33722","1","0","0","0","0","0","0","1","1","0","0","0","1","0","1","0","0","1","0","0","1","0","0","1"
"San Isidro","20.57256","-102.71649","1","0","0","0","0","0","0","1","1","0","0","0","1","0","1","0","0","1","0","0","1","0","0","1"
"San Isidro","19.73934","-102.29717","1","0","0","0","0","0","0","1","1","0","0","0","1","0","1","0","0","1","0","0","1","0","0","1"
"San Isidro","19.64254","-101.82886","1","0","0","0","0","0","0","1","1","0","0","0","1","0","1","0","0","1","0","0","1","0","0","1"
"San Isidro","19.8496","-101.5683","1","0","0","0","0","0","0","1","1","0","0","0","1","0","1","0","0","1","0","0","1","0","0","1"
"San Isidro","20.46353","-101.49447","1","0","0","0","0","0","0","1","1","0","0","0","1","0","1","0","0","1","0","0","1","0","0","1"
"San Isidro","20.95306","-101.27028","1","0","0","0","0","0","0","1","1","0","0","0","1","0","1","0","0","1","0","0","1","0","0","1"
"San Isidro","20.29181","-100.8851","1","0","0","0","0","0","0","1","1","0","0","0","1","0","1","0","0","1","0","0","1","0","0","1"
"San Isidro","23.866","-100.77506","1","0","0","0","0","0","0","1","1","0","0","0","1","0","1","0","0","1","0","0","1","0","0","1"
"San Isidro","21.37235","-100.54785","1","0","0","0","0","0","0","1","1","0","0","0","1","0","1","0","0","1","0","0","1","0","0","1"
"San Isidro","19.76806","-100.20361","1","0","0","0","0","0","0","1","1","0","0","0","1","0","1","0","0","1","0","0","1","0","0","1"
"San Isidro","19.39243","-100.0929","1","0","0","0","0","0","0","1","1","0","0","0","1","0","1","0","0","1","0","0","1","0","0","1"
"San Isidro","25.67367","-99.7566","1","0","0","0","0","0","0","1","1","0","0","0","1","0","1","0","0","1","0","0","1","0","0","1"
"San Isidro","20.54611","-99.32361","1","0","0","0","0","0","0","1","1","0","0","0","1","0","1","0","0","1","0","0","1","0","0","1"
"San Isidro","18.82194","-99.09389","1","0","0","0","0","0","0","1","1","0","0","0","1","0","1","0","0","1","0","0","1","0","0","1"
"San Isidro","21.52389","-99.03944","1","0","0","0","0","0","0","1","1","0","0","0","1","0","1","0","0","1","0","0","1","0","0","1"
"San Isidro","19.33972","-98.95056","1","0","0","0","0","0","0","1","1","0","0","0","1","0","1","0","0","1","0","0","1","0","0","1"
"San Isidro","19.78927","-98.59141","1","0","0","0","0","0","0","1","1","0","0","0","1","0","1","0","0","1","0","0","1","0","0","1"
"San Isidro","21.01861","-98.43167","1","0","0","0","0","0","0","1","1","0","0","0","1","0","1","0","0","1","0","0","1","0","0","1"
"San Isidro","20.25007","-97.9613","1","0","0","0","0","0","0","1","1","0","0","0","1","0","1","0","0","1","0","0","1","0","0","1"
"San Isidro","17.21667","-97.57139","1","0","0","0","0","0","0","1","1","0","0","0","1","0","1","0","0","1","0","0","1","0","0","1"
"San Isidro","19.79639","-97.38361","1","0","0","0","0","0","0","1","1","0","0","0","1","0","1","0","0","1","0","0","1","0","0","1"
"San Isidro","19.96452","-97.22581","1","0","0","0","0","0","0","1","1","0","0","0","1","0","1","0","0","1","0","0","1","0","0","1"
"San Isidro","19.35483","-97.17585","1","0","0","0","0","0","0","1","1","0","0","0","1","0","1","0","0","1","0","0","1","0","0","1"
"San Isidro","18.89111","-97.12583","1","0","0","0","0","0","0","1","1","0","0","0","1","0","1","0","0","1","0","0","1","0","0","1"
"San Isidro","17.19389","-96.82833","1","0","0","0","0","0","0","1","1","0","0","0","1","0","1","0","0","1","0","0","1","0","0","1"
"San Isidro","18.04472","-96.75944","1","0","0","0","0","0","0","1","1","0","0","0","1","0","1","0","0","1","0","0","1","0","0","1"
"San Isidro","19.48251","-96.37946","1","0","0","0","0","0","0","1","1","0","0","0","1","0","1","0","0","1","0","0","1","0","0","1"
"San Isidro","18.15056","-96.19029","1","0","0","0","0","0","0","1","1","0","0","0","1","0","1","0","0","1","0","0","1","0","0","1"
"San Isidro","18.25806","-95.98583","1","0","0","0","0","0","0","1","1","0","0","0","1","0","1","0","0","1","0","0","1","0","0","1"
"San Isidro","15.74373","-93.35276","1","0","0","0","0","0","0","1","1","0","0","0","1","0","1","0","0","1","0","0","1","0","0","1"
"San Isidro","16.32944","-91.64056","1","0","0","0","0","0","0","1","1","0","0","0","1","0","1","0","0","1","0","0","1","0","0","1"
"San Isidro","18.63384","-91.05024","1","0","0","0","0","0","0","1","1","0","0","0","1","0","1","0","0","1","0","0","1","0","0","1"
"San Isidro","12.92957","-86.19521","1","0","0","0","0","0","0","1","1","0","0","0","1","0","1","0","0","1","0","0","1","0","0","1"
"San Isidro","9.3674","-83.69713","1","0","0","0","0","0","0","1","1","0","0","0","1","0","1","0","0","1","0","0","1","0","0","1"
"San Isidro","8.53032","-82.8272","1","0","0","0","0","0","0","1","1","0","0","0","1","0","1","0","0","1","0","0","1","0","0","1"
"San Isidro","-12.11667","-77.05","1","0","0","0","0","0","0","1","1","0","0","0","1","0","1","0","0","1","0","0","1","0","0","1"
"San Isidro","18.39217","-65.88544","1","0","0","0","0","0","0","1","1","0","0","0","1","0","1","0","0","1","0","0","1","0","0","1"
"San Isidro","-28.46265","-65.72585","1","0","0","0","0","0","0","1","1","0","0","0","1","0","1","0","0","1","0","0","1","0","0","1"
"San Isidro","-34.4721","-58.52708","1","0","0","0","0","0","0","1","1","0","0","0","1","0","1","0","0","1","0","0","1","0","0","1"
"San Isidro","28.07617","-16.558","1","0","0","0","0","0","0","1","1","0","0","0","1","0","1","0","0","1","0","0","1","0","0","1"
"San Isidro","38.17249","-0.83874","1","0","0","0","0","0","0","1","1","0","0","0","1","0","1","0","0","1","0","0","1","0","0","1"
"San Isidro","17.465","120.6035","1","0","0","0","0","0","0","1","1","0","0","0","1","0","1","0","0","1","0","0","1","0","0","1"
"San Isidro","15.23507","120.64134","1","0","0","0","0","0","0","1","1","0","0","0","1","0","1","0","0","1","0","0","1","0","0","1"
"San Isidro","15.4425","120.72565","1","0","0","0","0","0","0","1","1","0","0","0","1","0","1","0","0","1","0","0","1","0","0","1"
"San Isidro","15.02116","120.82019","1","0","0","0","0","0","0","1","1","0","0","0","1","0","1","0","0","1","0","0","1","0","0","1"
"San Isidro","14.03353","121.1095","1","0","0","0","0","0","0","1","1","0","0","0","1","0","1","0","0","1","0","0","1","0","0","1"
"San Isidro","13.7686","121.2308","1","0","0","0","0","0","0","1","1","0","0","0","1","0","1","0","0","1","0","0","1","0","0","1"
"San Isidro","14.2086","121.3983","1","0","0","0","0","0","0","1","1","0","0","0","1","0","1","0","0","1","0","0","1","0","0","1"
"San Isidro","16.73333","121.61667","1","0","0","0","0","0","0","1","1","0","0","0","1","0","1","0","0","1","0","0","1","0","0","1"
"San Isidro","13.6325","122.2428","1","0","0","0","0","0","0","1","1","0","0","0","1","0","1","0","0","1","0","0","1","0","0","1"
"San Isidro","10.5508","123.7335","1","0","0","0","0","0","0","1","1","0","0","0","1","0","1","0","0","1","0","0","1","0","0","1"
"San Isidro","12.97417","123.85722","1","0","0","0","0","0","0","1","1","0","0","0","1","0","1","0","0","1","0","0","1","0","0","1"
"San Isidro","9.91667","123.88333","1","0","0","0","0","0","0","1","1","0","0","0","1","0","1","0","0","1","0","0","1","0","0","1"
"San Isidro","9.7712","124.2527","1","0","0","0","0","0","0","1","1","0","0","0","1","0","1","0","0","1","0","0","1","0","0","1"
"San Isidro","12.38806","124.33139","1","0","0","0","0","0","0","1","1","0","0","0","1","0","1","0","0","1","0","0","1","0","0","1"
"San Isidro","11.4062","124.3521","1","0","0","0","0","0","0","1","1","0","0","0","1","0","1","0","0","1","0","0","1","0","0","1"
"San Isidro","10.9629","124.4304","1","0","0","0","0","0","0","1","1","0","0","0","1","0","1","0","0","1","0","0","1","0","0","1"
"San Isidro","8.25833","124.59306","1","0","0","0","0","0","0","1","1","0","0","0","1","0","1","0","0","1","0","0","1","0","0","1"
"San Isidro","9.93694","126.08861","1","0","0","0","0","0","0","1","1","0","0","0","1","0","1","0","0","1","0","0","1","0","0","1"
"San Jerónimo","23.81086","-105.5453","1","0","0","0","0","0","0","1","0","1","0","0","1","0","0","1","0","1","1","0","0","0","0","1"
"San Jerónimo","22.65402","-102.49182","1","0","0","0","0","0","0","1","0","1","0","0","1","0","0","1","0","1","1","0","0","0","0","1"
"San Jerónimo","20.39856","-102.33957","1","0","0","0","0","0","0","1","0","1","0","0","1","0","0","1","0","1","1","0","0","0","0","1"
"San Jerónimo","20.99083","-101.87528","1","0","0","0","0","0","0","1","0","1","0","0","1","0","0","1","0","1","1","0","0","0","0","1"
"San Jerónimo","18.53297","-101.32654","1","0","0","0","0","0","0","1","0","1","0","0","1","0","0","1","0","1","1","0","0","0","0","1"
"San Jerónimo","18.38056","-100.67194","1","0","0","0","0","0","0","1","0","1","0","0","1","0","0","1","0","1","1","0","0","0","0","1"
"San Jerónimo","19.24255","-100.02224","1","0","0","0","0","0","0","1","0","1","0","0","1","0","0","1","0","1","1","0","0","0","0","1"
"San Jerónimo","19.28279","-99.5929","1","0","0","0","0","0","0","1","0","1","0","0","1","0","0","1","0","1","1","0","0","0","0","1"
"San Jerónimo","20.23467","-98.84643","1","0","0","0","0","0","0","1","0","1","0","0","1","0","0","1","0","1","1","0","0","0","0","1"
"San Jerónimo","16.87778","-98.36111","1","0","0","0","0","0","0","1","0","1","0","0","1","0","0","1","0","1","1","0","0","0","0","1"
"San Jerónimo","17.98463","-95.7006","1","0","0","0","0","0","0","1","0","1","0","0","1","0","0","1","0","1","1","0","0","0","0","1"
"San Jerónimo","15.04143","-92.13752","1","0","0","0","0","0","0","1","0","1","0","0","1","0","0","1","0","1","1","0","0","0","0","1"
"San Jerónimo","15.06032","-90.2405","1","0","0","0","0","0","0","1","0","1","0","0","1","0","0","1","0","1","1","0","0","0","0","1"
"San Jerónimo","14.96667","-88.86667","1","0","0","0","0","0","0","1","0","1","0","0","1","0","0","1","0","1","1","0","0","0","0","1"
"San Jerónimo","14.63333","-87.6","1","0","0","0","0","0","0","1","0","1","0","0","1","0","0","1","0","1","1","0","0","0","0","1"
"San Jerónimo","13.17667","-87.13639","1","0","0","0","0","0","0","1","0","1","0","0","1","0","0","1","0","1","1","0","0","0","0","1"
"San Jerónimo","6.44344","-75.72815","1","0","0","0","0","0","0","1","0","1","0","0","1","0","0","1","0","1","1","0","0","0","0","1"
"San Jerónimo","-11.95591","-75.28411","1","0","0","0","0","0","0","1","0","1","0","0","1","0","0","1","0","1","1","0","0","0","0","1"
"San Jerónimo","-13.65138","-73.36388","1","0","0","0","0","0","0","1","0","1","0","0","1","0","0","1","0","1","1","0","0","0","0","1"
"San Jose","37.33939","-121.89496","5","0","0","0","0","0","0","5","2","1","0","0","3","1","1","3","0","5","2","0","3","0","0","5"
"San Jose","32.82007","-109.59202","5","0","0","0","0","0","0","5","2","1","0","0","3","1","1","3","0","5","2","0","3","0","0","5"
"San Jose","36.03919","-106.09808","5","0","0","0","0","0","0","5","2","1","0","0","3","1","1","3","0","5","2","0","3","0","0","5"
"San Jose","40.3056","-89.60288","5","0","0","0","0","0","0","5","2","1","0","0","3","1","1","3","0","5","2","0","3","0","0","5"
"San Jose","9.80056","118.75694","5","0","0","0","0","0","0","5","2","1","0","0","3","1","1","3","0","5","2","0","3","0","0","5"
"San Jose","15.0333","120.7833","5","0","0","0","0","0","0","5","2","1","0","0","3","1","1","3","0","5","2","0","3","0","0","5"
"San Jose","13.85209","120.94951","5","0","0","0","0","0","0","5","2","1","0","0","3","1","1","3","0","5","2","0","3","0","0","5"
"San Jose","12.35275","121.06761","5","0","0","0","0","0","0","5","2","1","0","0","3","1","1","3","0","5","2","0","3","0","0","5"
"San Jose","13.8784","121.1045","5","0","0","0","0","0","0","5","2","1","0","0","3","1","1","3","0","5","2","0","3","0","0","5"
"San Jose","17.15","121.6","5","0","0","0","0","0","0","5","2","1","0","0","3","1","1","3","0","5","2","0","3","0","0","5"
"San Jose","17.89269","121.87125","5","0","0","0","0","0","0","5","2","1","0","0","3","1","1","3","0","5","2","0","3","0","0","5"
"San Jose","10.745","121.9415","5","0","0","0","0","0","0","5","2","1","0","0","3","1","1","3","0","5","2","0","3","0","0","5"
"San Jose","10.77028","122.53389","5","0","0","0","0","0","0","5","2","1","0","0","3","1","1","3","0","5","2","0","3","0","0","5"
"San Jose","9.41194","123.23806","5","0","0","0","0","0","0","5","2","1","0","0","3","1","1","3","0","5","2","0","3","0","0","5"
"San Jose","13.24629","123.37136","5","0","0","0","0","0","0","5","2","1","0","0","3","1","1","3","0","5","2","0","3","0","0","5"
"San Jose","13.6993","123.5178","5","0","0","0","0","0","0","5","2","1","0","0","3","1","1","3","0","5","2","0","3","0","0","5"
"San Jose","13.35","123.55","5","0","0","0","0","0","0","5","2","1","0","0","3","1","1","3","0","5","2","0","3","0","0","5"
"San Jose","12.5296","124.4875","5","0","0","0","0","0","0","5","2","1","0","0","3","1","1","3","0","5","2","0","3","0","0","5"
"San Jose","10.98889","125.03528","5","0","0","0","0","0","0","5","2","1","0","0","3","1","1","3","0","5","2","0","3","0","0","5"
"San Jose","7.73667","125.07028","5","0","0","0","0","0","0","5","2","1","0","0","3","1","1","3","0","5","2","0","3","0","0","5"
"San Jose","10.18","125.56833","5","0","0","0","0","0","0","5","2","1","0","0","3","1","1","3","0","5","2","0","3","0","0","5"
"San José","19.00777","-99.66345","2","0","0","0","0","0","1","3","1","1","0","0","2","1","1","1","0","3","2","1","0","0","0","3"
"San José","17.27639","-99.11417","2","0","0","0","0","0","1","3","1","1","0","0","2","1","1","1","0","3","2","1","0","0","0","3"
"San José","19.65949","-98.90973","2","0","0","0","0","0","1","3","1","1","0","0","2","1","1","1","0","3","2","1","0","0","0","3"
"San José","21.06917","-98.59444","2","0","0","0","0","0","1","3","1","1","0","0","2","1","1","1","0","3","2","1","0","0","0","3"
"San José","20.56389","-97.70139","2","0","0","0","0","0","1","3","1","1","0","0","2","1","1","1","0","3","2","1","0","0","0","3"
"San José","16.50936","-97.458","2","0","0","0","0","0","1","3","1","1","0","0","2","1","1","1","0","3","2","1","0","0","0","3"
"San José","19.80306","-97.33389","2","0","0","0","0","0","1","3","1","1","0","0","2","1","1","1","0","3","2","1","0","0","0","3"
"San José","18.24556","-92.30833","2","0","0","0","0","0","1","3","1","1","0","0","2","1","1","1","0","3","2","1","0","0","0","3"
"San José","16.71056","-91.39694","2","0","0","0","0","0","1","3","1","1","0","0","2","1","1","1","0","3","2","1","0","0","0","3"
"San José","16.98333","-89.9","2","0","0","0","0","0","1","3","1","1","0","0","2","1","1","1","0","3","2","1","0","0","0","3"
"San José","14.25","-87.95","2","0","0","0","0","0","1","3","1","1","0","0","2","1","1","1","0","3","2","1","0","0","0","3"
"San José","15.31667","-87.16667","2","0","0","0","0","0","1","3","1","1","0","0","2","1","1","1","0","3","2","1","0","0","0","3"
"San José","10.95173","-85.1361","2","0","0","0","0","0","1","3","1","1","0","0","2","1","1","1","0","3","2","1","0","0","0","3"
"San José","9.93333","-84.08333","2","0","0","0","0","0","1","3","1","1","0","0","2","1","1","1","0","3","2","1","0","0","0","3"
"San José","8.37261","-81.40486","2","0","0","0","0","0","1","3","1","1","0","0","2","1","1","1","0","3","2","1","0","0","0","3"
"San José","7.95188","-80.84757","2","0","0","0","0","0","1","3","1","1","0","0","2","1","1","1","0","3","2","1","0","0","0","3"
"San José","8.46704","-80.80514","2","0","0","0","0","0","1","3","1","1","0","0","2","1","1","1","0","3","2","1","0","0","0","3"
"San José","7.67395","-80.24438","2","0","0","0","0","0","1","3","1","1","0","0","2","1","1","1","0","3","2","1","0","0","0","3"
"San José","8.5324","-79.93089","2","0","0","0","0","0","1","3","1","1","0","0","2","1","1","1","0","3","2","1","0","0","0","3"
"San José","-6.73813","-79.8275","2","0","0","0","0","0","1","3","1","1","0","0","2","1","1","1","0","3","2","1","0","0","0","3"
"San José","8.93333","-79.73333","2","0","0","0","0","0","1","3","1","1","0","0","2","1","1","1","0","3","2","1","0","0","0","3"
"San José","1.69659","-78.24482","2","0","0","0","0","0","1","3","1","1","0","0","2","1","1","1","0","3","2","1","0","0","0","3"
"San José","1.47446","-77.08144","2","0","0","0","0","0","1","3","1","1","0","0","2","1","1","1","0","3","2","1","0","0","0","3"
"San José","5.08221","-75.79107","2","0","0","0","0","0","1","3","1","1","0","0","2","1","1","1","0","3","2","1","0","0","0","3"
"San José","18.39828","-66.25572","2","0","0","0","0","0","1","3","1","1","0","0","2","1","1","1","0","3","2","1","0","0","0","3"
"San José","-28.38333","-65.7","2","0","0","0","0","0","1","3","1","1","0","0","2","1","1","1","0","3","2","1","0","0","0","3"
"San José","-25.53333","-56.73333","2","0","0","0","0","0","1","3","1","1","0","0","2","1","1","1","0","3","2","1","0","0","0","3"
"San José","-27.76979","-55.7826","2","0","0","0","0","0","1","3","1","1","0","0","2","1","1","1","0","3","2","1","0","0","0","3"
"San José","36.76048","-2.10912","2","0","0","0","0","0","1","3","1","1","0","0","2","1","1","1","0","3","2","1","0","0","0","3"
"San Jose del Monte","14.81389","121.04528","3","0","0","0","0","0","0","3","1","0","2","0","3","1","0","2","0","3","0","0","3","0","0","3"
"San Juan Capistrano","33.50169","-117.66255","1","0","0","0","0","0","0","1","0","0","0","0","0","1","0","0","0","1","1","0","0","0","0","1"
"San Juan Capistrano","22.64358","-104.10089","1","0","0","0","0","0","0","1","0","0","0","0","0","1","0","0","0","1","1","0","0","0","0","1"
"Sankt Peter-Ording","54.30363","8.64138","1","0","0","0","0","0","0","1","0","1","0","0","1","0","1","0","0","1","1","0","0","0","0","1"
"San Leandro","37.72493","-122.15608","1","0","0","0","0","0","0","1","1","0","0","0","1","1","0","0","0","1","0","0","1","0","0","1"
"Şanlıurfa","37.16708","38.79392","1","0","0","0","0","0","0","1","0","0","0","0","0","0","0","1","0","1","0","0","0","0","1","1"
"San Luis","32.43167","-116.95361","1","0","0","0","0","0","0","1","1","0","0","0","1","0","0","1","0","1","0","0","1","0","0","1"
"San Luis","32.487","-114.78218","1","0","0","0","0","0","0","1","1","0","0","0","1","0","0","1","0","1","0","0","1","0","0","1"
"San Luis","28.43333","-113.75","1","0","0","0","0","0","0","1","1","0","0","0","1","0","0","1","0","1","0","0","1","0","0","1"
"San Luis","37.20085","-105.4239","1","0","0","0","0","0","0","1","1","0","0","0","1","0","0","1","0","1","0","0","1","0","0","1"
"San Luis","16.19889","-89.44028","1","0","0","0","0","0","0","1","1","0","0","0","1","0","0","1","0","1","0","0","1","0","0","1"
"San Luis","15.08333","-88.38333","1","0","0","0","0","0","0","1","1","0","0","0","1","0","0","1","0","1","0","0","1","0","0","1"
"San Luis","14.75","-87.41667","1","0","0","0","0","0","0","1","1","0","0","0","1","0","0","1","0","1","0","0","1","0","0","1"
"San Luis","22.27898","-83.75956","1","0","0","0","0","0","0","1","1","0","0","0","1","0","0","1","0","1","0","0","1","0","0","1"
"San Luis","-9.08333","-77.35","1","0","0","0","0","0","0","1","1","0","0","0","1","0","0","1","0","1","0","0","1","0","0","1"
"San Luis","-12.07674","-76.99435","1","0","0","0","0","0","0","1","1","0","0","0","1","0","0","1","0","1","0","0","1","0","0","1"
"San Luis","20.18809","-75.85031","1","0","0","0","0","0","0","1","1","0","0","0","1","0","0","1","0","1","0","0","1","0","0","1"
"San Luis","4.13258","-75.09499","1","0","0","0","0","0","0","1","1","0","0","0","1","0","0","1","0","1","0","0","1","0","0","1"
"San Luis","6.04343","-74.99366","1","0","0","0","0","0","0","1","1","0","0","0","1","0","0","1","0","1","0","0","1","0","0","1"
"San Luis","11.12034","-69.68397","1","0","0","0","0","0","0","1","1","0","0","0","1","0","0","1","0","1","0","0","1","0","0","1"
"San Luis","-33.29501","-66.33563","1","0","0","0","0","0","0","1","1","0","0","0","1","0","0","1","0","1","0","0","1","0","0","1"
"San Luis","15.0401","120.7883","1","0","0","0","0","0","0","1","1","0","0","0","1","0","0","1","0","1","0","0","1","0","0","1"
"San Luis","13.85469","120.91653","1","0","0","0","0","0","0","1","1","0","0","0","1","0","0","1","0","1","0","0","1","0","0","1"
"San Luis","15.7208","121.5205","1","0","0","0","0","0","0","1","1","0","0","0","1","0","0","1","0","1","0","0","1","0","0","1"
"San Luis","16.96455","121.82784","1","0","0","0","0","0","0","1","1","0","0","0","1","0","0","1","0","1","0","0","1","0","0","1"
"San Luis","8.48333","125","1","0","0","0","0","0","0","1","1","0","0","0","1","0","0","1","0","1","0","0","1","0","0","1"
"San Luis","8.47806","125.74389","1","0","0","0","0","0","0","1","1","0","0","0","1","0","0","1","0","1","0","0","1","0","0","1"
"San Luis","7.44139","126.55111","1","0","0","0","0","0","0","1","1","0","0","0","1","0","0","1","0","1","0","0","1","0","0","1"
"San Luis Potosí","32.50957","-115.12771","2","0","0","0","0","0","0","2","0","1","0","1","2","0","2","0","0","2","1","0","0","1","0","2"
"San Luis Potosí","22.14982","-100.97916","2","0","0","0","0","0","0","2","0","1","0","1","2","0","2","0","0","2","1","0","0","1","0","2"
"San Luis Potosí","16.6036","-91.64599","2","0","0","0","0","0","0","2","0","1","0","1","2","0","2","0","0","2","1","0","0","1","0","2"
"San Pablo","37.96215","-122.34553","1","0","0","0","0","0","0","1","1","0","0","0","1","0","1","0","0","1","0","0","1","0","0","1"
"San Pablo","26.05027","-109.2772","1","0","0","0","0","0","0","1","1","0","0","0","1","0","1","0","0","1","0","0","1","0","0","1"
"San Pablo","32.24954","-106.77278","1","0","0","0","0","0","0","1","1","0","0","0","1","0","1","0","0","1","0","0","1","0","0","1"
"San Pablo","25.72842","-103.0746","1","0","0","0","0","0","0","1","1","0","0","0","1","0","1","0","0","1","0","0","1","0","0","1"
"San Pablo","22.55937","-102.0999","1","0","0","0","0","0","0","1","1","0","0","0","1","0","1","0","0","1","0","0","1","0","0","1"
"San Pablo","20.78639","-100.81222","1","0","0","0","0","0","0","1","1","0","0","0","1","0","1","0","0","1","0","0","1","0","0","1"
"San Pablo","21.17684","-100.69564","1","0","0","0","0","0","0","1","1","0","0","0","1","0","1","0","0","1","0","0","1","0","0","1"
"San Pablo","20.20576","-100.53546","1","0","0","0","0","0","0","1","1","0","0","0","1","0","1","0","0","1","0","0","1","0","0","1"
"San Pablo","20.08857","-99.97785","1","0","0","0","0","0","0","1","1","0","0","0","1","0","1","0","0","1","0","0","1","0","0","1"
"San Pablo","20.4626","-97.19125","1","0","0","0","0","0","0","1","1","0","0","0","1","0","1","0","0","1","0","0","1","0","0","1"
"San Pablo","14.93269","-92.00415","1","0","0","0","0","0","0","1","1","0","0","0","1","0","1","0","0","1","0","0","1","0","0","1"
"San Pablo","9.99559","-84.09656","1","0","0","0","0","0","0","1","1","0","0","0","1","0","1","0","0","1","0","0","1","0","0","1"
"San Pablo","9.68323","-84.0405","1","0","0","0","0","0","0","1","1","0","0","0","1","0","1","0","0","1","0","0","1","0","0","1"
"San Pablo","-7.11667","-78.83333","1","0","0","0","0","0","0","1","1","0","0","0","1","0","1","0","0","1","0","0","1","0","0","1"
"San Pablo","1.6725","-77.01389","1","0","0","0","0","0","0","1","1","0","0","0","1","0","1","0","0","1","0","0","1","0","0","1"
"San Pablo","-6.81923","-76.57578","1","0","0","0","0","0","0","1","1","0","0","0","1","0","1","0","0","1","0","0","1","0","0","1"
"San Pablo","10.05154","-75.26775","1","0","0","0","0","0","0","1","1","0","0","0","1","0","1","0","0","1","0","0","1","0","0","1"
"San Pablo","7.47754","-73.92255","1","0","0","0","0","0","0","1","1","0","0","0","1","0","1","0","0","1","0","0","1","0","0","1"
"San Pablo","-14.20278","-71.31556","1","0","0","0","0","0","0","1","1","0","0","0","1","0","1","0","0","1","0","0","1","0","0","1"
"San Pablo","10.24929","-68.84427","1","0","0","0","0","0","0","1","1","0","0","0","1","0","1","0","0","1","0","0","1","0","0","1"
"San Pablo","-16.21667","-68.83333","1","0","0","0","0","0","0","1","1","0","0","0","1","0","1","0","0","1","0","0","1","0","0","1"
"San Pablo","14.0683","121.3256","1","0","0","0","0","0","0","1","1","0","0","0","1","0","1","0","0","1","0","0","1","0","0","1"
"San Pablo","10.91234","123.1418","1","0","0","0","0","0","0","1","1","0","0","0","1","0","1","0","0","1","0","0","1","0","0","1"
"San Pablo","7.65639","123.46083","1","0","0","0","0","0","0","1","1","0","0","0","1","0","1","0","0","1","0","0","1","0","0","1"
"San Pedro","33.73585","-118.29229","1","0","0","0","0","0","0","1","0","1","0","0","1","0","0","1","0","1","1","0","0","0","0","1"
"San Pedro","23.92584","-110.26337","1","0","0","0","0","0","0","1","0","1","0","0","1","0","0","1","0","1","1","0","0","0","0","1"
"San Pedro","26.52294","-108.4729","1","0","0","0","0","0","0","1","0","1","0","0","1","0","0","1","0","1","1","0","0","0","0","1"
"San Pedro","20.8182","-104.06216","1","0","0","0","0","0","0","1","0","1","0","0","1","0","0","1","0","1","1","0","0","0","0","1"
"San Pedro","25.43333","-103.21667","1","0","0","0","0","0","0","1","0","1","0","0","1","0","0","1","0","1","1","0","0","0","0","1"
"San Pedro","25.75602","-102.98385","1","0","0","0","0","0","0","1","0","1","0","0","1","0","0","1","0","1","1","0","0","0","0","1"
"San Pedro","20.32055","-100.28466","1","0","0","0","0","0","0","1","0","1","0","0","1","0","0","1","0","1","1","0","0","0","0","1"
"San Pedro","20.60935","-99.51729","1","0","0","0","0","0","0","1","0","1","0","0","1","0","0","1","0","1","1","0","0","0","0","1"
"San Pedro","25.98175","-97.59638","1","0","0","0","0","0","0","1","0","1","0","0","1","0","0","1","0","1","1","0","0","0","0","1"
"San Pedro","31.47629","-95.37828","1","0","0","0","0","0","0","1","0","1","0","0","1","0","0","1","0","1","1","0","0","0","0","1"
"San Pedro","17.39604","-92.21427","1","0","0","0","0","0","0","1","0","1","0","0","1","0","0","1","0","1","1","0","0","0","0","1"
"San Pedro","17.91598","-87.9659","1","0","0","0","0","0","0","1","0","1","0","0","1","0","0","1","0","1","1","0","0","0","0","1"
"San Pedro","9.92829","-84.05074","1","0","0","0","0","0","0","1","0","1","0","0","1","0","0","1","0","1","1","0","0","0","0","1"
"San Pedro","8.72207","-80.22276","1","0","0","0","0","0","0","1","0","1","0","0","1","0","0","1","0","1","1","0","0","0","0","1"
"San Pedro","3.99445","-76.22885","1","0","0","0","0","0","0","1","0","1","0","0","1","0","0","1","0","1","1","0","0","0","0","1"
"San Pedro","-13.39889","-76.15904","1","0","0","0","0","0","0","1","0","1","0","0","1","0","0","1","0","1","1","0","0","0","0","1"
"San Pedro","6.46135","-75.55778","1","0","0","0","0","0","0","1","0","1","0","0","1","0","0","1","0","1","1","0","0","0","0","1"
"San Pedro","9.3956","-75.06476","1","0","0","0","0","0","0","1","0","1","0","0","1","0","0","1","0","1","1","0","0","0","0","1"
"San Pedro","-14.76667","-74.1","1","0","0","0","0","0","0","1","0","1","0","0","1","0","0","1","0","1","1","0","0","0","0","1"
"San Pedro","-14.18667","-71.34167","1","0","0","0","0","0","0","1","0","1","0","0","1","0","0","1","0","1","1","0","0","0","0","1"
"San Pedro","-16.23717","-68.85063","1","0","0","0","0","0","0","1","0","1","0","0","1","0","0","1","0","1","1","0","0","0","0","1"
"San Pedro","-27.95386","-65.16651","1","0","0","0","0","0","0","1","0","1","0","0","1","0","0","1","0","1","1","0","0","0","0","1"
"San Pedro","-19.61667","-64.5","1","0","0","0","0","0","0","1","0","1","0","0","1","0","0","1","0","1","1","0","0","0","0","1"
"San Pedro","-18.28333","-59.81667","1","0","0","0","0","0","0","1","0","1","0","0","1","0","0","1","0","1","1","0","0","0","0","1"
"San Pedro","-33.67918","-59.66633","1","0","0","0","0","0","0","1","0","1","0","0","1","0","0","1","0","1","1","0","0","0","0","1"
"San Pedro","-26.62207","-54.10842","1","0","0","0","0","0","0","1","0","1","0","0","1","0","0","1","0","1","1","0","0","0","0","1"
"San Pedro","38.82493","-2.18276","1","0","0","0","0","0","0","1","0","1","0","0","1","0","0","1","0","1","1","0","0","0","0","1"
"San Pedro","12.46084","121.01041","1","0","0","0","0","0","0","1","0","1","0","0","1","0","0","1","0","1","1","0","0","0","0","1"
"San Pedro","14.3595","121.0473","1","0","0","0","0","0","0","1","0","1","0","0","1","0","0","1","0","1","1","0","0","0","0","1"
"San Pedro","17.2","121.88333","1","0","0","0","0","0","0","1","0","1","0","0","1","0","0","1","0","1","1","0","0","0","0","1"
"San Pedro","10.8018","121.9499","1","0","0","0","0","0","0","1","0","1","0","0","1","0","0","1","0","1","1","0","0","0","0","1"
"San Pedro","12.01667","124","1","0","0","0","0","0","0","1","0","1","0","0","1","0","0","1","0","1","1","0","0","0","0","1"
"San Pedro","10.961","124.8197","1","0","0","0","0","0","0","1","0","1","0","0","1","0","0","1","0","1","1","0","0","0","0","1"
"San Pedro","7.34194","126.5175","1","0","0","0","0","0","0","1","0","1","0","0","1","0","0","1","0","1","1","0","0","0","0","1"
"San Pedro Garza Garcia","25.65716","-100.40268","1","0","0","0","0","0","0","1","1","0","0","0","1","0","0","1","0","1","1","0","0","0","0","1"
"San Pedro Sula","15.50417","-88.025","5","0","0","0","0","0","0","5","1","1","1","0","3","3","0","2","1","6","2","1","3","0","0","6"
"San Rafael","37.97353","-122.53109","0","0","0","0","1","0","0","1","0","0","0","0","0","1","0","0","0","1","0","0","1","0","0","1"
"San Rafael","31.90167","-116.55361","0","0","0","0","1","0","0","1","0","0","0","0","0","1","0","0","0","1","0","0","1","0","0","1"
"San Rafael","25.4939","-108.30527","0","0","0","0","1","0","0","1","0","0","0","0","0","1","0","0","0","1","0","0","1","0","0","1"
"San Rafael","27.4975","-107.89099","0","0","0","0","1","0","0","1","0","0","0","0","0","1","0","0","0","1","0","0","1","0","0","1"
"San Rafael","35.11254","-107.88256","0","0","0","0","1","0","0","1","0","0","0","0","0","1","0","0","0","1","0","0","1","0","0","1"
"San Rafael","25.0306","-100.55139","0","0","0","0","1","0","0","1","0","0","0","0","0","1","0","0","0","1","0","0","1","0","0","1"
"San Rafael","20.45284","-100.39399","0","0","0","0","1","0","0","1","0","0","0","0","0","1","0","0","0","1","0","0","1","0","0","1"
"San Rafael","21.13285","-100.35487","0","0","0","0","1","0","0","1","0","0","0","0","0","1","0","0","0","1","0","0","1","0","0","1"
"San Rafael","20.75246","-100.28583","0","0","0","0","1","0","0","1","0","0","0","0","0","1","0","0","0","1","0","0","1","0","0","1"
"San Rafael","19.73","-100.22333","0","0","0","0","1","0","0","1","0","0","0","0","0","1","0","0","0","1","0","0","1","0","0","1"
"San Rafael","23.12469","-99.79386","0","0","0","0","1","0","0","1","0","0","0","0","0","1","0","0","0","1","0","0","1","0","0","1"
"San Rafael","21.58894","-99.70832","0","0","0","0","1","0","0","1","0","0","0","0","0","1","0","0","0","1","0","0","1","0","0","1"
"San Rafael","21.11528","-98.9375","0","0","0","0","1","0","0","1","0","0","0","0","0","1","0","0","0","1","0","0","1","0","0","1"
"San Rafael","19.20959","-98.75636","0","0","0","0","1","0","0","1","0","0","0","0","0","1","0","0","0","1","0","0","1","0","0","1"
"San Rafael","17.22667","-98.42417","0","0","0","0","1","0","0","1","0","0","0","0","0","1","0","0","0","1","0","0","1","0","0","1"
"San Rafael","20.18862","-96.86737","0","0","0","0","1","0","0","1","0","0","0","0","0","1","0","0","0","1","0","0","1","0","0","1"
"San Rafael","17.20111","-92.78278","0","0","0","0","1","0","0","1","0","0","0","0","0","1","0","0","0","1","0","0","1","0","0","1"
"San Rafael","20.70323","-90.15843","0","0","0","0","1","0","0","1","0","0","0","0","0","1","0","0","0","1","0","0","1","0","0","1"
"San Rafael","10.06403","-84.47281","0","0","0","0","1","0","0","1","0","0","0","0","0","1","0","0","0","1","0","0","1","0","0","1"
"San Rafael","9.92787","-84.13722","0","0","0","0","1","0","0","1","0","0","0","0","0","1","0","0","0","1","0","0","1","0","0","1"
"San Rafael","10.0132","-84.10016","0","0","0","0","1","0","0","1","0","0","0","0","0","1","0","0","0","1","0","0","1","0","0","1"
"San Rafael","-7.0304","-76.47499","0","0","0","0","1","0","0","1","0","0","0","0","0","1","0","0","0","1","0","0","1","0","0","1"
"San Rafael","-10.33806","-76.18333","0","0","0","0","1","0","0","1","0","0","0","0","0","1","0","0","0","1","0","0","1","0","0","1"
"San Rafael","6.29436","-75.02589","0","0","0","0","1","0","0","1","0","0","0","0","0","1","0","0","0","1","0","0","1","0","0","1"
"San Rafael","-34.61772","-68.33007","0","0","0","0","1","0","0","1","0","0","0","0","0","1","0","0","0","1","0","0","1","0","0","1"
"San Rafael","14.89906","120.69352","0","0","0","0","1","0","0","1","0","0","0","0","0","1","0","0","0","1","0","0","1","0","0","1"
"San Rafael","14.94833","120.96222","0","0","0","0","1","0","0","1","0","0","0","0","0","1","0","0","0","1","0","0","1","0","0","1"
"San Rafael","14.1284","121.4147","0","0","0","0","1","0","0","1","0","0","0","0","0","1","0","0","0","1","0","0","1","0","0","1"
"San Rafael","11.1781","122.8273","0","0","0","0","1","0","0","1","0","0","0","0","0","1","0","0","0","1","0","0","1","0","0","1"
"San Rafael","13.09417","122.96","0","0","0","0","1","0","0","1","0","0","0","0","0","1","0","0","0","1","0","0","1","0","0","1"
"San Rafael","13.21667","123.6","0","0","0","0","1","0","0","1","0","0","0","0","0","1","0","0","0","1","0","0","1","0","0","1"
"San Rafael","12.8905","123.6823","0","0","0","0","1","0","0","1","0","0","0","0","0","1","0","0","0","1","0","0","1","0","0","1"
"San Rafael","7.76389","126.45583","0","0","0","0","1","0","0","1","0","0","0","0","0","1","0","0","0","1","0","0","1","0","0","1"
"San Salvador","20.28583","-99.01457","10","0","0","0","0","0","0","10","2","3","0","0","5","2","1","6","0","9","5","0","4","0","0","9"
"San Salvador","16.97167","-91.87667","10","0","0","0","0","0","0","10","2","3","0","0","5","2","1","6","0","9","5","0","4","0","0","9"
"San Salvador","13.68935","-89.18718","10","0","0","0","0","0","0","10","2","3","0","0","5","2","1","6","0","9","5","0","4","0","0","9"
"San Salvador","-13.49361","-71.77389","10","0","0","0","0","0","0","10","2","3","0","0","5","2","1","6","0","9","5","0","4","0","0","9"
"San Salvador","-31.62487","-58.50524","10","0","0","0","0","0","0","10","2","3","0","0","5","2","1","6","0","9","5","0","4","0","0","9"
"San Salvador","41.6206","-5.08713","10","0","0","0","0","0","0","10","2","3","0","0","5","2","1","6","0","9","5","0","4","0","0","9"
"San Salvador","11.00278","122.83528","10","0","0","0","0","0","0","10","2","3","0","0","5","2","1","6","0","9","5","0","4","0","0","9"
"Santa Ana","33.74557","-117.86783","2","0","0","0","0","0","0","2","0","0","0","0","0","0","1","1","0","2","2","0","0","0","0","2"
"Santa Ana","30.54075","-111.11888","2","0","0","0","0","0","0","2","0","0","0","0","0","0","1","1","0","2","2","0","0","0","0","2"
"Santa Ana","26.58976","-108.3847","2","0","0","0","0","0","0","2","0","0","0","0","0","0","1","1","0","2","2","0","0","0","0","2"
"Santa Ana","21.05917","-101.67583","2","0","0","0","0","0","0","2","0","0","0","0","0","0","1","1","0","2","2","0","0","0","0","2"
"Santa Ana","22.39194","-101.47401","2","0","0","0","0","0","0","2","0","0","0","0","0","0","1","1","0","2","2","0","0","0","0","2"
"Santa Ana","20.37306","-101.1125","2","0","0","0","0","0","0","2","0","0","0","0","0","0","1","1","0","2","2","0","0","0","0","2"
"Santa Ana","19.58222","-100.46889","2","0","0","0","0","0","0","2","0","0","0","0","0","0","1","1","0","2","2","0","0","0","0","2"
"Santa Ana","18.9875","-99.41333","2","0","0","0","0","0","0","2","0","0","0","0","0","0","1","1","0","2","2","0","0","0","0","2"
"Santa Ana","17.57444","-99.22194","2","0","0","0","0","0","0","2","0","0","0","0","0","0","1","1","0","2","2","0","0","0","0","2"
"Santa Ana","19.69667","-97.29222","2","0","0","0","0","0","0","2","0","0","0","0","0","0","1","1","0","2","2","0","0","0","0","2"
"Santa Ana","16.34139","-96.71697","2","0","0","0","0","0","0","2","0","0","0","0","0","0","1","1","0","2","2","0","0","0","0","2"
"Santa Ana","19.89071","-96.50696","2","0","0","0","0","0","0","2","0","0","0","0","0","0","1","1","0","2","2","0","0","0","0","2"
"Santa Ana","17.09528","-96.05472","2","0","0","0","0","0","0","2","0","0","0","0","0","0","1","1","0","2","2","0","0","0","0","2"
"Santa Ana","17.05455","-95.08509","2","0","0","0","0","0","0","2","0","0","0","0","0","0","1","1","0","2","2","0","0","0","0","2"
"Santa Ana","16.80722","-92.73694","2","0","0","0","0","0","0","2","0","0","0","0","0","0","1","1","0","2","2","0","0","0","0","2"
"Santa Ana","16.8","-89.83333","2","0","0","0","0","0","0","2","0","0","0","0","0","0","1","1","0","2","2","0","0","0","0","2"
"Santa Ana","13.99417","-89.55972","2","0","0","0","0","0","0","2","0","0","0","0","0","0","1","1","0","2","2","0","0","0","0","2"
"Santa Ana","13.93167","-87.27139","2","0","0","0","0","0","0","2","0","0","0","0","0","0","1","1","0","2","2","0","0","0","0","2"
"Santa Ana","15.65","-87.06667","2","0","0","0","0","0","0","2","0","0","0","0","0","0","1","1","0","2","2","0","0","0","0","2"
"Santa Ana","9.9326","-84.18255","2","0","0","0","0","0","0","2","0","0","0","0","0","0","1","1","0","2","2","0","0","0","0","2"
"Santa Ana","-1.20726","-80.37132","2","0","0","0","0","0","0","2","0","0","0","0","0","0","1","1","0","2","2","0","0","0","0","2"
"Santa Ana","-13.05","-75.13333","2","0","0","0","0","0","0","2","0","0","0","0","0","0","1","1","0","2","2","0","0","0","0","2"
"Santa Ana","9.32125","-74.56848","2","0","0","0","0","0","0","2","0","0","0","0","0","0","1","1","0","2","2","0","0","0","0","2"
"Santa Ana","-12.86667","-72.71667","2","0","0","0","0","0","0","2","0","0","0","0","0","0","1","1","0","2","2","0","0","0","0","2"
"Santa Ana","7.6422","-72.27694","2","0","0","0","0","0","0","2","0","0","0","0","0","0","1","1","0","2","2","0","0","0","0","2"
"Santa Ana","8.11697","-72.02174","2","0","0","0","0","0","0","2","0","0","0","0","0","0","1","1","0","2","2","0","0","0","0","2"
"Santa Ana","9.3056","-64.65478","2","0","0","0","0","0","0","2","0","0","0","0","0","0","1","1","0","2","2","0","0","0","0","2"
"Santa Ana","11.06828","-63.92239","2","0","0","0","0","0","0","2","0","0","0","0","0","0","1","1","0","2","2","0","0","0","0","2"
"Santa Ana","-30.90004","-57.93162","2","0","0","0","0","0","0","2","0","0","0","0","0","0","1","1","0","2","2","0","0","0","0","2"
"Santa Ana","-27.3674","-55.58091","2","0","0","0","0","0","0","2","0","0","0","0","0","0","1","1","0","2","2","0","0","0","0","2"
"Santa Ana","39.30823","-5.99027","2","0","0","0","0","0","0","2","0","0","0","0","0","0","1","1","0","2","2","0","0","0","0","2"
"Santa Ana","15.0955","120.767","2","0","0","0","0","0","0","2","0","0","0","0","0","0","1","1","0","2","2","0","0","0","0","2"
"Santa Ana","18.46986","122.14775","2","0","0","0","0","0","0","2","0","0","0","0","0","0","1","1","0","2","2","0","0","0","0","2"
"Santa Ana","8.51667","124.78333","2","0","0","0","0","0","0","2","0","0","0","0","0","0","1","1","0","2","2","0","0","0","0","2"
"Santa Ana","9.19278","125.56444","2","0","0","0","0","0","0","2","0","0","0","0","0","0","1","1","0","2","2","0","0","0","0","2"
"Santa Barbara","34.42083","-119.69819","1","0","0","0","0","0","0","1","0","0","1","0","1","0","0","1","0","1","0","0","1","0","0","1"
"Santa Barbara","18.39356","-65.91878","1","0","0","0","0","0","0","1","0","0","1","0","1","0","0","1","0","1","0","0","1","0","0","1"
"Santa Barbara","40.17898","15.25788","1","0","0","0","0","0","0","1","0","0","1","0","1","0","0","1","0","1","0","0","1","0","0","1"
"Santa Barbara","16.0009","120.4023","1","0","0","0","0","0","0","1","0","0","1","0","1","0","0","1","0","1","0","0","1","0","0","1"
"Santa Barbara","15.38494","120.79611","1","0","0","0","0","0","0","1","0","0","1","0","1","0","0","1","0","1","0","0","1","0","0","1"
"Santa Barbara","10.82306","122.53444","1","0","0","0","0","0","0","1","0","0","1","0","1","0","0","1","0","1","0","0","1","0","0","1"
"Santa Clara","37.35411","-121.95524","1","0","0","0","0","0","0","1","0","0","0","0","0","0","0","1","0","1","0","0","1","0","0","1"
"Santa Clara","37.13304","-113.65413","1","0","0","0","0","0","0","1","0","0","0","0","0","0","0","1","0","1","0","0","1","0","0","1"
"Santa Clara","32.77952","-108.15032","1","0","0","0","0","0","0","1","0","0","0","0","0","0","0","1","0","1","0","0","1","0","0","1"
"Santa Clara","25.80861","-103.59389","1","0","0","0","0","0","0","1","0","0","0","0","0","0","0","1","0","1","0","0","1","0","0","1"
"Santa Clara","24.475","-103.35694","1","0","0","0","0","0","0","1","0","0","0","0","0","0","0","1","0","1","0","0","1","0","0","1"
"Santa Clara","20.17904","-101.4335","1","0","0","0","0","0","0","1","0","0","0","0","0","0","0","1","0","1","0","0","1","0","0","1"
"Santa Clara","21.13306","-100.86361","1","0","0","0","0","0","0","1","0","0","0","0","0","0","0","1","0","1","0","0","1","0","0","1"
"Santa Clara","19.69889","-98.57778","1","0","0","0","0","0","0","1","0","0","0","0","0","0","0","1","0","1","0","0","1","0","0","1"
"Santa Clara","18.97616","-98.3014","1","0","0","0","0","0","0","1","0","0","0","0","0","0","0","1","0","1","0","0","1","0","0","1"
"Santa Clara","29.5119","-98.1214","1","0","0","0","0","0","0","1","0","0","0","0","0","0","0","1","0","1","0","0","1","0","0","1"
"Santa Clara","8.83376","-82.77945","1","0","0","0","0","0","0","1","0","0","0","0","0","0","0","1","0","1","0","0","1","0","0","1"
"Santa Clara","8.38298","-80.10992","1","0","0","0","0","0","0","1","0","0","0","0","0","0","0","1","0","1","0","0","1","0","0","1"
"Santa Clara","22.40694","-79.96472","1","0","0","0","0","0","0","1","0","0","0","0","0","0","0","1","0","1","0","0","1","0","0","1"
"Santa Clara","9.02875","-79.75443","1","0","0","0","0","0","0","1","0","0","0","0","0","0","0","1","0","1","0","0","1","0","0","1"
"Santa Clara","-1.26399","-77.88739","1","0","0","0","0","0","0","1","0","0","0","0","0","0","0","1","0","1","0","0","1","0","0","1"
"Santa Clara","18.21857","-66.12878","1","0","0","0","0","0","0","1","0","0","0","0","0","0","0","1","0","1","0","0","1","0","0","1"
"Santa Clara","-24.30921","-64.66253","1","0","0","0","0","0","0","1","0","0","0","0","0","0","0","1","0","1","0","0","1","0","0","1"
"Santa Clara","40.19985","-8.44018","1","0","0","0","0","0","0","1","0","0","0","0","0","0","0","1","0","1","0","0","1","0","0","1"
"Santa Clara","13.75361","121.06056","1","0","0","0","0","0","0","1","0","0","0","0","0","0","0","1","0","1","0","0","1","0","0","1"
"Santa Clara","6.6782","122.06","1","0","0","0","0","0","0","1","0","0","0","0","0","0","0","1","0","1","0","0","1","0","0","1"
"Santa Cruz de la Sierra","-17.78629","-63.18117","3","0","0","0","0","0","0","3","1","0","0","0","1","0","0","3","0","3","1","0","2","0","0","3"
"Santa Cruz de la Sierra","39.33635","-5.84561","3","0","0","0","0","0","0","3","1","0","0","0","1","0","0","3","0","3","1","0","2","0","0","3"
"Santa Cruz de Tenerife","28.46824","-16.25462","1","0","0","0","0","0","0","1","0","0","1","0","1","1","0","0","0","1","1","0","0","0","0","1"
"Santa Margalida","39.70143","3.10215","2","0","0","0","0","0","0","2","0","1","1","0","2","1","0","1","0","2","0","2","0","0","0","2"
"Santana de Parnaíba","-23.44417","-46.91778","1","0","0","0","0","0","0","1","0","0","0","0","0","1","0","0","0","1","1","0","0","0","0","1"
"Santa Rosa","38.44047","-122.71443","1","0","0","0","0","0","0","1","0","0","1","0","1","1","0","0","0","1","1","0","0","0","0","1"
"Santa Rosa","32.32368","-112.04125","1","0","0","0","0","0","0","1","0","0","1","0","1","1","0","0","0","1","1","0","0","0","0","1"
"Santa Rosa","34.93867","-104.68249","1","0","0","0","0","0","0","1","0","0","1","0","1","1","0","0","0","1","1","0","0","0","0","1"
"Santa Rosa","20.4144","-103.23534","1","0","0","0","0","0","0","1","0","0","1","0","1","1","0","0","0","1","1","0","0","0","0","1"
"Santa Rosa","22.92789","-103.11227","1","0","0","0","0","0","0","1","0","0","1","0","1","1","0","0","0","1","1","0","0","0","0","1"
"Santa Rosa","21.55181","-101.0921","1","0","0","0","0","0","0","1","0","0","1","0","1","1","0","0","0","1","1","0","0","0","0","1"
"Santa Rosa","25.82463","-100.22164","1","0","0","0","0","0","0","1","0","0","1","0","1","1","0","0","0","1","1","0","0","0","0","1"
"Santa Rosa","19.32332","-99.2957","1","0","0","0","0","0","0","1","0","0","1","0","1","1","0","0","0","1","1","0","0","0","0","1"
"Santa Rosa","26.25674","-97.825","1","0","0","0","0","0","0","1","0","0","1","0","1","1","0","0","0","1","1","0","0","0","0","1"
"Santa Rosa","18.87704","-97.78122","1","0","0","0","0","0","0","1","0","0","1","0","1","1","0","0","0","1","1","0","0","0","0","1"
"Santa Rosa","19.47078","-96.46514","1","0","0","0","0","0","0","1","0","0","1","0","1","1","0","0","0","1","1","0","0","0","0","1"
"Santa Rosa","16.31655","-95.09944","1","0","0","0","0","0","0","1","0","0","1","0","1","1","0","0","0","1","1","0","0","0","0","1"
"Santa Rosa","15.72354","-92.10409","1","0","0","0","0","0","0","1","0","0","1","0","1","1","0","0","0","1","1","0","0","0","0","1"
"Santa Rosa","20.60599","-90.08822","1","0","0","0","0","0","0","1","0","0","1","0","1","1","0","0","0","1","1","0","0","0","0","1"
"Santa Rosa","8.59958","-82.68489","1","0","0","0","0","0","0","1","0","0","1","0","1","1","0","0","0","1","1","0","0","0","0","1"
"Santa Rosa","-3.44882","-79.95952","1","0","0","0","0","0","0","1","0","0","1","0","1","1","0","0","0","1","1","0","0","0","0","1"
"Santa Rosa","-6.88111","-79.91972","1","0","0","0","0","0","0","1","0","0","1","0","1","1","0","0","0","1","1","0","0","0","0","1"
"Santa Rosa","-6.75772","-79.82747","1","0","0","0","0","0","0","1","0","0","1","0","1","1","0","0","0","1","1","0","0","0","0","1"
"Santa Rosa","-11.79917","-77.17333","1","0","0","0","0","0","0","1","0","0","1","0","1","1","0","0","0","1","1","0","0","0","0","1"
"Santa Rosa","-6.68333","-76.61667","1","0","0","0","0","0","0","1","0","0","1","0","1","1","0","0","0","1","1","0","0","0","0","1"
"Santa Rosa","1.70267","-76.57389","1","0","0","0","0","0","0","1","0","0","1","0","1","1","0","0","0","1","1","0","0","0","0","1"
"Santa Rosa","10.44472","-75.36972","1","0","0","0","0","0","0","1","0","0","1","0","1","1","0","0","0","1","1","0","0","0","0","1"
"Santa Rosa","-14.15","-72.66667","1","0","0","0","0","0","0","1","0","0","1","0","1","1","0","0","0","1","1","0","0","0","0","1"
"Santa Rosa","-40.17625","-72.56058","1","0","0","0","0","0","0","1","0","0","1","0","1","1","0","0","0","1","1","0","0","0","0","1"
"Santa Rosa","-14.61111","-70.78611","1","0","0","0","0","0","0","1","0","0","1","0","1","1","0","0","0","1","1","0","0","0","0","1"
"Santa Rosa","8.44033","-69.70105","1","0","0","0","0","0","0","1","0","0","1","0","1","1","0","0","0","1","1","0","0","0","0","1"
"Santa Rosa","-33.25407","-68.14937","1","0","0","0","0","0","0","1","0","0","1","0","1","1","0","0","0","1","1","0","0","0","0","1"
"Santa Rosa","-14.16667","-66.88333","1","0","0","0","0","0","0","1","0","0","1","0","1","1","0","0","0","1","1","0","0","0","0","1"
"Santa Rosa","-36.61667","-64.28333","1","0","0","0","0","0","0","1","0","0","1","0","1","1","0","0","0","1","1","0","0","0","0","1"
"Santa Rosa","-28.26318","-58.11891","1","0","0","0","0","0","0","1","0","0","1","0","1","1","0","0","0","1","1","0","0","0","0","1"
"Santa Rosa","-34.49819","-56.03795","1","0","0","0","0","0","0","1","0","0","1","0","1","1","0","0","0","1","1","0","0","0","0","1"
"Santa Rosa","-27.87083","-54.48139","1","0","0","0","0","0","0","1","0","0","1","0","1","1","0","0","0","1","1","0","0","0","0","1"
"Santa Rosa","15.36756","120.61703","1","0","0","0","0","0","0","1","0","0","1","0","1","1","0","0","0","1","1","0","0","0","0","1"
"Santa Rosa","14.42612","120.87931","1","0","0","0","0","0","0","1","0","0","1","0","1","1","0","0","0","1","1","0","0","0","0","1"
"Santa Rosa","15.4238","120.9378","1","0","0","0","0","0","0","1","0","0","1","0","1","1","0","0","0","1","1","0","0","0","0","1"
"Santa Rosa","14.31222","121.11139","1","0","0","0","0","0","0","1","0","0","1","0","1","1","0","0","0","1","1","0","0","0","0","1"
"Santa Rosa","13.5591","122.3776","1","0","0","0","0","0","0","1","0","0","1","0","1","1","0","0","0","1","1","0","0","0","0","1"
"Santa Rosa de Cabal","4.86806","-75.62139","1","0","0","0","0","0","0","1","0","0","0","0","0","0","0","1","0","1","0","0","1","0","0","1"
"Sant Cugat del Vallès","41.47063","2.08611","0","0","0","0","0","0","0","0","0","0","0","0","0","0","0","0","0","0","0","0","0","0","0","0"
"Santiago","23.47855","-109.71515","14","0","0","0","1","0","0","15","8","2","1","0","11","3","2","9","1","15","7","2","8","1","0","18"
"Santiago","22.11948","-102.33769","14","0","0","0","1","0","0","15","8","2","1","0","11","3","2","9","1","15","7","2","8","1","0","18"
"Santiago","22.45477","-101.45898","14","0","0","0","1","0","0","15","8","2","1","0","11","3","2","9","1","15","7","2","8","1","0","18"
"Santiago","25.42533","-100.15205","14","0","0","0","1","0","0","15","8","2","1","0","11","3","2","9","1","15","7","2","8","1","0","18"
"Santiago","19.81194","-97.32361","14","0","0","0","1","0","0","15","8","2","1","0","11","3","2","9","1","15","7","2","8","1","0","18"
"Santiago","19.91714","-97.154","14","0","0","0","1","0","0","15","8","2","1","0","11","3","2","9","1","15","7","2","8","1","0","18"
"Santiago","18.44884","-95.83037","14","0","0","0","1","0","0","15","8","2","1","0","11","3","2","9","1","15","7","2","8","1","0","18"
"Santiago","16.13861","-93.015","14","0","0","0","1","0","0","15","8","2","1","0","11","3","2","9","1","15","7","2","8","1","0","18"
"Santiago","10.02275","-84.4442","14","0","0","0","1","0","0","15","8","2","1","0","11","3","2","9","1","15","7","2","8","1","0","18"
"Santiago","9.84636","-84.31428","14","0","0","0","1","0","0","15","8","2","1","0","11","3","2","9","1","15","7","2","8","1","0","18"
"Santiago","1.14844","-77.0045","14","0","0","0","1","0","0","15","8","2","1","0","11","3","2","9","1","15","7","2","8","1","0","18"
"Santiago","-14.18469","-75.71124","14","0","0","0","1","0","0","15","8","2","1","0","11","3","2","9","1","15","7","2","8","1","0","18"
"Santiago","7.86432","-72.7162","14","0","0","0","1","0","0","15","8","2","1","0","11","3","2","9","1","15","7","2","8","1","0","18"
"Santiago","-33.45694","-70.64827","14","0","0","0","1","0","0","15","8","2","1","0","11","3","2","9","1","15","7","2","8","1","0","18"
"Santiago","-27.1431","-56.76803","14","0","0","0","1","0","0","15","8","2","1","0","11","3","2","9","1","15","7","2","8","1","0","18"
"Santiago","-29.19167","-54.86722","14","0","0","0","1","0","0","15","8","2","1","0","11","3","2","9","1","15","7","2","8","1","0","18"
"Santiago","17.2939","120.4449","14","0","0","0","1","0","0","15","8","2","1","0","11","3","2","9","1","15","7","2","8","1","0","18"
"Santiago","14.90371","120.51134","14","0","0","0","1","0","0","15","8","2","1","0","11","3","2","9","1","15","7","2","8","1","0","18"
"Santiago","14.0211","121.2792","14","0","0","0","1","0","0","15","8","2","1","0","11","3","2","9","1","15","7","2","8","1","0","18"
"Santiago","16.68808","121.5487","14","0","0","0","1","0","0","15","8","2","1","0","11","3","2","9","1","15","7","2","8","1","0","18"
"Santiago","11.05806","122.91167","14","0","0","0","1","0","0","15","8","2","1","0","11","3","2","9","1","15","7","2","8","1","0","18"
"Santiago","10.5897","124.3066","14","0","0","0","1","0","0","15","8","2","1","0","11","3","2","9","1","15","7","2","8","1","0","18"
"Santiago","7.28889","126.57333","14","0","0","0","1","0","0","15","8","2","1","0","11","3","2","9","1","15","7","2","8","1","0","18"
"Santiago de Compostela","42.88052","-8.54569","1","0","0","0","0","0","0","1","0","0","1","0","1","1","0","0","0","1","0","0","0","1","0","1"
"Santiago de los Caballeros","19.4517","-70.69703","6","0","0","0","0","0","0","6","4","0","1","0","5","2","0","4","0","6","0","2","4","0","0","6"
"Santiago do Cacém","38.01693","-8.69475","1","0","0","0","0","0","0","1","1","0","0","0","1","0","0","1","0","1","0","1","0","0","0","1"
"Santo Domingo","23.3267","-101.7361","7","1","0","0","0","0","0","8","4","1","1","0","6","1","3","4","0","8","3","1","4","0","0","8"
"Santo Domingo","20.516","-101.22851","7","1","0","0","0","0","0","8","4","1","1","0","6","1","3","4","0","8","3","1","4","0","0","8"
"Santo Domingo","18.40203","-100.72888","7","1","0","0","0","0","0","8","4","1","1","0","6","1","3","4","0","8","3","1","4","0","0","8"
"Santo Domingo","17.45315","-100.35328","7","1","0","0","0","0","0","8","4","1","1","0","6","1","3","4","0","8","3","1","4","0","0","8"
"Santo Domingo","22.86532","-100.28337","7","1","0","0","0","0","0","8","4","1","1","0","6","1","3","4","0","8","3","1","4","0","0","8"
"Santo Domingo","22.28325","-100.16965","7","1","0","0","0","0","0","8","4","1","1","0","6","1","3","4","0","8","3","1","4","0","0","8"
"Santo Domingo","15.03067","-92.10361","7","1","0","0","0","0","0","8","4","1","1","0","6","1","3","4","0","8","3","1","4","0","0","8"
"Santo Domingo","17.02819","-91.41682","7","1","0","0","0","0","0","8","4","1","1","0","6","1","3","4","0","8","3","1","4","0","0","8"
"Santo Domingo","20.6","-90.11667","7","1","0","0","0","0","0","8","4","1","1","0","6","1","3","4","0","8","3","1","4","0","0","8"
"Santo Domingo","17.99917","-89.37694","7","1","0","0","0","0","0","8","4","1","1","0","6","1","3","4","0","8","3","1","4","0","0","8"
"Santo Domingo","12.26438","-85.08235","7","1","0","0","0","0","0","8","4","1","1","0","6","1","3","4","0","8","3","1","4","0","0","8"
"Santo Domingo","10.06389","-84.15499","7","1","0","0","0","0","0","8","4","1","1","0","6","1","3","4","0","8","3","1","4","0","0","8"
"Santo Domingo","8.50803","-82.71295","7","1","0","0","0","0","0","8","4","1","1","0","6","1","3","4","0","8","3","1","4","0","0","8"
"Santo Domingo","22.58677","-80.24261","7","1","0","0","0","0","0","8","4","1","1","0","6","1","3","4","0","8","3","1","4","0","0","8"
"Santo Domingo","7.74614","-80.24173","7","1","0","0","0","0","0","8","4","1","1","0","6","1","3","4","0","8","3","1","4","0","0","8"
"Santo Domingo","-5.02611","-79.87417","7","1","0","0","0","0","0","8","4","1","1","0","6","1","3","4","0","8","3","1","4","0","0","8"
"Santo Domingo","6.47282","-75.16547","7","1","0","0","0","0","0","8","4","1","1","0","6","1","3","4","0","8","3","1","4","0","0","8"
"Santo Domingo","8.86052","-70.6948","7","1","0","0","0","0","0","8","4","1","1","0","6","1","3","4","0","8","3","1","4","0","0","8"
"Santo Domingo","18.47186","-69.89232","7","1","0","0","0","0","0","8","4","1","1","0","6","1","3","4","0","8","3","1","4","0","0","8"
"Santo Domingo","18.0633","-66.7524","7","1","0","0","0","0","0","8","4","1","1","0","6","1","3","4","0","8","3","1","4","0","0","8"
"Santo Domingo","17.63528","120.41083","7","1","0","0","0","0","0","8","4","1","1","0","6","1","3","4","0","8","3","1","4","0","0","8"
"Santo Domingo","14.96532","120.55672","7","1","0","0","0","0","0","8","4","1","1","0","6","1","3","4","0","8","3","1","4","0","0","8"
"Santo Domingo","14.9912","120.74341","7","1","0","0","0","0","0","8","4","1","1","0","6","1","3","4","0","8","3","1","4","0","0","8"
"Santo Domingo","15.07289","120.75703","7","1","0","0","0","0","0","8","4","1","1","0","6","1","3","4","0","8","3","1","4","0","0","8"
"Santo Domingo","15.5873","120.877","7","1","0","0","0","0","0","8","4","1","1","0","6","1","3","4","0","8","3","1","4","0","0","8"
"Santo Domingo","17.15999","121.75183","7","1","0","0","0","0","0","8","4","1","1","0","6","1","3","4","0","8","3","1","4","0","0","8"
"Santo Domingo","14.1338","122.8883","7","1","0","0","0","0","0","8","4","1","1","0","6","1","3","4","0","8","3","1","4","0","0","8"
"Santo Domingo","13.7","123.16667","7","1","0","0","0","0","0","8","4","1","1","0","6","1","3","4","0","8","3","1","4","0","0","8"
"Santo Domingo","13.42","123.4486","7","1","0","0","0","0","0","8","4","1","1","0","6","1","3","4","0","8","3","1","4","0","0","8"
"Santo Domingo","13.23528","123.77722","7","1","0","0","0","0","0","8","4","1","1","0","6","1","3","4","0","8","3","1","4","0","0","8"
"Santo Domingo Este","18.48847","-69.85707","3","0","0","0","0","0","0","3","3","0","0","0","3","0","3","0","0","3","1","1","1","0","0","3"
"Santo Domingo Oeste","18.5","-70","1","0","0","1","0","0","0","2","2","0","0","0","2","0","0","2","0","2","0","0","2","0","0","2"
"Santos","-23.96083","-46.33361","1","0","0","0","0","0","1","2","0","1","1","0","2","1","1","0","0","2","1","0","1","0","0","2"
"São Paulo","-23.5475","-46.63611","6","1","0","1","0","0","1","9","2","2","0","1","5","3","3","3","0","9","5","1","2","1","0","9"
"São Roque do Pico","38.51631","-28.30752","1","0","0","0","0","0","0","1","0","0","1","0","1","0","0","1","0","1","0","1","0","0","0","1"
"Sapiranga","-29.63806","-51.00694","1","0","0","0","0","0","0","1","0","0","1","0","1","0","0","1","0","1","0","1","0","0","0","1"
"Saraburi","14.53333","100.91667","1","0","0","0","0","0","0","1","0","0","0","0","0","0","1","0","0","1","0","0","0","0","1","1"
"Sarajevo","43.84864","18.35644","7","0","0","0","0","0","0","7","0","2","3","1","6","1","2","3","1","7","1","2","2","1","1","7"
"Sarandë","39.87534","20.00477","0","0","0","0","0","0","0","0","0","0","0","0","0","0","1","0","0","1","0","0","0","0","0","0"
"Saransk","54.1838","45.1749","1","0","0","0","0","0","0","1","0","0","1","0","1","1","0","0","0","1","0","0","1","0","0","1"
"Saratov","51.54056","46.00861","1","0","0","0","0","0","0","1","0","0","1","0","1","1","0","0","0","1","0","0","1","0","0","1"
"Sargodha","32.08586","72.67418","8","1","0","0","0","0","0","9","5","3","0","1","9","4","3","3","0","10","4","0","5","0","0","9"
"Sarıcakaya","40.03686","30.62675","5","0","0","0","0","0","0","5","5","0","0","0","5","5","0","0","0","5","0","5","0","0","0","5"
"Sarratt","51.68458","-0.494","1","0","0","0","0","0","0","1","0","0","1","0","1","0","0","1","0","1","0","0","1","0","0","1"
"Sartrouville","48.9482","2.19169","0","0","0","0","0","0","1","1","1","0","0","0","1","1","0","0","0","1","0","1","0","0","0","1"
"Satara","17.68589","73.99333","1","0","0","0","0","0","0","1","1","0","0","0","1","1","0","0","0","1","0","0","1","0","0","1"
"Satna","24.57726","80.82719","1","0","0","0","0","0","0","1","1","0","0","0","1","0","0","1","0","1","0","0","1","0","0","1"
"Satwās","22.53628","76.68452","1","0","0","0","0","0","0","1","1","0","0","0","1","0","1","0","0","1","0","0","1","0","0","1"
"Saugus","42.46482","-71.01005","1","0","0","0","0","0","0","1","1","0","0","0","1","0","1","0","0","1","0","0","1","0","0","1"
"Saundersfoot","51.70945","-4.70215","2","0","0","0","0","0","0","2","0","0","0","0","0","0","0","2","0","2","0","2","0","0","0","2"
"Savigliano","44.64808","7.65677","1","0","0","0","0","0","0","1","0","1","0","0","1","1","0","0","0","1","1","0","0","0","0","1"
"Savona","42.28868","-77.21831","1","0","0","0","0","0","0","1","0","1","0","0","1","0","0","1","0","1","0","0","1","0","0","1"
"Savona","44.30905","8.47715","1","0","0","0","0","0","0","1","0","1","0","0","1","0","0","1","0","1","0","0","1","0","0","1"
"Sawbridgeworth","51.81667","0.15","2","1","0","0","0","0","0","3","1","0","0","0","1","1","0","1","1","3","1","1","1","0","0","3"
"Saxmundham","52.21497","1.48805","1","0","0","0","0","0","0","1","0","1","0","0","1","0","0","1","0","1","0","0","0","0","1","1"
"Sayalonga","36.79819","-4.01325","1","0","0","0","0","0","0","1","0","0","0","0","0","0","0","1","0","1","0","1","0","0","0","1"
"Scalby","53.76667","-0.71667","1","0","0","0","0","0","0","1","0","0","1","0","1","1","0","0","0","1","0","1","0","0","0","1"
"Scarborough","43.77223","-79.25666","10","0","0","0","4","0","3","17","5","4","7","0","16","5","3","9","0","17","6","3","7","0","1","17"
"Scarborough","43.57814","-70.32172","10","0","0","0","4","0","3","17","5","4","7","0","16","5","3","9","0","17","6","3","7","0","1","17"
"Scarborough","11.18229","-60.73525","10","0","0","0","4","0","3","17","5","4","7","0","16","5","3","9","0","17","6","3","7","0","1","17"
"Scarborough","54.27966","-0.40443","10","0","0","0","4","0","3","17","5","4","7","0","16","5","3","9","0","17","6","3","7","0","1","17"
"Scarborough","-31.89578","115.76431","10","0","0","0","4","0","3","17","5","4","7","0","16","5","3","9","0","17","6","3","7","0","1","17"
"Scarborough","-27.20118","153.10939","10","0","0","0","4","0","3","17","5","4","7","0","16","5","3","9","0","17","6","3","7","0","1","17"
"Schaumburg","42.03336","-88.08341","1","0","0","0","0","0","0","1","0","0","0","0","0","1","0","0","0","1","0","0","1","0","0","1"
"Schwaikheim","48.87733","9.34958","0","0","0","0","1","0","0","1","0","1","0","0","1","0","1","0","0","1","1","0","0","0","0","1"
"Sciacca","37.50693","13.08399","1","0","0","0","0","0","0","1","1","0","0","0","1","1","0","0","0","1","0","0","1","0","0","1"
"Scottsdale","33.50921","-111.89903","1","0","0","0","0","0","0","1","1","0","0","0","1","0","0","1","0","1","0","0","1","0","0","1"
"Scottsdale","-41.1578","147.51727","1","0","0","0","0","0","0","1","1","0","0","0","1","0","0","1","0","1","0","0","1","0","0","1"
"Scunthorpe","53.57905","-0.65437","6","0","0","1","1","0","0","8","3","3","0","0","6","5","0","3","0","8","4","1","3","0","0","8"
"Seaford","38.64123","-75.61104","4","0","0","0","0","0","0","4","1","0","2","0","3","0","2","2","0","4","0","3","1","0","0","4"
"Seaford","40.66593","-73.48818","4","0","0","0","0","0","0","4","1","0","2","0","3","0","2","2","0","4","0","3","1","0","0","4"
"Seaford","50.77141","0.10268","4","0","0","0","0","0","0","4","1","0","2","0","3","0","2","2","0","4","0","3","1","0","0","4"
"Seaford","-35.1898","138.47589","4","0","0","0","0","0","0","4","1","0","2","0","3","0","2","2","0","4","0","3","1","0","0","4"
"Seaford","-38.1","145.13333","4","0","0","0","0","0","0","4","1","0","2","0","3","0","2","2","0","4","0","3","1","0","0","4"
"Seaham","54.83903","-1.34575","3","0","0","0","1","0","2","6","1","1","4","0","6","2","2","2","0","6","1","3","2","0","0","6"
"Seaham","-32.66221","151.72664","3","0","0","0","1","0","2","6","1","1","4","0","6","2","2","2","0","6","1","3","2","0","0","6"
"Seahouses","55.58063","-1.65497","1","0","0","0","0","0","0","1","0","0","1","0","1","0","1","0","0","1","0","0","1","0","0","1"
"SeaTac","47.44846","-122.29217","1","0","0","0","0","0","0","1","0","1","0","0","1","1","0","0","0","1","0","0","1","0","0","1"
"Seaton","52.57489","-0.66759","0","0","0","0","1","0","0","1","0","0","1","0","1","1","0","0","0","1","0","1","0","0","0","1"
"Seaton","-34.9","138.51667","0","0","0","0","1","0","0","1","0","0","1","0","1","1","0","0","0","1","0","1","0","0","0","1"
"Seattle","47.60621","-122.33207","2","0","0","2","0","0","0","4","2","0","1","0","3","4","0","0","0","4","1","3","0","0","0","4"
"Sebring","27.49559","-81.44091","1","0","0","0","0","0","0","1","0","0","0","0","0","0","0","1","0","1","0","1","0","0","0","1"
"Sebring","40.92284","-81.01898","1","0","0","0","0","0","0","1","0","0","0","0","0","0","0","1","0","1","0","1","0","0","0","1"
"Sedgefield","54.65329","-1.44952","1","0","0","0","0","0","0","1","0","1","0","0","1","1","0","0","0","1","1","0","0","0","0","1"
"Seefeld","54.09977","9.4931","2","0","0","0","0","0","0","2","0","1","0","0","1","0","0","2","0","2","0","0","2","0","0","2"
"Seefeld","48.03505","11.21395","2","0","0","0","0","0","0","2","0","1","0","0","1","0","0","2","0","2","0","0","2","0","0","2"
"Seffner","27.98363","-82.27565","1","0","0","0","0","0","0","1","0","1","0","0","1","1","0","0","0","1","1","0","0","0","0","1"
"Sefrou","33.83186","-4.828","1","1","0","0","0","0","0","2","2","0","0","0","2","1","0","1","0","2","0","0","2","0","0","2"
"Seghill","55.06225","-1.55027","1","0","0","0","0","0","0","1","0","0","0","0","0","0","0","1","0","1","0","1","0","0","0","1"
"Sehwan","26.42495","67.86126","1","0","0","0","0","0","0","1","1","0","0","0","1","0","1","0","0","1","0","0","1","0","0","1"
"Seixal","32.82322","-17.10941","1","0","0","0","0","0","0","1","0","0","1","0","1","1","0","0","0","1","0","1","0","0","0","1"
"Seixal","38.64008","-9.10141","1","0","0","0","0","0","0","1","0","0","1","0","1","1","0","0","0","1","0","1","0","0","0","1"
"Selargius","39.25779","9.16323","1","0","0","0","0","0","0","1","1","0","0","0","1","0","0","1","0","1","0","0","1","0","0","1"
"Selby","45.50638","-100.03207","7","0","0","2","1","0","1","11","3","2","6","0","11","4","0","7","0","11","2","3","6","0","0","11"
"Selby","53.78333","-1.06667","7","0","0","2","1","0","1","11","3","2","6","0","11","4","0","7","0","11","2","3","6","0","0","11"
"Selby","-37.91667","145.38333","7","0","0","2","1","0","1","11","3","2","6","0","11","4","0","7","0","11","2","3","6","0","0","11"
"Selinsgrove","40.79897","-76.86219","1","0","0","0","0","0","0","1","0","1","0","0","1","0","1","0","0","1","1","0","0","0","0","1"
"Selkirk","50.1436","-96.88452","1","0","0","0","0","0","1","2","0","0","1","0","1","1","1","0","0","2","0","1","1","0","0","2"
"Selkirk","55.54738","-2.83911","1","0","0","0","0","0","1","2","0","0","1","0","1","1","1","0","0","2","0","1","1","0","0","2"
"Selsey","50.73501","-0.78979","2","0","0","0","1","0","0","3","0","2","1","0","3","2","0","1","0","3","1","0","2","0","0","3"
"Semarang","-6.99306","110.42083","1","0","0","0","0","0","0","1","0","0","1","0","1","0","0","1","0","1","0","0","1","0","0","1"
"Semenyih","2.9516","101.843","1","1","0","0","0","0","0","2","1","1","0","0","2","2","0","0","0","2","1","0","1","0","0","2"
"Seoni","31.24188","77.12362","0","1","0","0","0","0","0","1","0","0","1","0","1","0","0","1","0","1","0","0","0","0","1","1"
"Seoni","22.08503","79.55037","0","1","0","0","0","0","0","1","0","0","1","0","1","0","0","1","0","1","0","0","0","0","1","1"
"Seoul","37.566","126.9784","2","0","0","0","0","0","0","2","0","1","0","0","1","1","1","0","0","2","2","0","0","0","0","2"
"Sepang","2.6931","101.7498","1","0","0","0","0","0","0","1","0","1","0","0","1","1","0","0","0","1","1","0","0","0","0","1"
"Sepang","-8.3089","114.9171","1","0","0","0","0","0","0","1","0","1","0","0","1","1","0","0","0","1","1","0","0","0","0","1"
"Seregno","45.65002","9.20548","1","0","0","0","0","0","0","1","0","1","0","0","1","0","0","1","0","1","1","0","0","0","0","1"
"Serekunda","13.43833","-16.67806","0","0","0","0","1","0","0","1","0","1","0","0","1","0","1","0","0","1","0","0","0","0","1","1"
"Seremban","2.7297","101.9381","1","0","0","0","0","0","0","1","0","1","0","0","1","0","0","1","0","1","0","0","1","0","0","1"
"Serramanna","39.42335","8.92243","1","0","0","0","0","0","0","1","0","1","0","0","1","1","0","0","0","1","1","0","0","0","0","1"
"Sesvete","45.83111","16.11639","0","0","0","0","1","0","0","1","1","0","0","0","1","1","0","0","0","1","0","0","1","0","0","1"
"Sétif","36.19112","5.41373","2","0","0","0","1","0","0","3","2","1","0","0","3","1","1","1","0","3","0","1","1","0","1","3"
"Settle","54.06865","-2.2772","3","0","0","0","0","0","0","3","0","2","1","0","3","1","0","2","0","3","0","0","3","0","0","3"
"Sevenoaks","51.27266","0.18883","19","0","0","1","4","0","1","25","4","7","8","0","19","10","3","12","0","25","2","6","15","0","2","25"
"Seven Sisters","51.76667","-3.71667","1","0","0","0","0","0","0","1","0","1","0","0","1","1","0","0","0","1","0","0","1","0","0","1"
"Seyid Sadiq","35.35278","45.86682","1","0","0","0","0","0","0","1","0","1","0","0","1","0","0","0","1","1","1","0","0","0","0","1"
"Seymour","33.59426","-99.26035","1","0","0","0","0","0","0","1","0","0","0","0","0","1","0","0","0","1","1","0","0","0","0","1"
"Seymour","40.68251","-93.12104","1","0","0","0","0","0","0","1","0","0","0","0","0","1","0","0","0","1","1","0","0","0","0","1"
"Seymour","37.14644","-92.76878","1","0","0","0","0","0","0","1","0","0","0","0","0","1","0","0","0","1","1","0","0","0","0","1"
"Seymour","44.82663","-91.43127","1","0","0","0","0","0","0","1","0","0","0","0","0","1","0","0","0","1","1","0","0","0","0","1"
"Seymour","44.51499","-88.33038","1","0","0","0","0","0","0","1","0","0","0","0","0","1","0","0","0","1","1","0","0","0","0","1"
"Seymour","38.95922","-85.89025","1","0","0","0","0","0","0","1","0","0","0","0","0","1","0","0","0","1","1","0","0","0","0","1"
"Seymour","35.89064","-83.72462","1","0","0","0","0","0","0","1","0","0","0","0","0","1","0","0","0","1","1","0","0","0","0","1"
"Seymour","41.39676","-73.07594","1","0","0","0","0","0","0","1","0","0","0","0","0","1","0","0","0","1","1","0","0","0","0","1"
"Seymour","-37.02655","145.13924","1","0","0","0","0","0","0","1","0","0","0","0","0","1","0","0","0","1","1","0","0","0","0","1"
"Sfântu Gheorghe","45.86667","25.78333","0","1","0","0","0","0","0","1","1","0","0","0","1","0","0","1","0","1","0","0","1","0","0","1"
"Sfântu Gheorghe","44.65","26.83333","0","1","0","0","0","0","0","1","1","0","0","0","1","0","0","1","0","1","0","0","1","0","0","1"
"Sfântu Gheorghe","44.896","29.59294","0","1","0","0","0","0","0","1","1","0","0","0","1","0","0","1","0","1","0","0","1","0","0","1"
"Sfax","34.74056","10.76028","5","0","0","0","0","0","0","5","2","1","1","0","4","1","2","1","0","4","1","1","2","0","0","4"
"Shaftesbury","51.00528","-2.19333","7","0","0","0","0","0","0","7","1","4","1","0","6","4","1","2","0","7","2","1","4","0","0","7"
"Shah Alam","3.08507","101.53281","3","0","0","0","0","0","0","3","1","1","0","0","2","1","0","2","0","3","2","0","1","0","0","3"
"Shahdadpur","25.92539","68.6228","1","0","0","0","0","0","0","1","1","0","0","0","1","0","1","0","0","1","0","1","0","0","0","1"
"Shahkot","31.5709","73.48531","1","0","0","0","0","0","0","1","0","0","1","0","1","0","0","1","0","1","0","0","1","0","0","1"
"Shahpur","32.2682","72.46884","1","0","0","0","0","0","0","1","1","0","0","0","1","0","0","1","0","1","0","0","1","0","0","1"
"Shakargarh","32.26361","75.16008","4","0","0","0","0","0","0","4","4","0","0","0","4","1","0","2","0","3","0","1","3","0","0","4"
"Shanghai","31.22222","121.45806","2","0","0","0","0","0","0","2","1","0","0","1","2","0","0","1","1","2","1","1","0","0","0","2"
"Shanklin","50.62613","-1.1785","1","0","0","0","0","0","0","1","0","0","1","0","1","1","0","0","0","1","0","0","1","0","0","1"
"Sharjah","25.33737","55.41206","9","0","0","0","1","0","0","10","2","4","2","0","8","6","1","3","0","10","7","3","0","0","0","10"
"Shawbury","52.79098","-2.66183","0","0","0","1","0","0","0","1","0","0","1","0","1","0","1","0","0","1","0","0","1","0","0","1"
"Sheering","51.80373","0.18454","2","0","0","0","0","0","0","2","0","1","0","0","1","0","2","0","0","2","1","1","0","0","0","2"
"Sheerness","51.44042","0.76252","1","0","0","1","1","0","0","3","1","2","0","0","3","1","0","2","0","3","1","0","2","0","0","3"
"Sheffield","42.8933","-93.2152","96","2","0","6","13","0","6","123","20","42","35","3","100","52","14","56","1","123","21","16","79","5","2","123"
"Sheffield","41.35837","-89.73732","96","2","0","6","13","0","6","123","20","42","35","3","100","52","14","56","1","123","21","16","79","5","2","123"
"Sheffield","34.76509","-87.69864","96","2","0","6","13","0","6","123","20","42","35","3","100","52","14","56","1","123","21","16","79","5","2","123"
"Sheffield","41.42115","-82.09626","96","2","0","6","13","0","6","123","20","42","35","3","100","52","14","56","1","123","21","16","79","5","2","123"
"Sheffield","41.70395","-79.0356","96","2","0","6","13","0","6","123","20","42","35","3","100","52","14","56","1","123","21","16","79","5","2","123"
"Sheffield","42.11037","-73.35511","96","2","0","6","13","0","6","123","20","42","35","3","100","52","14","56","1","123","21","16","79","5","2","123"
"Sheffield","53.38297","-1.4659","96","2","0","6","13","0","6","123","20","42","35","3","100","52","14","56","1","123","21","16","79","5","2","123"
"Sheffield","-41.39947","146.33897","96","2","0","6","13","0","6","123","20","42","35","3","100","52","14","56","1","123","21","16","79","5","2","123"
"Shefford","52.0387","-0.33399","3","0","0","0","0","0","0","3","0","1","1","0","2","1","0","2","0","3","0","1","1","0","1","3"
"Shekhupura","31.71287","73.98556","4","0","0","0","0","0","0","4","1","3","0","0","4","3","0","1","0","4","1","0","2","0","1","4"
"Sheki","41.19194","47.17056","1","0","0","0","0","0","0","1","0","1","0","0","1","1","0","0","0","1","0","0","0","0","1","1"
"Shenley","46.00007","-70.83234","2","0","0","0","0","0","0","2","0","0","1","0","1","2","0","0","0","2","0","1","1","0","0","2"
"Shenley","51.69054","-0.28067","2","0","0","0","0","0","0","2","0","0","1","0","1","2","0","0","0","2","0","1","1","0","0","2"
"Shepparton East","-36.40156","145.47765","1","0","0","0","0","0","0","1","0","0","1","0","1","1","0","0","0","1","0","0","0","1","0","1"
"Shepperton","51.39546","-0.44889","3","0","0","0","0","0","0","3","1","1","0","0","2","0","1","2","0","3","0","1","2","0","0","3"
"Shepton Mallet","51.18972","-2.54722","4","0","0","0","0","0","0","4","0","0","2","0","2","0","2","2","0","4","2","1","1","0","0","4"
"Sherborne","50.94599","-2.51776","7","0","0","0","0","0","1","8","0","1","5","0","6","0","1","7","0","8","1","5","1","0","1","8"
"Sherburn in Elmet","53.79519","-1.2466","1","0","0","0","0","0","0","1","0","0","0","0","0","0","0","1","0","1","0","0","1","0","0","1"
"Sheringham","52.94078","1.20931","1","0","0","0","0","0","0","1","0","0","1","0","1","0","0","1","0","1","0","1","0","0","0","1"
"Sherington","52.11172","-0.69973","1","0","0","0","0","0","0","1","0","1","0","0","1","1","0","0","0","1","0","0","0","0","1","1"
"Sherpur","25.01881","90.01751","1","0","0","0","0","0","0","1","0","0","0","1","1","1","0","0","0","1","0","0","1","0","0","1"
"Sherston","51.57205","-2.21278","1","0","0","0","0","0","0","1","0","1","0","0","1","1","0","0","0","1","1","0","0","0","0","1"
"Shibīn al Kawm","30.55258","31.00904","1","0","0","0","0","0","0","1","0","1","1","0","2","0","1","1","0","2","1","1","0","0","0","2"
"Shifnal","52.67043","-2.37248","6","0","0","0","0","0","1","7","0","4","3","0","7","2","1","4","0","7","4","0","3","0","0","7"
"Shikarpur","27.95558","68.63823","1","0","0","0","0","0","0","1","0","0","1","0","1","1","0","0","0","1","0","0","1","0","0","1"
"Shikohābād","27.108","78.58661","1","0","0","0","0","0","0","1","0","1","0","0","1","0","0","1","0","1","0","0","1","0","0","1"
"Shildon","54.62997","-1.64295","2","0","0","0","0","0","0","2","0","1","1","0","2","2","0","0","0","2","0","0","2","0","0","2"
"Shillong","25.56892","91.88313","1","0","0","0","0","0","0","1","1","0","0","0","1","1","0","0","0","1","0","0","1","0","0","1"
"Shimla","31.10442","77.16662","2","0","0","0","0","0","0","2","1","1","0","0","2","0","0","2","0","2","0","0","2","0","0","2"
"Shimoga","13.93157","75.56791","2","0","0","0","0","0","0","2","2","0","0","0","2","0","0","2","0","2","0","0","2","0","0","2"
"Shinfield","51.40542","-0.94534","1","0","0","0","0","0","0","1","0","1","0","0","1","0","0","1","0","1","0","1","0","0","0","1"
"Shipham","51.31428","-2.8001","0","0","0","0","1","0","0","1","1","0","0","0","1","0","0","1","0","1","0","0","1","0","0","1"
"Shipley","53.83333","-1.76667","2","0","0","0","0","0","0","2","0","1","1","0","2","0","0","2","0","2","0","0","2","0","0","2"
"Shirbīn","31.19688","31.5243","1","0","0","0","0","0","0","1","0","1","0","0","1","1","0","0","0","1","0","0","0","1","0","1"
"Shiremoor","55.03535","-1.5095","1","0","0","0","0","0","0","1","0","0","1","0","1","0","0","1","0","1","0","0","1","0","0","1"
"Shirley","39.89199","-85.57692","1","0","0","0","0","0","0","1","1","0","0","0","1","0","0","1","0","1","0","1","0","0","0","1"
"Shirley","40.80149","-72.8676","1","0","0","0","0","0","0","1","1","0","0","0","1","0","0","1","0","1","0","1","0","0","0","1"
"Shirley","42.5437","-71.64951","1","0","0","0","0","0","0","1","1","0","0","0","1","0","0","1","0","1","0","1","0","0","0","1"
"Shirley","52.41074","-1.81952","1","0","0","0","0","0","0","1","1","0","0","0","1","0","0","1","0","1","0","1","0","0","0","1"
"Shirley","52.97012","-1.6755","1","0","0","0","0","0","0","1","1","0","0","0","1","0","0","1","0","1","0","1","0","0","0","1"
"Shkodër","42.06828","19.51258","3","2","0","0","0","0","0","5","2","3","0","0","5","1","3","1","0","5","1","0","2","0","2","5"
"Shoreham-by-Sea","50.83413","-0.27431","8","0","0","0","1","0","1","10","1","3","3","0","7","5","3","2","0","10","2","1","6","1","0","10"
"Shorkot","31.91023","70.87757","1","1","0","0","0","0","0","2","1","0","1","0","2","1","1","0","0","2","0","1","1","0","0","2"
"Shotton","54.78333","-1.36667","1","0","0","0","0","0","1","2","0","2","0","0","2","1","1","0","0","2","0","1","1","0","0","2"
"Shotts","55.81951","-3.79749","2","0","0","0","0","0","0","2","1","0","1","0","2","1","1","0","0","2","0","2","0","0","0","2"
"Shreveport","32.52515","-93.75018","1","0","0","0","0","0","0","1","0","0","0","0","0","0","0","1","0","1","0","0","1","0","0","1"
"Shrewsbury","38.59033","-90.33678","27","4","0","0","4","0","3","38","7","8","13","2","30","12","6","19","1","38","7","14","17","0","0","38"
"Shrewsbury","38.20621","-81.4715","27","4","0","0","4","0","3","38","7","8","13","2","30","12","6","19","1","38","7","14","17","0","0","38"
"Shrewsbury","39.76871","-76.67969","27","4","0","0","4","0","3","38","7","8","13","2","30","12","6","19","1","38","7","14","17","0","0","38"
"Shrewsbury","40.18261","-74.52932","27","4","0","0","4","0","3","38","7","8","13","2","30","12","6","19","1","38","7","14","17","0","0","38"
"Shrewsbury","40.32955","-74.06153","27","4","0","0","4","0","3","38","7","8","13","2","30","12","6","19","1","38","7","14","17","0","0","38"
"Shrewsbury","42.29593","-71.71285","27","4","0","0","4","0","3","38","7","8","13","2","30","12","6","19","1","38","7","14","17","0","0","38"
"Shrewsbury","52.71009","-2.75208","27","4","0","0","4","0","3","38","7","8","13","2","30","12","6","19","1","38","7","14","17","0","0","38"
"Shrīrāmpur","22.75278","88.34222","1","0","0","0","0","0","0","1","0","0","1","0","1","0","1","0","0","1","0","0","0","0","1","1"
"Shrivenham","51.59853","-1.65461","0","0","0","0","1","0","0","1","0","0","0","0","0","0","0","0","1","1","0","0","1","0","0","1"
"Sialkot","32.49268","74.53134","13","2","0","0","0","0","0","15","10","4","0","0","14","5","3","7","0","15","4","2","7","1","0","14"
"Šiauliai","55.93333","23.31667","1","0","0","0","0","0","0","1","0","0","0","0","0","0","0","1","0","1","1","0","0","0","0","1"
"Siavonga","-16.53818","28.70876","2","0","0","0","0","0","0","2","0","1","0","1","2","2","0","0","0","2","1","0","0","0","1","2"
"Sibiu","45.8","24.15","9","0","0","0","0","0","0","9","3","1","0","0","4","1","1","7","0","9","5","1","3","0","0","9"
"Sibsāgar","26.98427","94.63784","1","0","0","0","0","0","0","1","0","0","0","1","1","0","0","0","1","1","0","0","1","0","0","1"
"Sibu","2.3","111.81667","1","0","0","0","0","0","0","1","0","0","0","0","0","0","1","0","0","1","0","0","1","0","0","1"
"Sidcup","51.42619","0.1036","7","0","0","0","0","0","1","8","1","1","6","0","8","1","1","6","0","8","0","4","4","0","0","8"
"Siddharthanagar","27.5","83.45","0","0","0","0","1","0","0","1","1","0","0","0","1","1","0","0","0","1","0","0","1","0","0","1"
"Sidi Slimane","34.26479","-5.92598","1","0","0","0","0","0","0","1","0","1","0","0","1","1","0","0","0","1","1","0","0","0","0","1"
"Sidmouth","50.69094","-3.2397","11","0","0","0","0","0","0","11","1","1","2","0","4","7","0","4","0","11","1","5","5","0","0","11"
"Sidoarjo","-7.4478","112.7183","0","1","0","0","0","0","0","1","0","0","1","0","1","0","0","1","0","1","0","0","1","0","0","1"
"Sidon","33.40818","-90.20397","1","1","0","0","0","0","0","2","1","1","0","0","2","1","0","1","0","2","0","1","1","0","0","2"
"Sidon","33.55751","35.37148","1","1","0","0","0","0","0","2","1","1","0","0","2","1","0","1","0","2","0","1","1","0","0","2"
"Siem Reap","13.36179","103.86056","4","0","0","0","0","0","0","4","0","3","0","1","4","1","2","0","1","4","1","0","0","0","3","4"
"Sighetu Marmaţiei","47.93195","23.88603","1","0","0","0","0","0","0","1","0","0","0","0","0","1","0","0","0","1","1","0","0","0","0","1"
"Sigmaringen","48.08829","9.23033","1","0","0","0","0","0","0","1","0","0","0","0","0","1","0","0","0","1","1","0","0","0","0","1"
"Silang","14.21567","120.97137","1","0","0","0","0","0","0","1","0","1","0","0","1","1","0","0","0","1","1","0","0","0","0","1"
"Silchester","51.35356","-1.10061","2","0","0","0","0","0","0","2","0","0","0","0","0","1","0","1","0","2","0","1","1","0","0","2"
"Sileby","52.73286","-1.10773","1","0","0","0","0","0","0","1","0","0","1","0","1","1","0","0","0","1","0","1","0","0","0","1"
"Siliguri","26.71004","88.42851","4","0","0","0","0","0","0","4","1","1","0","1","3","2","0","1","1","4","1","0","1","0","2","4"
"Silloth","54.8687","-3.38448","1","0","0","0","0","0","0","1","0","0","1","0","1","1","0","0","0","1","0","0","1","0","0","1"
"Silsden","53.91443","-1.93802","3","0","0","0","0","0","0","3","0","1","1","0","2","0","0","3","0","3","0","1","2","0","0","3"
"Silsoe","52.00854","-0.42484","2","0","0","0","0","0","0","2","0","2","0","0","2","2","0","0","0","2","2","0","0","0","0","2"
"Silver Spring","38.99067","-77.02609","2","0","0","0","0","0","0","2","0","1","1","0","2","2","0","0","0","2","1","1","0","0","0","2"
"Sinaia","45.35","25.55","1","0","0","0","0","0","0","1","0","0","1","0","1","0","0","1","0","1","0","1","0","0","0","1"
"Sinazongwe","-17.2614","27.46179","1","0","0","0","0","0","0","1","0","1","0","0","1","0","1","0","0","1","0","0","1","0","0","1"
"Sindi","58.40056","24.6675","0","1","0","0","0","0","0","1","0","0","0","1","1","0","0","1","0","1","0","0","1","0","0","1"
"Sindi","20.80509","78.88752","0","1","0","0","0","0","0","1","0","0","0","1","1","0","0","1","0","1","0","0","1","0","0","1"
"Singapore","1.28967","103.85007","14","0","0","0","0","0","1","15","2","5","2","1","10","7","7","0","1","15","3","2","7","3","0","15"
"Singkawang","0.90925","108.98463","0","1","0","0","0","0","0","1","1","0","0","0","1","0","1","0","0","1","0","0","1","0","0","1"
"Siniloan","14.4216","121.4463","1","0","0","0","0","0","0","1","1","0","0","0","1","0","0","1","0","1","0","0","1","0","0","1"
"Sinjai","-5.1241","120.253","0","0","0","1","0","0","0","1","0","0","0","0","0","1","0","0","0","1","0","0","1","0","0","1"
"Sint-Oedenrode","51.5675","5.45972","1","0","0","0","0","0","0","1","0","0","1","0","1","0","0","1","0","1","0","0","1","0","0","1"
"Sintra","38.80097","-9.37826","1","0","0","0","0","0","0","1","1","0","0","0","1","0","0","1","0","1","0","0","1","0","0","1"
"Siraha","26.65422","86.20795","0","1","0","0","0","0","0","1","0","1","0","0","1","0","1","0","0","1","0","0","1","0","0","1"
"Sirajganj","24.45771","89.70802","1","1","0","1","0","0","0","3","2","0","1","0","3","1","0","1","1","3","0","1","2","0","0","3"
"Sirsa","29.53489","75.02898","1","0","0","0","0","0","0","1","0","0","0","0","0","0","1","0","0","1","0","0","1","0","0","1"
"Sisteron","44.19002","5.94643","1","0","0","0","0","0","0","1","0","0","1","0","1","0","0","1","0","1","0","1","0","0","0","1"
"Siteki","-26.4525","31.94722","1","0","0","0","0","0","0","1","0","1","0","0","1","0","1","0","0","1","0","0","1","0","0","1"
"Sitia","35.20783","26.10467","1","0","0","0","0","0","0","1","0","1","0","0","1","0","0","1","0","1","1","0","0","0","0","1"
"Sittard","50.99833","5.86944","1","0","0","0","0","0","0","1","1","0","0","0","1","0","0","1","0","1","0","0","1","0","0","1"
"Sittingbourne","51.34128","0.73282","9","0","0","1","0","0","3","13","2","5","3","0","10","5","1","7","0","13","4","1","9","0","0","14"
"Sivas","39.74833","37.01611","1","0","0","0","0","0","0","1","0","1","0","0","1","0","0","1","0","1","0","0","0","0","1","1"
"Skardu","35.29787","75.63372","2","0","0","0","0","0","0","2","1","0","1","0","2","1","0","1","0","2","0","0","2","0","0","2"
"Skelmersdale","53.55024","-2.77348","14","1","0","0","2","0","0","17","2","6","8","0","16","5","2","9","0","16","4","8","4","0","0","16"
"Skidby","53.78921","-0.46131","3","0","0","0","0","0","0","3","0","0","3","0","3","2","0","1","0","3","0","0","3","0","0","3"
"Skierniewice","51.95485","20.15837","1","0","0","0","0","0","0","1","0","0","0","0","0","0","0","1","0","1","0","0","1","0","0","1"
"Skikda","36.87617","6.90921","2","0","0","0","0","0","0","2","0","0","1","0","1","2","0","0","0","2","1","0","1","0","0","2"
"Skipton","53.96144","-2.01676","6","0","0","1","0","0","1","8","1","2","3","0","6","4","1","3","0","8","2","1","5","0","0","8"
"Skipton","-37.686","143.36475","6","0","0","1","0","0","1","8","1","2","3","0","6","4","1","3","0","8","2","1","5","0","0","8"
"Skopje","41.99646","21.43141","31","0","0","0","0","0","0","31","2","8","2","2","14","11","4","16","0","31","15","1","11","0","4","31"
"Skövde","58.39118","13.84506","1","0","0","0","0","0","0","1","0","1","0","0","1","1","0","0","0","1","1","0","0","0","0","1"
"Skye","-38.10505","145.2163","0","0","0","0","1","0","0","1","0","1","0","0","1","0","1","0","0","1","0","1","0","0","0","1"
"Slavonski Brod","45.16028","18.01556","1","0","0","0","0","0","0","1","0","0","0","0","0","1","0","0","0","1","1","0","0","0","0","1"
"Sleaford","52.99826","-0.40941","4","0","0","0","0","0","0","4","0","1","3","0","4","2","0","2","0","4","0","1","2","0","1","4"
"Sliema","35.9125","14.50194","1","0","0","0","0","0","1","2","0","0","1","0","1","0","0","2","0","2","0","0","2","0","0","2"
"Sligo","41.10923","-79.49005","1","0","0","0","0","0","0","1","0","1","0","0","1","0","0","1","0","1","1","0","0","0","0","1"
"Sligo","54.26969","-8.46943","1","0","0","0","0","0","0","1","0","1","0","0","1","0","0","1","0","1","1","0","0","0","0","1"
"Slough","51.50949","-0.59541","23","0","0","1","3","0","2","29","8","4","8","0","20","9","2","18","0","29","6","4","16","1","1","28"
"Slovenj Gradec","46.51028","15.08056","1","0","0","0","0","0","0","1","0","0","0","0","0","0","0","1","0","1","1","0","0","0","0","1"
"Smethwick","52.49268","-1.96745","3","1","0","0","2","0","0","6","2","1","1","0","4","1","1","4","0","6","1","1","4","0","0","6"
"Smiltene","57.42444","25.90164","1","0","0","0","0","0","0","1","0","0","1","0","1","0","0","1","0","1","0","0","1","0","0","1"
"Smolensk","54.7818","32.0401","2","0","0","0","0","0","0","2","1","1","0","0","2","0","0","2","0","2","0","0","1","1","0","2"
"Sneads Ferry","34.55267","-77.39718","1","0","0","0","0","0","0","1","0","1","0","0","1","0","0","1","0","1","1","0","0","0","0","1"
"Snowmass Village","39.21304","-106.93782","1","0","0","0","0","0","0","1","0","0","1","0","1","0","0","1","0","1","0","0","0","0","1","1"
"Sofia","42.69751","23.32415","28","0","0","0","0","0","3","31","9","9","1","0","19","5","11","15","0","31","9","4","13","4","1","31"
"Sohag","26.55695","31.69478","3","2","0","0","0","0","0","5","3","1","0","0","4","1","3","1","0","5","2","2","1","0","0","5"
"Sohar","24.34745","56.70937","2","0","0","0","0","0","0","2","0","0","0","1","1","1","0","1","0","2","2","0","0","0","0","2"
"Soignies","50.57904","4.07129","0","1","0","0","0","0","0","1","0","0","1","0","1","0","0","1","0","1","0","1","0","0","0","1"
"Soio","-6.1349","12.36894","1","0","0","0","0","0","0","1","0","0","0","0","0","0","0","1","0","1","1","0","0","0","0","1"
"Soko Banja","43.64333","21.87111","1","0","0","0","0","0","0","1","0","1","0","0","1","0","1","0","0","1","1","0","0","0","0","1"
"Sokoto","13.06269","5.24322","3","0","0","0","0","0","0","3","0","3","0","0","3","2","1","0","0","3","0","0","2","0","1","3"
"Sole Street","51.38555","0.37843","1","0","0","0","0","0","0","1","0","0","0","0","0","1","0","0","0","1","0","0","1","0","0","1"
"Solihull","52.41426","-1.78094","40","2","0","0","2","0","1","45","10","11","17","1","39","15","3","27","0","45","5","10","30","0","0","45"
"Sollentuna","59.42804","17.95093","1","0","0","0","0","0","0","1","1","0","0","0","1","1","0","0","0","1","0","1","0","0","0","1"
"Solwezi","-12.1688","26.38938","1","0","0","0","0","0","0","1","1","0","0","0","1","0","0","1","0","1","0","1","0","0","0","1"
"Sombor","45.77417","19.11222","1","1","0","0","0","0","0","2","1","1","0","0","2","0","0","2","0","2","1","1","0","0","0","2"
"Somerton Park","-34.99705","138.52155","1","0","0","0","0","0","0","1","0","0","0","0","0","1","0","0","0","1","0","0","1","0","0","1"
"Somerville","30.34604","-96.5283","2","0","0","0","0","0","1","3","1","0","1","0","2","2","0","1","0","3","0","0","3","0","0","3"
"Somerville","35.2437","-89.35007","2","0","0","0","0","0","1","3","1","0","1","0","2","2","0","1","0","3","0","0","3","0","0","3"
"Somerville","34.47338","-86.7987","2","0","0","0","0","0","1","3","1","0","1","0","2","2","0","1","0","3","0","0","3","0","0","3"
"Somerville","40.57427","-74.60988","2","0","0","0","0","0","1","3","1","0","1","0","2","2","0","1","0","3","0","0","3","0","0","3"
"Somerville","42.3876","-71.0995","2","0","0","0","0","0","1","3","1","0","1","0","2","2","0","1","0","3","0","0","3","0","0","3"
"Somerville","44.30924","-69.48893","2","0","0","0","0","0","1","3","1","0","1","0","2","2","0","1","0","3","0","0","3","0","0","3"
"Somerville","-30.76979","121.45438","2","0","0","0","0","0","1","3","1","0","1","0","2","2","0","1","0","3","0","0","3","0","0","3"
"Somerville","-38.21667","145.16667","2","0","0","0","0","0","1","3","1","0","1","0","2","2","0","1","0","3","0","0","3","0","0","3"
"Songea","-10.68333","35.65","1","0","0","0","0","0","0","1","0","1","0","0","1","0","0","0","0","0","0","0","0","1","0","1"
"Sopron","47.68501","16.59049","1","0","0","0","0","0","0","1","0","1","0","0","1","0","0","1","0","1","1","0","0","0","0","1"
"Sopur","34.28671","74.47228","1","0","0","0","0","0","0","1","1","0","0","0","1","0","0","1","0","1","0","0","1","0","0","1"
"Soroti","1.71464","33.61113","1","0","0","0","0","0","0","1","0","0","0","0","0","0","0","1","0","1","0","0","0","0","1","1"
"Sousse","35.82539","10.63699","5","0","0","0","0","0","0","5","1","1","0","1","3","0","3","2","0","5","4","0","1","0","0","5"
"Southall","51.50896","-0.3713","1","0","0","0","0","0","0","1","1","0","0","0","1","0","1","0","0","1","0","0","1","0","0","1"
"Southam","52.25266","-1.3884","3","0","0","0","0","0","0","3","0","0","1","0","1","0","1","2","0","3","0","0","3","0","0","3"
"Southampton","42.22926","-72.73009","75","3","0","4","8","0","11","101","22","22","46","0","90","28","11","62","0","101","21","29","46","0","5","101"
"Southampton","40.88427","-72.38953","75","3","0","4","8","0","11","101","22","22","46","0","90","28","11","62","0","101","21","29","46","0","5","101"
"Southampton","50.90395","-1.40428","75","3","0","4","8","0","11","101","22","22","46","0","90","28","11","62","0","101","21","29","46","0","5","101"
"South Benfleet","51.55295","0.55962","4","1","0","0","0","0","0","5","1","2","2","0","5","3","0","2","0","5","1","1","3","0","0","5"
"South Boston","36.69875","-78.9014","1","0","0","0","0","0","0","1","0","0","0","0","0","0","1","0","0","1","0","0","1","0","0","1"
"South Boston","42.33343","-71.04949","1","0","0","0","0","0","0","1","0","0","0","0","0","0","1","0","0","1","0","0","1","0","0","1"
"South Bound Brook","40.55344","-74.53154","1","0","0","0","0","0","0","1","0","0","0","0","0","0","0","1","0","1","0","0","1","0","0","1"
"South Brisbane","-27.48034","153.02049","1","0","0","0","0","0","0","1","0","1","0","0","1","0","0","0","0","0","0","1","0","0","0","1"
"South Croydon","51.36217","-0.09421","11","2","0","1","2","0","2","18","5","3","9","1","18","5","1","11","1","18","0","9","9","0","0","18"
"South Elmsall","53.59709","-1.28034","1","0","0","0","0","0","0","1","0","1","0","0","1","0","0","1","0","1","1","0","0","0","0","1"
"Southend-on-Sea","51.53782","0.71433","36","3","1","4","4","0","3","51","12","13","17","0","42","17","5","28","0","50","9","14","27","0","0","50"
"Southminster","51.66228","0.82968","0","0","0","0","1","0","0","1","0","0","1","0","1","0","1","0","0","1","0","1","0","0","0","1"
"South Molton","51.01667","-3.83333","1","0","0","0","0","0","0","1","0","0","0","0","0","0","0","1","0","1","1","0","0","0","0","1"
"South Ockendon","51.50799","0.28333","3","0","0","0","0","0","0","3","2","0","0","0","2","1","1","1","0","3","0","1","2","0","0","3"
"Southport","39.66505","-86.12776","13","2","0","0","1","0","0","16","5","1","8","1","15","7","0","10","0","17","2","3","12","0","0","17"
"Southport","33.92156","-78.02027","13","2","0","0","1","0","0","16","5","1","8","1","15","7","0","10","0","17","2","3","12","0","0","17"
"Southport","42.0548","-76.81912","13","2","0","0","1","0","0","16","5","1","8","1","15","7","0","10","0","17","2","3","12","0","0","17"
"Southport","41.13649","-73.28345","13","2","0","0","1","0","0","16","5","1","8","1","15","7","0","10","0","17","2","3","12","0","0","17"
"Southport","43.84092","-69.65866","13","2","0","0","1","0","0","16","5","1","8","1","15","7","0","10","0","17","2","3","12","0","0","17"
"Southport","53.64581","-3.01008","13","2","0","0","1","0","0","16","5","1","8","1","15","7","0","10","0","17","2","3","12","0","0","17"
"Southport","-27.96724","153.39796","13","2","0","0","1","0","0","16","5","1","8","1","15","7","0","10","0","17","2","3","12","0","0","17"
"Southsea","50.79205","-1.08593","2","0","0","0","0","0","0","2","0","2","0","0","2","0","0","2","0","2","1","0","0","0","1","2"
"South Shields","54.99859","-1.4323","25","0","0","0","3","0","0","28","6","7","7","0","20","13","1","15","0","29","5","6","18","0","0","29"
"South Tangerang","-6.28862","106.71789","1","0","0","0","0","0","0","1","0","1","0","0","1","1","0","0","0","1","1","0","0","0","0","1"
"Southwell","53.07804","-0.95538","2","0","0","0","0","0","0","2","0","1","1","0","2","0","1","1","0","2","1","0","1","0","0","2"
"Southwick","42.05482","-72.77037","3","0","0","0","0","0","0","3","1","2","0","0","3","2","1","0","0","3","1","0","2","0","0","3"
"Southwick","51.29694","-2.2325","3","0","0","0","0","0","0","3","1","2","0","0","3","2","1","0","0","3","1","0","2","0","0","3"
"South Yarra","-37.83834","144.99149","0","0","0","0","1","0","0","1","0","0","1","0","1","1","0","0","0","1","0","0","1","0","0","1"
"Soweto","-26.26781","27.85849","1","0","0","0","0","0","0","1","0","1","0","0","1","0","0","1","0","1","1","0","0","0","0","1"
"Soyapango","13.71024","-89.13989","1","0","0","0","0","0","0","1","1","0","0","0","1","0","0","1","0","1","0","0","1","0","0","1"
"Spalding","52.78709","-0.15141","5","0","0","0","0","0","0","5","0","2","2","1","5","4","0","1","0","5","2","2","0","0","1","5"
"Spalding","-28.73525","114.63651","5","0","0","0","0","0","0","5","0","2","2","1","5","4","0","1","0","5","2","2","0","0","1","5"
"Sparks","39.53491","-119.75269","1","0","0","0","0","0","0","1","0","0","0","0","0","1","0","0","0","1","0","0","1","0","0","1"
"Sparks","31.67261","-106.2397","1","0","0","0","0","0","0","1","0","0","0","0","0","1","0","0","0","1","0","0","1","0","0","1"
"Sparks","30.92852","-97.35972","1","0","0","0","0","0","0","1","0","0","0","0","0","1","0","0","0","1","0","0","1","0","0","1"
"Sparks","31.16686","-83.43738","1","0","0","0","0","0","0","1","0","0","0","0","0","1","0","0","0","1","0","0","1","0","0","1"
"Sparks","33.08793","-82.73764","1","0","0","0","0","0","0","1","0","0","0","0","0","1","0","0","0","1","0","0","1","0","0","1"
"Spennymoor","54.6988","-1.60229","1","0","0","0","0","0","0","1","0","0","1","0","1","0","0","1","0","1","0","0","1","0","0","1"
"Spilsby","53.17363","0.09373","1","0","0","0","0","0","0","1","0","1","0","0","1","0","0","1","0","1","0","1","0","0","0","1"
"Split","43.50891","16.43915","4","0","0","0","0","0","0","4","0","2","0","0","2","1","1","2","0","4","2","0","0","0","2","4"
"Spokane","47.65966","-117.42908","4","0","0","0","0","0","0","4","1","0","2","0","3","2","1","1","0","4","1","2","1","0","0","4"
"Springfield","44.04624","-123.02203","2","1","0","0","0","0","0","3","0","3","0","0","3","0","1","2","0","3","1","0","2","0","0","3"
"Springfield","37.40835","-102.61436","2","1","0","0","0","0","0","3","0","3","0","0","3","0","1","2","0","3","1","0","2","0","0","3"
"Springfield","42.85417","-97.89729","2","1","0","0","0","0","0","3","0","3","0","0","3","0","1","2","0","3","1","0","2","0","0","3"
"Springfield","41.08194","-96.13446","2","1","0","0","0","0","0","3","0","3","0","0","3","0","1","2","0","3","1","0","2","0","0","3"
"Springfield","44.23885","-94.97582","2","1","0","0","0","0","0","3","0","3","0","0","3","0","1","2","0","3","1","0","2","0","0","3"
"Springfield","37.21533","-93.29824","2","1","0","0","0","0","0","3","0","3","0","0","3","0","1","2","0","3","1","0","2","0","0","3"
"Springfield","39.80172","-89.64371","2","1","0","0","0","0","0","3","0","3","0","0","3","0","1","2","0","3","1","0","2","0","0","3"
"Springfield","36.50921","-86.885","2","1","0","0","0","0","0","3","0","3","0","0","3","0","1","2","0","3","1","0","2","0","0","3"
"Springfield","30.15326","-85.61132","2","1","0","0","0","0","0","3","0","3","0","0","3","0","1","2","0","3","1","0","2","0","0","3"
"Springfield","42.32643","-85.23916","2","1","0","0","0","0","0","3","0","3","0","0","3","0","1","2","0","3","1","0","2","0","0","3"
"Springfield","37.68534","-85.22218","2","1","0","0","0","0","0","3","0","3","0","0","3","0","1","2","0","3","1","0","2","0","0","3"
"Springfield","39.92423","-83.80882","2","1","0","0","0","0","0","3","0","3","0","0","3","0","1","2","0","3","1","0","2","0","0","3"
"Springfield","32.37241","-81.3115","2","1","0","0","0","0","0","3","0","3","0","0","3","0","1","2","0","3","1","0","2","0","0","3"
"Springfield","33.49682","-81.27927","2","1","0","0","0","0","0","3","0","3","0","0","3","0","1","2","0","3","1","0","2","0","0","3"
"Springfield","38.78928","-77.1872","2","1","0","0","0","0","0","3","0","3","0","0","3","0","1","2","0","3","1","0","2","0","0","3"
"Springfield","39.93067","-75.32019","2","1","0","0","0","0","0","3","0","3","0","0","3","0","1","2","0","3","1","0","2","0","0","3"
"Springfield","42.83618","-74.85348","2","1","0","0","0","0","0","3","0","3","0","0","3","0","1","2","0","3","1","0","2","0","0","3"
"Springfield","40.70491","-74.31723","2","1","0","0","0","0","0","3","0","3","0","0","3","0","1","2","0","3","1","0","2","0","0","3"
"Springfield","42.10148","-72.58981","2","1","0","0","0","0","0","3","0","3","0","0","3","0","1","2","0","3","1","0","2","0","0","3"
"Springfield","43.29841","-72.48231","2","1","0","0","0","0","0","3","0","3","0","0","3","0","1","2","0","3","1","0","2","0","0","3"
"Springfield","43.49507","-72.03342","2","1","0","0","0","0","0","3","0","3","0","0","3","0","1","2","0","3","1","0","2","0","0","3"
"Springfield","56.29509","-3.0612","2","1","0","0","0","0","0","3","0","3","0","0","3","0","1","2","0","3","1","0","2","0","0","3"
"Springfield","-34.97819","138.63249","2","1","0","0","0","0","0","3","0","3","0","0","3","0","1","2","0","3","1","0","2","0","0","3"
"Springfield","-27.65365","152.91716","2","1","0","0","0","0","0","3","0","3","0","0","3","0","1","2","0","3","1","0","2","0","0","3"
"Spring Lake","43.07696","-86.197","0","0","0","0","1","0","0","1","0","0","1","0","1","1","0","0","0","1","0","0","1","0","0","1"
"Spring Lake","35.16794","-78.97281","0","0","0","0","1","0","0","1","0","0","1","0","1","1","0","0","0","1","0","0","1","0","0","1"
"Spring Lake","40.15345","-74.02819","0","0","0","0","1","0","0","1","0","0","1","0","1","1","0","0","0","1","0","0","1","0","0","1"
"Springs","41.01621","-72.15924","1","0","0","0","0","0","0","1","0","1","0","0","1","0","1","0","0","1","1","0","0","0","0","1"
"Springs","-26.25","28.4","1","0","0","0","0","0","0","1","0","1","0","0","1","0","1","0","0","1","1","0","0","0","0","1"
"Squamish","49.69925","-123.15631","1","0","0","0","0","0","0","1","0","0","0","0","0","0","0","1","0","1","0","0","1","0","0","1"
"Srbac","45.0973","17.52331","1","0","0","0","0","0","0","1","1","0","0","0","1","0","0","1","0","1","0","0","1","0","0","1"
"Srikakulam","18.2989","83.89751","2","0","0","0","0","0","0","2","2","0","0","0","2","0","0","2","0","2","0","0","2","0","0","2"
"Srinagar","34.08565","74.80555","31","3","0","0","0","0","0","34","24","4","0","2","30","18","4","10","1","33","2","3","24","0","5","34"
"Stadhampton","51.68131","-1.13138","1","0","0","0","0","0","0","1","1","0","0","0","1","0","0","1","0","1","1","0","0","0","0","1"
"Stafford","45.35734","-122.72259","16","0","0","0","1","0","4","21","5","3","8","0","16","8","1","12","0","21","1","9","9","0","2","21"
"Stafford","37.96224","-98.60064","16","0","0","0","1","0","4","21","5","3","8","0","16","8","1","12","0","21","1","9","9","0","2","21"
"Stafford","29.61607","-95.55772","16","0","0","0","1","0","4","21","5","3","8","0","16","8","1","12","0","21","1","9","9","0","2","21"
"Stafford","38.42207","-77.40832","16","0","0","0","1","0","4","21","5","3","8","0","16","8","1","12","0","21","1","9","9","0","2","21"
"Stafford","41.98482","-72.28897","16","0","0","0","1","0","4","21","5","3","8","0","16","8","1","12","0","21","1","9","9","0","2","21"
"Stafford","52.80521","-2.11636","16","0","0","0","1","0","4","21","5","3","8","0","16","8","1","12","0","21","1","9","9","0","2","21"
"Stafford","-27.41044","153.01105","16","0","0","0","1","0","4","21","5","3","8","0","16","8","1","12","0","21","1","9","9","0","2","21"
"Staindrop","54.58102","-1.80708","0","0","0","0","1","0","0","1","0","0","1","0","1","0","0","1","0","1","0","1","0","0","0","1"
"Staines","51.43092","-0.50606","9","0","0","0","0","0","2","11","3","4","2","1","10","5","0","6","0","11","6","2","3","0","0","11"
"Stakeford","55.1611","-1.57529","1","0","0","0","0","0","0","1","0","0","0","0","0","0","0","1","0","1","1","0","0","0","0","1"
"St Albans","51.75","-0.33333","31","1","0","3","2","0","1","38","6","5","15","1","27","20","3","15","0","38","2","12","24","0","0","38"
"St Albans","-37.74496","144.80049","31","1","0","3","2","0","1","38","6","5","15","1","27","20","3","15","0","38","2","12","24","0","0","38"
"Stalybridge","53.48414","-2.05908","2","0","0","0","1","0","0","3","1","0","1","0","2","0","1","2","0","3","1","0","2","0","0","3"
"Stamford","32.94539","-99.80287","5","0","0","0","0","0","0","5","1","1","2","0","4","3","0","2","0","5","0","0","5","0","0","5"
"Stamford","42.4073","-74.61432","5","0","0","0","0","0","0","5","1","1","2","0","4","3","0","2","0","5","0","0","5","0","0","5"
"Stamford","41.05343","-73.53873","5","0","0","0","0","0","0","5","1","1","2","0","4","3","0","2","0","5","0","0","5","0","0","5"
"Stamford","52.65","-0.48333","5","0","0","0","0","0","0","5","1","1","2","0","4","3","0","2","0","5","0","0","5","0","0","5"
"Stanford-le-Hope","51.52274","0.43422","5","0","0","1","0","0","0","6","1","2","3","0","6","3","0","3","0","6","2","1","3","0","0","6"
"Stanley","48.31724","-102.39045","3","0","0","0","0","0","0","3","0","2","1","0","3","2","0","1","0","3","1","1","0","0","1","3"
"Stanley","44.95997","-90.93708","3","0","0","0","0","0","0","3","0","2","1","0","3","2","0","1","0","3","1","1","0","0","1","3"
"Stanley","35.35903","-81.09702","3","0","0","0","0","0","0","3","0","2","1","0","3","2","0","1","0","3","1","1","0","0","1","3"
"Stanley","38.5754","-78.50251","3","0","0","0","0","0","0","3","0","2","1","0","3","2","0","1","0","3","1","1","0","0","1","3"
"Stanley","-51.69382","-57.85701","3","0","0","0","0","0","0","3","0","2","1","0","3","2","0","1","0","3","1","1","0","0","1","3"
"Stanley","56.4854","-3.45184","3","0","0","0","0","0","0","3","0","2","1","0","3","2","0","1","0","3","1","1","0","0","1","3"
"Stanley","54.86796","-1.69846","3","0","0","0","0","0","0","3","0","2","1","0","3","2","0","1","0","3","1","1","0","0","1","3"
"Stanley","-40.76064","145.29555","3","0","0","0","0","0","0","3","0","2","1","0","3","2","0","1","0","3","1","1","0","0","1","3"
"Stanmore","51.61667","-0.31667","1","1","0","0","0","0","0","2","0","0","0","0","0","1","0","1","0","2","0","0","2","0","0","2"
"Stanmore","-33.89407","151.16424","1","1","0","0","0","0","0","2","0","0","0","0","0","1","0","1","0","2","0","0","2","0","0","2"
"Stansted Mountfitchet","51.9","0.2","2","0","0","0","1","0","0","3","0","1","1","0","2","1","0","2","0","3","0","1","2","0","0","3"
"St Anton am Arlberg","47.1275","10.26372","0","0","0","0","0","0","1","1","0","0","1","0","1","0","1","0","0","1","0","1","0","0","0","1"
"Staplecross","50.97356","0.53576","0","0","0","0","0","0","1","1","0","0","1","0","1","1","0","0","0","1","0","0","1","0","0","1"
"Staplehurst","51.1611","0.55249","0","0","0","0","1","0","0","1","0","0","1","0","1","0","0","1","0","1","0","1","0","0","0","1"
"State College","40.79339","-77.86","1","0","0","0","0","0","0","1","0","1","0","0","1","1","0","0","0","1","0","0","1","0","0","1"
"Staten Island","40.56233","-74.13986","0","0","0","0","0","0","1","1","0","0","1","0","1","1","0","0","0","1","0","0","1","0","0","1"
"Statesville","35.78264","-80.8873","1","0","0","0","0","0","0","1","0","0","0","0","0","1","0","0","0","1","0","0","1","0","0","1"
"Stattegg","47.13333","15.41667","1","0","0","0","0","0","0","1","0","0","0","0","0","0","1","0","0","1","1","0","0","0","0","1"
"St Austell","50.3425","-4.77442","7","0","0","0","0","0","0","7","0","3","2","1","6","1","2","4","0","7","4","1","1","0","1","7"
"Stavanger","58.97005","5.73332","1","0","0","0","0","0","0","1","0","1","0","0","1","1","0","0","0","1","0","0","1","0","0","1"
"Stavropol’","45.0428","41.9734","1","0","0","0","0","0","0","1","0","0","0","1","1","0","0","0","1","1","1","0","0","0","0","1"
"St. Catharines","43.17126","-79.24267","6","0","0","0","1","0","0","7","1","1","5","0","7","2","1","4","0","7","1","2","4","0","0","7"
"St. Charles","38.60728","-76.92478","1","0","0","0","0","0","0","1","0","1","0","0","1","0","1","0","0","1","0","1","0","0","0","1"
"Steenwijk","52.7875","6.12083","1","0","0","0","0","0","0","1","0","0","1","0","1","0","0","1","0","1","0","0","1","0","0","1"
"Stekene","51.2099","4.03651","1","0","0","0","0","0","0","1","0","0","1","0","1","0","1","0","0","1","0","1","0","0","0","1"
"Stenhousemuir","56.02676","-3.81462","1","0","0","0","0","0","0","1","0","1","0","0","1","1","0","0","0","1","1","0","0","0","0","1"
"Stephanskirchen","47.85389","12.1856","0","0","0","0","0","0","1","1","1","0","0","0","1","0","0","1","0","1","0","0","1","0","0","1"
"Sterling Heights","42.58031","-83.0302","1","0","0","0","0","0","0","1","1","0","0","0","1","1","0","0","0","1","0","0","1","0","0","1"
"Stevenage","51.90224","-0.20256","12","0","0","3","1","0","1","17","3","8","5","0","16","6","4","7","0","17","3","2","12","0","0","17"
"Stevenston","55.6397","-4.75339","3","0","0","0","1","0","1","5","1","0","2","0","3","1","1","2","0","4","1","3","1","0","0","5"
"Stewarton","55.67986","-4.51435","2","0","0","0","0","0","0","2","0","0","2","0","2","0","0","2","0","2","0","1","1","0","0","2"
"Stewkley","51.92744","-0.76381","0","0","0","0","1","0","0","1","1","0","0","0","1","1","0","0","0","1","0","0","1","0","0","1"
"Steyning","50.88744","-0.32787","1","0","0","0","0","0","0","1","0","0","1","0","1","0","0","1","0","1","0","1","0","0","0","1"
"St Helens","53.45","-2.73333","13","1","0","3","1","0","2","20","8","6","4","0","18","5","4","11","0","20","5","3","11","0","1","20"
"St Helens","-41.32028","148.23889","13","1","0","3","1","0","2","20","8","6","4","0","18","5","4","11","0","20","5","3","11","0","1","20"
"St. Helens","50.69688","-1.11159","2","0","0","0","0","0","0","2","0","1","1","0","2","1","0","1","0","2","1","0","1","0","0","2"
"Stirling","44.30012","-77.54948","10","0","0","0","1","0","0","11","2","5","4","0","11","2","4","4","0","10","4","4","2","0","1","11"
"Stirling","56.11903","-3.93682","10","0","0","0","1","0","0","11","2","5","4","0","11","2","4","4","0","10","4","4","2","0","1","11"
"Stirling","-31.88343","115.8099","10","0","0","0","1","0","0","11","2","5","4","0","11","2","4","4","0","10","4","4","2","0","1","11"
"Stirling","-35.0022","138.71956","10","0","0","0","1","0","0","11","2","5","4","0","11","2","4","4","0","10","4","4","2","0","1","11"
"Stirling","-35.34969","149.0493","10","0","0","0","1","0","0","11","2","5","4","0","11","2","4","4","0","10","4","4","2","0","1","11"
"St Ives","50.20861","-5.4875","7","0","0","0","1","0","0","8","3","1","4","0","8","3","0","5","0","8","0","2","5","0","1","8"
"St Kilda West","-37.85988","144.97108","1","0","0","0","0","0","0","1","0","1","0","0","1","0","1","0","0","1","0","0","1","0","0","1"
"St Leonards","50.83077","-1.84377","5","0","0","0","0","0","1","6","1","4","1","0","6","4","0","2","0","6","1","1","2","0","2","6"
"St Leonards","-33.82344","151.19836","5","0","0","0","0","0","1","6","1","4","1","0","6","4","0","2","0","6","1","1","2","0","2","6"
"St. Louis","38.62727","-90.19789","1","0","0","0","0","0","0","1","0","1","0","0","1","0","1","0","0","1","1","0","0","0","0","1"
"St Martin","49.43713","-2.55479","1","0","0","0","0","0","0","1","0","0","0","0","0","0","0","1","0","1","0","1","0","0","0","1"
"Stockbridge","44.07166","-88.29899","1","0","0","0","0","0","0","1","0","1","0","0","1","0","0","1","0","1","0","0","1","0","0","1"
"Stockbridge","33.54428","-84.23381","1","0","0","0","0","0","0","1","0","1","0","0","1","0","0","1","0","1","0","0","1","0","0","1"
"Stockbridge","42.45115","-84.18051","1","0","0","0","0","0","0","1","0","1","0","0","1","0","0","1","0","1","0","0","1","0","0","1"
"Stockbridge","42.28759","-73.32039","1","0","0","0","0","0","0","1","0","1","0","0","1","0","0","1","0","1","0","0","1","0","0","1"
"Stockbridge","51.11398","-1.48839","1","0","0","0","0","0","0","1","0","1","0","0","1","0","0","1","0","1","0","0","1","0","0","1"
"Stockholm","59.32938","18.06871","18","1","0","2","0","0","1","22","0","4","7","4","15","11","6","3","2","22","1","2","13","1","4","21"
"Stockport","53.40979","-2.15761","63","1","0","4","5","0","5","78","19","20","26","3","68","30","15","33","0","78","13","24","39","0","2","78"
"Stockton","37.9577","-121.29078","6","1","0","1","0","0","0","8","3","4","1","0","8","6","1","1","0","8","3","1","4","0","0","8"
"Stockton","40.45272","-112.36078","6","1","0","1","0","0","0","8","3","4","1","0","8","6","1","1","0","8","3","1","4","0","0","8"
"Stockton","39.43807","-99.2651","6","1","0","1","0","0","0","8","3","4","1","0","8","6","1","1","0","8","3","1","4","0","0","8"
"Stockton","37.69893","-93.79604","6","1","0","1","0","0","0","8","3","4","1","0","8","6","1","1","0","8","3","1","4","0","0","8"
"Stockton","44.02746","-91.76987","6","1","0","1","0","0","0","8","3","4","1","0","8","6","1","1","0","8","3","1","4","0","0","8"
"Stockton","42.34974","-90.00679","6","1","0","1","0","0","0","8","3","4","1","0","8","6","1","1","0","8","3","1","4","0","0","8"
"Stockton","40.40788","-74.97822","6","1","0","1","0","0","0","8","3","4","1","0","8","6","1","1","0","8","3","1","4","0","0","8"
"Stockton","51.14528","-2.03194","6","1","0","1","0","0","0","8","3","4","1","0","8","6","1","1","0","8","3","1","4","0","0","8"
"Stockton","52.27181","-1.36055","6","1","0","1","0","0","0","8","3","4","1","0","8","6","1","1","0","8","3","1","4","0","0","8"
"Stockton","-32.90908","151.7836","6","1","0","1","0","0","0","8","3","4","1","0","8","6","1","1","0","8","3","1","4","0","0","8"
"Stockton-on-Tees","54.56848","-1.3187","9","1","0","0","3","0","0","13","4","0","7","0","11","4","3","6","0","13","2","2","9","0","0","13"
"Stoke","53.25","-2.86667","9","0","0","1","1","0","0","11","0","4","5","0","9","5","2","4","0","11","4","2","3","0","2","11"
"Stokenchurch","51.65831","-0.8974","1","0","0","0","0","0","0","1","0","0","1","0","1","0","0","1","0","1","0","1","0","0","0","1"
"Stoke-on-Trent","53.00415","-2.18538","31","2","0","1","5","0","1","40","9","18","10","0","37","11","10","19","0","40","10","14","14","0","2","40"
"Stoke Poges","51.54441","-0.5888","1","0","0","0","0","0","0","1","0","1","0","0","1","1","0","0","0","1","0","1","0","0","0","1"
"Stokesley","54.46998","-1.1933","1","0","0","0","0","0","0","1","1","0","0","0","1","1","0","0","0","1","0","0","1","0","0","1"
"Stone","52.36667","-2.2","3","0","0","0","0","0","1","4","0","2","0","0","2","0","1","3","0","4","2","2","0","0","0","4"
"Stone","52.9059","-2.15409","3","0","0","0","0","0","1","4","0","2","0","0","2","0","1","3","0","4","2","2","0","0","0","4"
"Stone","51.80246","-0.87032","3","0","0","0","0","0","1","4","0","2","0","0","2","0","1","3","0","4","2","2","0","0","0","4"
"Stone","51.45032","0.2647","3","0","0","0","0","0","1","4","0","2","0","0","2","0","1","3","0","4","2","2","0","0","0","4"
"Stone","51","0.76667","3","0","0","0","0","0","1","4","0","2","0","0","2","0","1","3","0","4","2","2","0","0","0","4"
"Stonehaven","56.96365","-2.21177","5","0","0","0","0","0","0","5","0","2","4","0","6","0","2","4","0","6","0","1","5","0","0","6"
"Stonehouse","55.69435","-3.9878","4","0","0","0","0","0","1","5","0","2","3","0","5","2","0","3","0","5","2","0","2","1","0","5"
"Stonehouse","51.75","-2.28333","4","0","0","0","0","0","1","5","0","2","3","0","5","2","0","3","0","5","2","0","2","1","0","5"
"Stony Stratford","52.05682","-0.85281","2","0","0","0","0","0","0","2","0","0","0","0","0","2","0","0","0","2","0","2","0","0","0","2"
"Stornoway","58.20925","-6.38649","3","0","0","0","0","0","0","3","0","2","1","0","3","0","1","2","0","3","2","1","0","0","0","3"
"Storrington","50.91765","-0.45473","3","0","0","0","0","0","0","3","0","0","2","0","2","2","0","1","0","3","0","1","2","0","0","3"
"Stotfold","52.01632","-0.23209","3","0","0","0","0","0","0","3","1","1","0","0","2","1","1","1","0","3","2","0","1","0","0","3"
"Stourbridge","52.45608","-2.14317","17","0","0","0","0","0","2","19","2","9","7","0","18","4","4","11","0","19","7","3","9","0","0","19"
"Stourport-on-Severn","52.33976","-2.28034","5","1","0","0","1","0","0","7","1","3","2","0","6","3","0","4","0","7","4","1","2","0","0","7"
"Stowmarket","52.18893","0.99774","4","0","0","0","0","0","0","4","1","2","1","0","4","3","0","1","0","4","0","1","3","0","0","4"
"Strabane","54.82373","-7.46916","2","0","0","0","0","0","0","2","0","1","1","0","2","0","1","1","0","2","1","0","1","0","0","2"
"Stranraer","54.90234","-5.02731","0","0","0","0","1","0","0","1","0","0","1","0","1","1","0","0","0","1","0","0","1","0","0","1"
"Strasbourg","48.58392","7.74553","3","0","0","0","0","0","0","3","0","3","0","0","3","1","1","1","0","3","0","0","0","1","2","3"
"Stratford-upon-Avon","52.19166","-1.70734","8","0","0","1","1","0","0","10","1","2","5","0","8","1","0","9","0","10","0","2","7","0","1","10"
"Street","51.12472","-2.74","4","0","0","0","0","0","0","4","0","1","3","0","4","1","0","3","0","4","0","0","4","0","0","4"
"Stroud","35.74868","-96.65807","15","1","0","0","2","0","0","18","5","6","3","0","14","4","4","10","0","18","2","4","12","0","0","18"
"Stroud","51.75","-2.2","15","1","0","0","2","0","0","18","5","6","3","0","14","4","4","10","0","18","2","4","12","0","0","18"
"Stroud","-32.40366","151.96699","15","1","0","0","2","0","0","18","5","6","3","0","14","4","4","10","0","18","2","4","12","0","0","18"
"Struga","41.17799","20.67784","1","1","0","0","0","0","0","2","0","2","0","0","2","0","0","2","0","2","2","0","0","0","0","2"
"Stuartfield","57.50303","-2.04637","1","0","0","0","0","0","0","1","0","0","0","0","0","0","1","0","0","1","0","1","0","0","0","1"
"Studio City","34.14862","-118.39647","1","0","0","0","0","0","0","1","0","0","0","0","0","1","0","0","0","1","0","0","1","0","0","1"
"Stupina","44.56427","28.18171","1","0","0","0","0","0","0","1","0","0","0","1","1","0","1","0","0","1","0","0","1","0","0","1"
"Sturminster Newton","50.92681","-2.30515","2","0","0","0","0","0","0","2","0","0","2","0","2","0","1","1","0","2","0","2","0","0","0","2"
"Stuttgart","34.50037","-91.55263","2","0","0","0","0","0","0","2","1","1","0","0","2","0","1","1","0","2","1","0","0","1","0","2"
"Stuttgart","48.78232","9.17702","2","0","0","0","0","0","0","2","1","1","0","0","2","0","1","1","0","2","1","0","0","1","0","2"
"Stuttgart-Ost","48.78363","9.21032","0","1","0","0","0","0","0","1","0","0","1","0","1","1","0","0","0","1","0","0","1","0","0","1"
"Subang Jaya","3.04384","101.58062","1","0","0","0","0","0","0","1","0","0","1","0","1","1","0","0","0","1","0","0","1","0","0","1"
"Subiaco","35.29287","-93.63464","1","0","0","0","0","0","0","1","0","1","0","0","1","1","0","0","0","1","0","0","1","0","0","1"
"Subiaco","41.92619","13.08906","1","0","0","0","0","0","0","1","0","1","0","0","1","1","0","0","0","1","0","0","1","0","0","1"
"Subiaco","-31.9485","115.8268","1","0","0","0","0","0","0","1","0","1","0","0","1","1","0","0","0","1","0","0","1","0","0","1"
"Subotica","46.1","19.66667","3","0","0","0","0","0","0","3","1","0","1","0","2","1","1","1","0","3","2","0","1","0","0","3"
"Suceava","47.63333","26.25","1","1","0","1","0","0","1","4","2","1","0","1","4","2","1","1","0","4","2","1","1","0","0","4"
"Sudbury","42.38343","-71.41617","7","0","0","0","0","0","1","8","3","2","2","0","7","3","0","5","0","8","1","3","4","0","0","8"
"Sudbury","52.0389","0.73117","7","0","0","0","0","0","1","8","3","2","2","0","7","3","0","5","0","8","1","3","4","0","0","8"
"Suffolk","36.72836","-76.58496","1","0","0","0","0","0","0","1","0","0","0","0","0","1","0","0","0","1","1","0","0","0","0","1"
"Suhum","6.04089","-0.45004","0","0","0","0","0","0","0","0","0","0","0","0","0","0","0","0","0","0","0","0","0","0","0","0"
"Suisun","38.23825","-122.04024","1","0","0","0","0","0","0","1","0","1","0","0","1","0","0","1","0","1","0","0","1","0","0","1"
"Sukkur","27.70323","68.85889","9","0","0","0","0","0","0","9","0","4","5","0","9","2","0","7","0","9","1","0","5","0","3","9"
"Sunbury-on-Thames","51.40424","-0.41817","3","0","0","0","1","0","2","6","1","3","2","0","6","2","0","4","0","6","1","1","4","0","0","6"
"Sunderland","42.24454","-71.77174","52","0","0","2","7","0","2","63","14","15","21","1","51","25","5","29","4","63","16","16","27","1","3","63"
"Sunderland","54.90465","-1.38222","52","0","0","2","7","0","2","63","14","15","21","1","51","25","5","29","4","63","16","16","27","1","3","63"
"Sungai Petani","5.647","100.48772","0","1","0","0","0","0","0","1","0","0","1","0","1","0","0","1","0","1","0","0","1","0","0","1"
"Sunningdale","51.39878","-0.62944","2","0","0","0","1","0","0","3","0","1","2","0","3","0","1","2","0","3","1","0","2","0","0","3"
"Sunnyvale","37.36883","-122.03635","3","0","0","0","0","0","0","3","0","1","1","0","2","1","0","2","0","3","0","0","3","0","0","3"
"Sunnyvale","32.79652","-96.56082","3","0","0","0","0","0","0","3","0","1","1","0","2","1","0","2","0","3","0","0","3","0","0","3"
"Sunyani","7.33991","-2.32676","5","0","0","0","0","0","0","5","0","4","0","1","5","2","2","2","0","6","0","0","2","1","2","5"
"Sur","37.91351","40.22859","3","0","0","0","0","0","0","3","0","1","0","0","1","1","2","0","0","3","1","0","1","0","1","3"
"Sur","22.56667","59.52889","3","0","0","0","0","0","0","3","0","1","0","0","1","1","2","0","0","3","1","0","1","0","1","3"
"Surab","28.49276","66.25999","1","0","0","0","0","0","0","1","1","0","0","0","1","1","0","0","0","1","0","0","0","0","0","0"
"Surabaya","-4.67122","105.72571","4","0","0","0","0","0","0","4","2","0","2","0","4","2","0","2","0","4","1","1","2","0","0","4"
"Surabaya","-7.0259","108.0209","4","0","0","0","0","0","0","4","2","0","2","0","4","2","0","2","0","4","1","1","2","0","0","4"
"Surabaya","-7.24917","112.75083","4","0","0","0","0","0","0","4","2","0","2","0","4","2","0","2","0","4","1","1","2","0","0","4"
"Surajpur","23.21347","82.86836","1","0","0","0","0","0","0","1","1","0","0","0","1","0","0","1","0","1","0","0","1","0","0","1"
"Surbiton","51.39148","-0.29825","11","0","0","1","5","0","1","18","3","5","3","0","11","3","2","13","0","18","1","3","14","0","0","18"
"Surendranagar","22.72706","71.64856","1","0","0","0","0","0","0","1","0","0","0","0","0","1","0","0","0","1","0","0","1","0","0","1"
"Surin","46.46098","-0.46324","1","0","0","0","0","0","0","1","0","0","0","0","0","1","0","0","0","1","1","0","0","0","0","1"
"Surin","14.88181","103.49364","1","0","0","0","0","0","0","1","0","0","0","0","0","1","0","0","0","1","1","0","0","0","0","1"
"Surkhet","28.51746","81.7787","2","0","0","0","0","0","0","2","2","0","0","0","2","2","0","0","0","2","0","0","1","0","1","2"
"Surrey Hills","-37.81667","145.1","1","0","0","0","0","0","0","1","0","1","0","0","1","0","0","1","0","1","1","0","0","0","0","1"
"Sutton","40.60557","-97.85921","22","0","0","3","4","0","3","32","12","7","9","0","28","7","5","20","0","32","7","8","16","1","0","32"
"Sutton","38.66454","-80.70982","22","0","0","3","4","0","3","32","12","7","9","0","28","7","5","20","0","32","7","8","16","1","0","32"
"Sutton","45.10008","-72.61582","22","0","0","3","4","0","3","32","12","7","9","0","28","7","5","20","0","32","7","8","16","1","0","32"
"Sutton","43.33424","-71.95147","22","0","0","3","4","0","3","32","12","7","9","0","28","7","5","20","0","32","7","8","16","1","0","32"
"Sutton","42.1501","-71.76285","22","0","0","3","4","0","3","32","12","7","9","0","28","7","5","20","0","32","7","8","16","1","0","32"
"Sutton","53.38947","-6.11059","22","0","0","3","4","0","3","32","12","7","9","0","28","7","5","20","0","32","7","8","16","1","0","32"
"Sutton","52.1","-2.68333","22","0","0","3","4","0","3","32","12","7","9","0","28","7","5","20","0","32","7","8","16","1","0","32"
"Sutton","52.11078","-0.2138","22","0","0","3","4","0","3","32","12","7","9","0","28","7","5","20","0","32","7","8","16","1","0","32"
"Sutton","51.35","-0.2","22","0","0","3","4","0","3","32","12","7","9","0","28","7","5","20","0","32","7","8","16","1","0","32"
"Sutton","52.38804","0.11866","22","0","0","3","4","0","3","32","12","7","9","0","28","7","5","20","0","32","7","8","16","1","0","32"
"Sutton","-35.16667","149.25","22","0","0","3","4","0","3","32","12","7","9","0","28","7","5","20","0","32","7","8","16","1","0","32"
"Sutton Coldfield","52.56667","-1.81667","26","0","0","0","2","0","2","30","4","3","8","1","16","14","3","13","0","30","6","8","14","0","2","30"
"Sutton in Ashfield","53.12542","-1.26135","1","0","0","0","0","0","1","2","1","0","1","0","2","2","0","0","0","2","1","0","1","0","0","2"
"Suva","-18.14161","178.44149","13","0","0","0","0","0","0","13","0","9","1","2","12","11","2","0","0","13","4","0","3","2","4","13"
"Suva Reka","42.35861","20.825","7","0","0","0","0","0","0","7","0","1","0","0","1","6","0","1","0","7","6","0","1","0","0","7"
"Svay Rieng","11.08785","105.79935","1","0","0","0","0","0","0","1","0","1","0","0","1","0","1","0","0","1","0","0","0","0","1","1"
"Sveti Nikole","41.86956","21.95274","1","0","0","0","0","0","0","1","0","1","0","0","1","1","0","0","0","1","1","0","0","0","0","1"
"Swabi","34.12018","72.46982","5","0","0","0","1","0","0","6","2","0","2","0","4","1","3","2","0","6","1","0","3","0","2","6"
"Swadlincote","52.774","-1.55744","7","1","0","0","0","0","0","8","0","3","3","0","6","3","1","4","0","8","0","2","6","0","0","8"
"Swampscott","42.47093","-70.91755","0","0","0","1","0","0","0","1","1","0","0","0","1","0","0","1","0","1","0","0","1","0","0","1"
"Swanage","50.60827","-1.95664","2","0","0","0","0","0","0","2","0","0","1","0","1","0","1","1","0","2","1","0","1","0","0","2"
"Swanley","51.39717","0.17321","1","0","0","0","1","0","1","3","1","1","1","0","3","0","1","2","0","3","1","1","1","0","0","3"
"Swanmore","50.94404","-1.18021","1","0","0","0","0","0","0","1","0","0","1","0","1","1","0","0","0","1","0","0","1","0","0","1"
"Swanscombe","51.44713","0.31028","0","0","0","0","0","0","1","1","0","0","1","0","1","1","0","0","0","1","0","1","0","0","0","1"
"Swansea","38.53394","-89.98899","93","5","0","5","12","0","5","120","26","45","41","3","115","47","12","59","2","120","39","31","46","1","2","119"
"Swansea","33.73821","-81.09787","93","5","0","5","12","0","5","120","26","45","41","3","115","47","12","59","2","120","39","31","46","1","2","119"
"Swansea","41.74816","-71.18977","93","5","0","5","12","0","5","120","26","45","41","3","115","47","12","59","2","120","39","31","46","1","2","119"
"Swansea","51.62079","-3.94323","93","5","0","5","12","0","5","120","26","45","41","3","115","47","12","59","2","120","39","31","46","1","2","119"
"Swansea","-42.12284","148.07434","93","5","0","5","12","0","5","120","26","45","41","3","115","47","12","59","2","120","39","31","46","1","2","119"
"Swansea","-33.08765","151.63745","93","5","0","5","12","0","5","120","26","45","41","3","115","47","12","59","2","120","39","31","46","1","2","119"
"Swedru","5.53711","-0.69984","1","0","0","0","0","0","0","1","0","0","0","1","1","1","0","0","0","1","0","0","1","0","0","1"
"Swieqi","35.9225","14.48","1","0","0","0","0","0","0","1","0","0","1","0","1","0","0","1","0","1","0","1","0","0","0","1"
"Swindon","51.92363","-2.09839","24","0","0","1","5","0","1","31","4","13","11","0","28","11","8","12","0","31","6","4","20","1","0","31"
"Swindon","51.55797","-1.78116","24","0","0","1","5","0","1","31","4","13","11","0","28","11","8","12","0","31","6","4","20","1","0","31"
"Swords","53.45972","-6.21806","1","0","0","0","0","0","0","1","0","1","0","0","1","1","0","0","0","1","0","0","0","1","0","1"
"Sydney","46.1351","-60.1831","19","0","0","0","0","0","0","19","5","3","7","0","15","8","4","7","0","19","3","5","9","1","1","19"
"Sydney","-33.86785","151.20732","19","0","0","0","0","0","0","19","5","3","7","0","15","8","4","7","0","19","3","5","9","1","1","19"
"Sydney Central Business District","-33.86482","151.20773","1","0","0","0","0","0","0","1","1","0","0","0","1","0","1","0","0","1","0","0","1","0","0","1"
"Sylhet","24.89904","91.87198","16","1","0","0","0","0","0","17","7","3","3","0","13","7","6","3","0","16","3","1","10","0","4","18"
"Szczecin","53.42894","14.55302","3","0","0","0","0","0","0","3","1","1","0","0","2","0","1","2","0","3","1","0","2","0","0","3"
"Szeged","46.253","20.14824","1","1","0","0","0","0","0","2","0","2","0","0","2","1","0","1","0","2","1","0","1","0","0","2"
"Székesfehérvár","47.18995","18.41034","0","0","0","0","1","0","0","1","1","0","0","0","1","0","0","1","0","1","1","0","0","0","0","1"
"Tabarka","36.95442","8.75801","1","0","0","0","0","0","0","1","0","0","1","0","1","0","0","1","0","1","0","1","0","0","0","1"
"Tabasco","21.86286","-102.91105","1","0","0","0","0","0","0","1","0","1","0","0","1","0","0","1","0","1","0","0","1","0","0","1"
"Tabora","-5.01622","32.82663","3","0","0","0","0","0","0","3","0","2","1","0","3","3","0","0","0","3","0","0","1","0","2","3"
"Tabou","4.42295","-7.3528","1","0","0","0","0","0","0","1","0","1","0","0","1","0","1","0","0","1","0","0","0","0","1","1"
"Tabriz","38.08","46.2919","1","1","0","0","0","0","0","2","0","0","0","0","0","0","1","1","0","2","1","0","1","0","0","2"
"Tabuk","28.3998","36.57151","2","0","0","0","0","1","0","3","0","2","0","0","2","2","0","1","0","3","2","0","0","0","1","3"
"Tabuk","17.4084","121.2785","2","0","0","0","0","1","0","3","0","2","0","0","2","2","0","1","0","3","2","0","0","0","1","3"
"Tabuk","17.47378","121.46799","2","0","0","0","0","1","0","3","0","2","0","0","2","2","0","1","0","3","2","0","0","0","1","3"
"Täby","59.4439","18.06872","1","0","0","0","0","0","0","1","0","0","1","0","1","0","0","1","0","1","0","0","1","0","0","1"
"Tacna","32.69755","-113.95354","1","0","0","0","0","0","0","1","0","0","0","0","0","1","0","0","0","1","0","0","1","0","0","1"
"Tacna","-18.01465","-70.25362","1","0","0","0","0","0","0","1","0","0","0","0","0","1","0","0","0","1","0","0","1","0","0","1"
"Tacoma","47.25288","-122.44429","1","0","0","0","0","0","0","1","0","0","0","0","0","0","0","1","0","1","1","0","0","0","0","1"
"Tacoma","-33.28794","151.46236","1","0","0","0","0","0","0","1","0","0","0","0","0","0","0","1","0","1","1","0","0","0","0","1"
"Tadley","51.35045","-1.1285","7","0","0","0","0","0","0","7","1","1","5","0","7","1","2","4","0","7","0","3","4","0","0","7"
"Tadmaït","36.74413","3.90045","0","0","0","1","0","0","0","1","0","1","0","0","1","0","1","0","0","1","0","0","0","1","0","1"
"Tadworth","51.29169","-0.23582","6","0","0","0","0","0","0","6","0","2","1","0","3","2","1","3","0","6","3","1","2","0","0","6"
"Tafunsak","5.3671","162.98532","1","0","0","0","0","0","0","1","0","0","0","1","1","1","0","0","0","1","0","0","0","0","0","0"
"Taguig","14.5243","121.0792","1","0","0","0","0","0","0","1","1","0","0","0","1","0","0","1","0","1","0","0","1","0","0","1"
"Tagum Norte","10.07454","124.38925","1","0","0","0","0","0","0","1","0","1","0","0","1","1","0","0","0","1","1","0","0","0","0","1"
"Ta’if","21.27028","40.41583","2","0","0","1","0","0","0","3","0","1","0","0","1","1","1","1","0","3","3","0","0","0","0","3"
"Tain","57.81204","-4.05518","0","0","0","0","1","0","0","1","1","0","0","0","1","1","0","0","0","1","0","1","0","0","0","1"
"Tainan","22.99083","120.21333","1","0","0","0","0","0","0","1","0","0","0","1","1","1","0","0","0","1","0","0","0","0","1","1"
"Tainan","32.76205","120.26944","1","0","0","0","0","0","0","1","0","0","0","1","1","1","0","0","0","1","0","0","0","0","1","1"
"Taipei","25.04776","121.53185","4","0","0","0","0","0","0","4","0","1","0","3","4","2","1","0","1","4","0","0","0","3","1","4"
"Ta‘izz","13.57952","44.02091","1","0","0","0","0","0","0","1","0","0","0","0","0","0","0","0","0","0","0","0","0","1","0","1"
"Takai","11.57569","9.1088","1","0","0","0","0","0","0","1","0","1","0","0","1","1","0","0","0","1","0","0","0","0","1","1"
"Takoradi","4.89816","-1.76029","5","0","0","0","0","0","0","5","1","3","0","1","5","3","1","0","1","5","2","0","1","1","1","5"
"Talā","30.6798","30.94364","1","0","0","0","0","0","0","1","1","0","0","0","1","0","0","1","0","1","0","0","1","0","0","1"
"Talamba","30.52693","72.24079","1","0","0","0","0","0","0","1","0","0","1","0","1","0","0","1","0","1","0","1","0","0","0","1"
"Talent","42.24568","-122.78865","1","0","0","0","0","0","0","1","0","1","0","0","1","1","0","0","0","1","0","0","1","0","0","1"
"Tallaght","53.2859","-6.37344","1","0","0","0","0","0","0","1","1","0","0","0","1","0","1","0","0","1","0","0","1","0","0","1"
"Tallahassee","30.43826","-84.28073","1","0","0","0","0","0","0","1","0","0","1","0","1","0","0","1","0","1","0","0","1","0","0","1"
"Tallinn","59.43696","24.75353","4","0","0","0","1","0","0","5","1","0","2","0","3","1","2","2","0","5","0","0","5","0","0","5"
"Tamale","9.40079","-0.8393","8","2","0","0","1","0","0","11","5","1","1","0","7","7","3","1","0","11","0","1","8","0","2","11"
"Tamarac","26.21286","-80.24977","1","0","0","0","0","0","0","1","0","0","1","0","1","0","0","1","0","1","0","1","0","0","0","1"
"Tambov","52.73169","41.44326","3","0","0","0","0","0","0","3","2","0","0","0","2","0","1","2","0","3","0","0","3","0","0","3"
"Tambovka","47.31528","47.37773","1","0","0","0","0","0","0","1","0","0","1","0","1","0","0","1","0","1","0","0","1","0","0","1"
"Tambovka","50.09968","128.05724","1","0","0","0","0","0","0","1","0","0","1","0","1","0","0","1","0","1","0","0","1","0","0","1"
"Tampa","27.94752","-82.45843","1","0","0","0","1","0","0","2","1","1","0","0","2","0","1","1","0","2","1","0","1","0","0","2"
"Tamworth","43.8598","-71.26313","13","0","0","0","1","0","2","16","2","3","7","2","14","6","4","6","0","16","3","6","7","0","0","16"
"Tamworth","52.63399","-1.69587","13","0","0","0","1","0","2","16","2","3","7","2","14","6","4","6","0","16","3","6","7","0","0","16"
"Tamworth","-31.09048","150.92905","13","0","0","0","1","0","2","16","2","3","7","2","14","6","4","6","0","16","3","6","7","0","0","16"
"Tanah Merah","3.63221","97.70234","1","0","0","0","0","0","0","1","1","0","0","0","1","1","0","0","0","1","0","0","1","0","0","1"
"Tanah Merah","5.8","102.15","1","0","0","0","0","0","0","1","1","0","0","0","1","1","0","0","0","1","0","0","1","0","0","1"
"Tanah Merah","-6.09756","140.30649","1","0","0","0","0","0","0","1","1","0","0","0","1","1","0","0","0","1","0","0","1","0","0","1"
"Tanah Merah","-27.67151","153.17019","1","0","0","0","0","0","0","1","1","0","0","0","1","1","0","0","0","1","0","0","1","0","0","1"
"Tanda","7.80335","-3.16832","4","0","0","0","0","0","1","5","2","2","1","0","5","1","0","4","1","6","2","0","4","0","0","6"
"Tanda","30.78847","31.00192","4","0","0","0","0","0","1","5","2","2","1","0","5","1","0","4","1","6","2","0","4","0","0","6"
"Tando Adam","25.76818","68.66196","2","0","0","0","0","0","0","2","1","1","0","0","2","1","1","0","0","2","0","0","1","0","1","2"
"Tando Allahyar","25.4605","68.71745","1","0","0","0","0","0","0","1","1","0","0","0","1","0","0","1","0","1","0","1","0","0","0","1"
"Tando Jam","25.42813","68.52923","1","0","0","0","0","0","0","1","1","0","0","0","1","0","1","0","0","1","0","1","0","0","0","1"
"Tando Muhammad Khan","25.12384","68.53677","2","0","0","0","0","0","0","2","1","1","0","0","2","1","0","1","0","2","0","0","2","0","0","2"
"Tandragee","54.35486","-6.41396","1","0","0","0","0","0","0","1","0","1","0","0","1","1","0","0","0","1","1","0","0","0","0","1"
"Tanga","-5.06893","39.09875","2","1","0","0","0","0","0","3","0","2","0","0","2","1","2","0","0","3","2","1","0","0","0","3"
"Tangalle","6.02338","80.79738","1","0","0","0","0","0","0","1","0","0","1","0","1","1","0","0","0","1","0","0","0","0","1","1"
"Tangerang","-6.17806","106.63","6","3","0","0","0","0","0","9","3","4","1","0","8","3","4","1","1","9","1","1","6","0","1","9"
"Tangier","37.82624","-75.9916","6","0","0","0","0","0","0","6","5","1","0","0","6","3","2","1","0","6","2","4","0","0","0","6"
"Tangier","35.76727","-5.79975","6","0","0","0","0","0","0","6","5","1","0","0","6","3","2","1","0","6","2","4","0","0","0","6"
"Tangwani","28.27886","68.9976","0","1","0","0","0","0","0","1","1","0","0","0","1","1","0","0","0","1","0","0","1","0","0","1"
"Tanjung Pinang","0.91667","104.45833","1","0","0","0","0","0","0","1","0","0","0","0","0","0","1","0","0","1","0","0","0","0","1","1"
"Tanjung Tokong","5.46061","100.30742","1","0","0","0","0","0","0","1","0","0","1","0","1","1","0","0","0","1","0","0","1","0","0","1"
"Tank","32.21707","70.38315","1","0","0","0","0","0","0","1","0","0","0","1","1","0","1","0","0","1","0","0","1","0","0","1"
"Tānsen","27.86731","83.5467","2","1","0","0","0","0","0","3","3","0","0","0","3","1","2","0","0","3","0","0","3","0","0","3"
"Taradell","41.87495","2.28662","1","0","0","0","0","0","0","1","1","0","0","0","1","0","0","1","0","1","1","0","0","0","0","1"
"Tarbert","52.57278","-9.37528","1","0","0","0","0","0","0","1","0","0","1","0","1","0","0","1","0","1","0","0","1","0","0","1"
"Tarbert","55.86277","-5.41622","1","0","0","0","0","0","0","1","0","0","1","0","1","0","0","1","0","1","0","0","1","0","0","1"
"Târgu Jiu","45.05","23.28333","1","0","0","0","0","0","0","1","0","0","1","0","1","0","0","1","0","1","0","1","0","0","0","1"
"Târgu-Mureş","46.54245","24.55747","3","0","0","0","0","0","0","3","0","0","1","0","1","1","0","2","0","3","1","0","2","0","0","3"
"Tarifa","36.01393","-5.60695","1","0","0","0","0","0","0","1","0","0","1","0","1","0","1","0","0","1","0","0","1","0","0","1"
"Tarime","-1.35","34.36667","0","0","0","0","1","0","0","1","0","0","0","1","1","1","0","0","0","1","0","0","0","0","1","1"
"Tarlac City","15.48017","120.59794","2","0","0","0","0","0","0","2","0","1","0","0","1","0","1","1","0","2","1","0","1","0","0","2"
"Tarn Tāran","31.45191","74.92777","1","0","0","0","0","0","0","1","1","0","0","0","1","0","1","0","0","1","0","0","1","0","0","1"
"Taroudant","30.47028","-8.87695","1","0","0","0","0","0","0","1","0","1","0","0","1","0","1","0","0","1","0","0","0","0","1","1"
"Tarporley","53.15918","-2.66867","2","0","0","0","0","0","0","2","1","0","1","0","2","1","0","1","0","2","0","1","1","0","0","2"
"Tarragona","41.11667","1.25","1","0","0","0","0","0","0","1","0","0","0","0","0","0","0","1","0","1","0","0","1","0","0","1"
"Tarragona","7.0491","126.44708","1","0","0","0","0","0","0","1","0","0","0","0","0","0","0","1","0","1","0","0","1","0","0","1"
"Tarrytown","41.07621","-73.85875","1","0","0","0","0","0","0","1","0","1","0","0","1","0","0","1","0","1","0","0","1","0","0","1"
"Tartouss","34.88902","35.88659","1","0","0","0","0","0","0","1","0","1","0","0","1","1","0","0","0","1","0","1","0","0","0","1"
"Tarxien","35.86583","14.515","1","0","0","0","0","0","0","1","1","0","0","0","1","0","0","1","0","1","0","0","1","0","0","1"
"Tashkent","41.26465","69.21627","8","1","0","0","1","0","1","11","4","0","3","0","7","4","3","4","0","11","2","0","8","0","1","11"
"Tatabánya","47.58494","18.39325","1","0","0","0","0","0","0","1","0","0","1","0","1","0","0","1","0","1","0","1","0","0","0","1"
"Taunton","41.9001","-71.08977","27","0","0","0","3","0","0","30","7","8","8","1","24","13","9","8","0","30","6","7","16","1","0","30"
"Taunton","51.01494","-3.10293","27","0","0","0","3","0","0","30","7","8","8","1","24","13","9","8","0","30","6","7","16","1","0","30"
"Taurage","55.25222","22.28972","1","0","0","0","0","0","0","1","0","0","0","1","1","1","0","0","0","1","0","0","0","0","1","1"
"Tavistock","43.31679","-80.83302","0","0","0","0","1","0","0","1","1","0","0","0","1","1","0","0","0","1","0","0","1","0","0","1"
"Tavistock","50.54944","-4.14418","0","0","0","0","1","0","0","1","1","0","0","0","1","1","0","0","0","1","0","0","1","0","0","1"
"Taxiárches","39.57565","21.89245","1","0","0","0","0","0","0","1","0","1","0","0","1","0","1","0","0","1","0","0","0","0","1","1"
"Taytay","10.81788","119.49851","1","0","0","0","0","0","0","1","0","0","1","0","1","0","0","1","0","1","1","0","0","0","0","1"
"Taytay","14.55883","121.13285","1","0","0","0","0","0","0","1","0","0","1","0","1","0","0","1","0","1","1","0","0","0","0","1"
"Taytay","14.12567","121.40399","1","0","0","0","0","0","0","1","0","0","1","0","1","0","0","1","0","1","1","0","0","0","0","1"
"Taytay","8.54111","124.53972","1","0","0","0","0","0","0","1","0","0","1","0","1","0","0","1","0","1","1","0","0","0","0","1"
"Taza","34.21","-4.01","1","0","0","0","0","0","0","1","1","0","0","0","1","1","0","0","0","1","0","0","1","0","0","1"
"Tbilisi","41.69411","44.83368","51","0","0","0","2","0","0","53","15","14","5","4","38","18","14","19","2","53","21","1","24","5","2","53"
"Techiman","7.59054","-1.93947","3","0","0","0","1","0","0","4","0","2","0","2","4","2","1","0","1","4","2","0","1","0","1","4"
"Tecuci","44.34179","24.85966","1","0","0","0","0","0","0","1","0","1","0","0","1","1","0","0","0","1","0","0","0","0","1","1"
"Tecuci","45.84973","27.43441","1","0","0","0","0","0","0","1","0","1","0","0","1","1","0","0","0","1","0","0","0","0","1","1"
"Teddington","51.42233","-0.33053","22","0","0","3","2","0","1","28","5","2","7","0","14","11","0","17","0","28","0","10","17","0","1","28"
"Tegucigalpa","14.0818","-87.20681","6","0","0","0","0","0","0","6","2","1","1","0","4","4","0","2","0","6","2","1","3","0","0","6"
"Tehran","35.69439","51.42151","5","1","0","0","1","0","0","7","2","0","1","1","4","1","2","3","1","7","2","2","2","1","0","7"
"Teignmouth","50.54581","-3.49671","3","0","0","0","0","0","0","3","0","1","0","1","2","2","0","1","0","3","0","1","2","0","0","3"
"Tekirdağ","40.9781","27.51101","3","0","0","0","0","0","0","3","0","3","0","0","3","1","2","0","0","3","3","0","0","0","0","3"
"Telavi","41.91978","45.47315","1","0","0","0","0","0","0","1","1","0","0","0","1","0","1","0","0","1","0","0","1","0","0","1"
"Tel Aviv","32.08088","34.78057","5","1","0","0","0","0","0","6","2","2","0","0","4","3","1","2","0","6","3","0","2","1","0","6"
"Telford","36.24899","-82.54515","76","4","0","3","8","0","5","96","19","41","32","0","92","31","10","54","1","96","25","22","46","0","3","96"
"Telford","40.32205","-75.32795","76","4","0","3","8","0","5","96","19","41","32","0","92","31","10","54","1","96","25","22","46","0","3","96"
"Telford","52.67659","-2.44926","76","4","0","3","8","0","5","96","19","41","32","0","92","31","10","54","1","96","25","22","46","0","3","96"
"Tema","5.6698","-0.01657","5","0","0","0","1","0","0","6","2","4","1","0","7","4","2","0","0","6","3","1","2","1","0","7"
"Temara","33.92866","-6.90656","1","0","0","0","0","0","0","1","0","0","1","0","1","0","0","1","0","1","0","0","1","0","0","1"
"Tempe","33.41477","-111.90931","1","0","0","0","0","0","0","1","0","0","0","0","0","1","0","0","0","1","0","0","1","0","0","1"
"Tempe","-33.92335","151.1602","1","0","0","0","0","0","0","1","0","0","0","0","0","1","0","0","0","1","0","0","1","0","0","1"
"Temple","34.27203","-98.23588","1","0","0","0","0","0","0","1","0","1","0","0","1","0","1","0","0","1","1","0","0","0","0","1"
"Temple","31.09823","-97.34278","1","0","0","0","0","0","0","1","0","1","0","0","1","0","1","0","0","1","1","0","0","0","0","1"
"Temple","33.73705","-85.03244","1","0","0","0","0","0","0","1","0","1","0","0","1","0","1","0","0","1","1","0","0","0","0","1"
"Temple","40.4087","-75.9216","1","0","0","0","0","0","0","1","0","1","0","0","1","0","1","0","0","1","1","0","0","0","0","1"
"Temple","42.81814","-71.85147","1","0","0","0","0","0","0","1","0","1","0","0","1","0","1","0","0","1","1","0","0","0","0","1"
"Temple","44.68506","-70.22645","1","0","0","0","0","0","0","1","0","1","0","0","1","0","1","0","0","1","1","0","0","0","0","1"
"Tenancingo de Degollado","18.96136","-99.5903","1","0","0","0","0","0","0","1","0","1","0","0","1","1","0","0","0","1","0","0","1","0","0","1"
"Tenbury Wells","52.31077","-2.59621","1","0","0","0","2","0","0","3","0","1","2","0","3","0","0","3","0","3","0","2","1","0","0","3"
"Tenby","51.67279","-4.70447","19","0","0","1","2","0","0","22","7","1","3","0","11","12","1","9","0","22","1","7","12","0","2","22"
"Tenterden","51.06845","0.68776","2","0","0","0","0","0","0","2","1","0","1","0","2","1","0","1","0","2","0","2","0","0","0","2"
"Termoli","41.99994","14.99389","1","0","0","0","0","0","0","1","1","0","0","0","1","1","0","0","0","1","0","0","0","0","1","1"
"Terni","42.56335","12.64329","0","1","0","0","0","0","0","1","0","1","0","0","1","0","0","1","0","1","0","0","1","0","0","1"
"Ternopil","49.55342","25.58918","4","0","0","0","0","0","0","4","0","0","2","0","2","0","1","3","0","4","0","0","4","0","0","4"
"Terre Rouge","-20.12611","57.52444","1","0","0","0","0","0","0","1","0","1","0","0","1","1","0","0","0","1","1","0","0","0","0","1"
"Tetbury","51.63944","-2.16222","0","0","0","1","1","0","0","2","1","0","0","0","1","1","1","0","0","2","0","0","2","0","0","2"
"Tete","-16.15639","33.58667","1","0","0","0","0","0","0","1","0","1","0","0","1","1","0","0","0","1","0","0","0","0","1","1"
"Tetovo","42.00973","20.97155","3","1","0","0","0","0","0","4","0","1","0","0","1","1","3","0","0","4","2","1","1","0","0","4"
"Tettnang","47.66857","9.59132","1","0","0","0","0","0","0","1","0","0","1","0","1","0","0","1","0","1","0","1","0","0","0","1"
"Tewkesbury","51.99244","-2.1601","4","0","0","0","0","0","1","5","0","3","2","0","5","3","0","2","0","5","1","0","3","0","1","5"
"Teyateyaneng","-29.14719","27.74895","0","0","0","0","1","0","0","1","0","0","1","0","1","1","0","0","0","1","0","0","0","1","0","1"
"Thame","51.7484","-0.97624","10","0","0","0","3","0","0","13","4","1","5","0","10","5","3","5","0","13","3","6","4","0","0","13"
"Thames Ditton","51.38964","-0.33928","6","0","0","2","0","0","0","8","3","2","2","0","7","1","0","7","0","8","0","3","3","2","0","8"
"Thatcham","51.40366","-1.26049","6","0","0","0","0","0","0","6","0","3","2","0","5","3","1","2","0","6","0","1","5","0","0","6"
"Thatta","24.74745","67.92353","1","0","0","0","0","0","0","1","0","1","0","0","1","1","0","0","0","1","1","0","0","0","0","1"
"Thaxted","51.95326","0.34478","0","0","0","0","0","0","5","5","5","0","0","0","5","0","0","5","0","5","0","5","0","0","0","5"
"The Hague","52.07667","4.29861","3","0","0","0","1","0","0","4","0","2","1","0","3","2","0","2","0","4","0","1","2","0","1","4"
"Thessaloníki","40.64361","22.93086","26","0","0","0","1","0","0","27","2","12","1","0","15","12","6","9","0","27","14","1","7","1","4","27"
"Thetford","52.41667","0.75","4","1","0","0","1","0","0","6","1","2","2","0","5","2","2","2","0","6","2","2","1","0","1","6"
"Thika","-1.03326","37.06933","3","0","0","0","0","0","0","3","1","1","0","0","2","2","0","1","0","3","0","0","2","0","1","3"
"Thimphu","27.46609","89.64191","7","0","0","0","0","0","0","7","1","2","0","0","3","4","2","0","0","6","0","0","3","0","5","8"
"Thirlmere","-34.20455","150.56767","1","0","0","0","0","0","0","1","1","0","0","0","1","1","0","0","0","1","0","1","0","0","0","1"
"Thirsk","54.23298","-1.34411","3","1","0","1","0","0","2","7","2","1","3","1","7","3","0","4","0","7","1","1","5","0","0","7"
"Thiruvananthapuram","8.4855","76.94924","6","0","0","0","0","0","0","6","4","0","2","0","6","2","0","4","0","6","0","0","5","0","1","6"
"Thiruvarur","10.77269","79.6368","0","0","0","0","1","0","0","1","0","0","0","1","1","0","1","0","0","1","0","0","1","0","0","1"
"Thohoyandou","-22.94564","30.48497","3","0","0","0","0","0","0","3","2","0","0","0","2","2","0","0","0","2","0","1","2","0","0","3"
"Thoiry","48.86715","1.7976","1","0","0","0","0","0","0","1","0","0","0","0","0","0","0","1","0","1","0","0","1","0","0","1"
"Thoiry","46.23762","5.98111","1","0","0","0","0","0","0","1","0","0","0","0","0","0","0","1","0","1","0","0","1","0","0","1"
"Thornaby-on-Tees","54.53333","-1.3","1","0","0","0","0","0","0","1","0","0","1","0","1","0","0","1","0","1","0","0","1","0","0","1"
"Thornbury","52.23333","-2.55","2","0","0","0","1","0","0","3","0","0","3","0","3","1","1","1","0","3","0","1","1","0","1","3"
"Thornbury","51.60889","-2.52028","2","0","0","0","1","0","0","3","0","0","3","0","3","1","1","1","0","3","0","1","1","0","1","3"
"Thornbury","-37.75819","145.00583","2","0","0","0","1","0","0","3","0","0","3","0","3","1","1","1","0","3","0","1","1","0","1","3"
"Thornton-Cleveleys","53.87389","-3.02244","1","1","0","0","0","0","0","2","1","1","0","0","2","1","0","1","0","2","1","0","1","0","0","2"
"Thornton Heath","51.39884","-0.09872","1","0","0","0","0","0","0","1","0","1","0","0","1","0","0","1","0","1","1","0","0","0","0","1"
"Thoubāl","24.63881","93.99639","1","0","0","0","0","0","0","1","0","0","0","0","0","1","0","0","0","1","1","0","0","0","0","1"
"Thrapston","52.39675","-0.5392","1","0","0","0","0","0","0","1","0","0","1","0","1","1","0","0","0","1","0","1","0","0","0","1"
"Thrissur","10.51667","76.21667","3","0","0","0","0","0","0","3","3","0","0","0","3","1","1","1","0","3","0","0","2","0","1","3"
"Thunder Bay","48.38202","-89.25018","1","0","0","0","0","0","0","1","0","0","0","0","0","0","0","1","0","1","0","0","1","0","0","1"
"Thurlestone","50.26932","-3.86264","1","0","0","0","0","0","0","1","0","0","1","0","1","0","0","1","0","1","0","0","1","0","0","1"
"Thurso","45.6001","-75.24931","1","0","0","0","0","0","0","1","0","0","1","0","1","1","0","0","0","1","0","0","1","0","0","1"
"Thurso","58.59271","-3.52594","1","0","0","0","0","0","0","1","0","0","1","0","1","1","0","0","0","1","0","0","1","0","0","1"
"Tiburon","37.87354","-122.45664","2","0","0","0","0","0","0","2","1","0","1","0","2","1","0","1","0","2","0","0","2","0","0","2"
"Tiburon","18.32589","-74.39598","2","0","0","0","0","0","0","2","1","0","1","0","2","1","0","1","0","2","0","0","2","0","0","2"
"Tickhill","53.43194","-1.10859","0","1","0","0","0","0","0","1","1","0","0","0","1","0","0","1","0","1","0","0","1","0","0","1"
"Tideswell","53.27807","-1.77292","1","0","0","0","0","0","0","1","0","1","0","0","1","0","0","1","0","1","0","0","1","0","0","1"
"Tidworth","51.23142","-1.66324","3","1","0","0","0","0","0","4","0","2","0","0","2","1","1","2","0","4","1","1","2","0","0","4"
"Tijuana","32.5027","-117.00371","1","0","0","0","0","0","0","1","0","0","0","0","0","1","0","0","0","1","1","0","0","0","0","1"
"Tiko","4.075","9.36005","1","0","0","0","0","0","0","1","0","0","0","0","0","0","1","0","0","1","1","0","0","0","0","1"
"Tikrīt","34.61581","43.67861","1","0","0","0","0","0","0","1","0","0","0","0","0","1","0","0","0","1","0","0","1","0","0","1"
"Tilbury","51.46248","0.35856","0","0","0","0","1","0","0","1","0","0","1","0","1","0","0","1","0","1","0","0","1","0","0","1"
"Tillicoultry","56.15251","-3.74015","2","0","0","0","0","0","0","2","0","1","1","0","2","1","0","1","0","2","0","2","0","0","0","2"
"Timargara","34.82659","71.84423","4","1","0","0","0","0","0","5","3","0","1","1","5","3","1","0","1","5","1","0","4","0","0","5"
"Timaru","-44.39672","171.25364","2","0","0","0","0","0","0","2","1","1","0","0","2","0","0","2","0","2","0","0","2","0","0","2"
"Timişoara","45.75372","21.22571","11","1","0","0","0","0","0","12","2","6","1","0","9","3","2","7","0","12","5","1","5","0","1","12"
"Timperley","53.4","-2.33333","1","0","0","0","0","0","0","1","0","1","0","0","1","0","0","1","0","1","1","0","0","0","0","1"
"Tintagel","50.66317","-4.75047","1","0","0","0","0","0","0","1","0","0","1","0","1","1","0","0","0","1","0","1","0","0","0","1"
"Tipasa","36.58972","2.4475","2","0","0","0","0","0","0","2","0","2","0","0","2","2","0","0","0","2","2","0","0","0","0","2"
"Tipperary","52.47333","-8.15583","2","0","0","0","0","0","0","2","0","0","2","0","2","0","1","1","0","2","0","1","1","0","0","2"
"Tipton","36.0594","-119.31206","3","0","0","0","1","0","0","4","0","1","2","0","3","2","0","2","0","4","2","0","2","0","0","4"
"Tipton","34.50285","-99.14091","3","0","0","0","1","0","0","4","0","1","2","0","3","2","0","2","0","4","2","0","2","0","0","4"
"Tipton","38.65558","-92.77992","3","0","0","0","1","0","0","4","0","1","2","0","3","2","0","2","0","4","2","0","2","0","0","4"
"Tipton","41.76974","-91.12793","3","0","0","0","1","0","0","4","0","1","2","0","3","2","0","2","0","4","2","0","2","0","0","4"
"Tipton","40.28226","-86.0411","3","0","0","0","1","0","0","4","0","1","2","0","3","2","0","2","0","4","2","0","2","0","0","4"
"Tipton","40.6359","-78.29585","3","0","0","0","1","0","0","4","0","1","2","0","3","2","0","2","0","4","2","0","2","0","0","4"
"Tipton","52.52956","-2.06773","3","0","0","0","1","0","0","4","0","1","2","0","3","2","0","2","0","4","2","0","2","0","0","4"
"Tirana","41.3275","19.81889","54","8","0","0","0","0","1","63","18","19","7","0","44","18","16","27","2","63","8","17","21","2","16","64"
"Tiruchirappalli","10.8155","78.69651","2","0","0","0","0","0","0","2","1","0","0","1","2","2","0","0","0","2","1","0","1","0","0","2"
"Tirupati","13.63551","79.41989","2","0","0","0","0","0","0","2","1","1","0","0","2","1","0","1","0","2","0","0","2","0","0","2"
"Tiruppur","11.11541","77.35456","1","0","0","0","0","0","0","1","1","0","0","0","1","1","0","0","0","1","0","0","1","0","0","1"
"Titusville","28.61222","-80.80755","1","0","0","0","0","0","0","1","0","0","0","0","0","1","0","0","0","1","1","0","0","0","0","1"
"Titusville","41.627","-79.67366","1","0","0","0","0","0","0","1","0","0","0","0","0","1","0","0","0","1","1","0","0","0","0","1"
"Titusville","41.66759","-73.87402","1","0","0","0","0","0","0","1","0","0","0","0","0","1","0","0","0","1","1","0","0","0","0","1"
"Tiverton","41.62594","-71.21338","1","0","0","1","1","0","0","3","2","1","0","0","3","1","0","2","0","3","0","0","3","0","0","3"
"Tiverton","50.90241","-3.49232","1","0","0","1","1","0","0","3","2","1","0","0","3","1","0","2","0","3","0","0","3","0","0","3"
"Tiverton","53.13333","-2.66667","1","0","0","1","1","0","0","3","2","1","0","0","3","1","0","2","0","3","0","0","3","0","0","3"
"Tizi Ouzou","36.71182","4.04591","4","0","0","0","0","0","0","4","2","1","1","0","4","1","3","0","0","4","1","1","2","0","0","4"
"Tlanepantla","18.8631","-97.88701","1","0","0","0","0","0","0","1","0","0","1","0","1","0","1","0","0","1","0","1","0","0","0","1"
"Tlanepantla","19.21748","-97.13404","1","0","0","0","0","0","0","1","0","0","1","0","1","0","1","0","0","1","0","1","0","0","0","1"
"Tlaquepaque","20.64091","-103.29327","0","1","0","0","0","0","0","1","0","1","0","0","1","0","0","1","0","1","0","0","1","0","0","1"
"Tlemcen","34.87833","-1.315","13","0","0","0","0","0","0","13","8","2","1","0","11","6","3","4","0","13","3","4","6","0","0","13"
"Toba Tek Singh","30.97127","72.48275","1","0","0","0","0","0","0","1","0","1","0","0","1","0","0","1","0","1","0","0","1","0","0","1"
"Tobruk","32.08963","23.95385","1","0","0","0","0","0","0","1","0","1","0","0","1","0","0","0","0","0","1","0","0","0","0","1"
"Tocoa","15.68333","-86","0","0","0","0","1","0","0","1","0","1","0","0","1","0","1","0","0","1","1","0","0","0","0","1"
"Toddington","51.94922","-0.53277","1","0","0","0","0","0","0","1","0","0","1","0","1","0","0","1","0","1","0","0","1","0","0","1"
"Todmorden","53.71434","-2.09701","4","0","0","0","0","0","0","4","0","0","3","0","3","1","0","3","0","4","0","3","1","0","0","4"
"Tokyo","35.6895","139.69171","3","0","0","0","0","0","0","3","0","1","0","1","2","2","0","1","0","3","0","0","1","1","1","3"
"Toledo","44.62151","-123.93845","0","0","0","0","0","0","1","1","1","0","0","0","1","0","0","0","0","0","0","0","1","0","0","1"
"Toledo","46.43983","-122.84678","0","0","0","0","0","0","1","1","1","0","0","0","1","0","0","0","0","0","0","0","1","0","0","1"
"Toledo","41.99555","-92.57686","0","0","0","0","0","0","1","1","1","0","0","0","1","0","0","0","0","0","0","0","1","0","0","1"
"Toledo","39.27365","-88.24365","0","0","0","0","0","0","1","1","1","0","0","0","1","0","0","0","0","0","0","0","1","0","0","1"
"Toledo","41.66394","-83.55521","0","0","0","0","0","0","1","1","1","0","0","0","1","0","0","0","0","0","0","0","1","0","0","1"
"Toledo","7.01306","-75.69528","0","0","0","0","0","0","1","1","1","0","0","0","1","0","0","0","0","0","0","0","1","0","0","1"
"Toledo","7.30984","-72.48295","0","0","0","0","0","0","1","1","1","0","0","0","1","0","0","0","0","0","0","0","1","0","0","1"
"Toledo","-31.55574","-64.00947","0","0","0","0","0","0","1","1","1","0","0","0","1","0","0","0","0","0","0","0","1","0","0","1"
"Toledo","-34.73807","-56.09469","0","0","0","0","0","0","1","1","1","0","0","0","1","0","0","0","0","0","0","0","1","0","0","1"
"Toledo","-24.71361","-53.74306","0","0","0","0","0","0","1","1","1","0","0","0","1","0","0","0","0","0","0","0","1","0","0","1"
"Toledo","39.8581","-4.02263","0","0","0","0","0","0","1","1","1","0","0","0","1","0","0","0","0","0","0","0","1","0","0","1"
"Toledo","10.3773","123.6386","0","0","0","0","0","0","1","1","1","0","0","0","1","0","0","0","0","0","0","0","1","0","0","1"
"Tolga","34.72224","5.37845","1","0","0","0","0","0","0","1","0","0","1","0","1","1","0","0","0","1","1","0","0","0","0","1"
"Tolga","62.40898","10.99883","1","0","0","0","0","0","0","1","0","0","1","0","1","1","0","0","0","1","1","0","0","0","0","1"
"Tolga","-17.18557","145.47707","1","0","0","0","0","0","0","1","0","0","1","0","1","1","0","0","0","1","1","0","0","0","0","1"
"Toluca","19.28786","-99.65324","1","0","0","0","0","0","0","1","0","1","0","0","1","0","0","0","0","0","0","0","1","0","0","1"
"Toluca","15.02843","-92.24375","1","0","0","0","0","0","0","1","0","1","0","0","1","0","0","0","0","0","0","0","1","0","0","1"
"Toluca","41.00226","-89.13342","1","0","0","0","0","0","0","1","0","1","0","0","1","0","0","0","0","0","0","0","1","0","0","1"
"Tomislavgrad","43.71849","17.22515","1","0","0","0","0","0","0","1","0","1","0","0","1","1","0","0","0","1","0","0","0","0","1","1"
"Tomsk","56.49771","84.97437","1","0","0","0","0","0","0","1","0","0","1","0","1","1","0","0","0","1","0","0","1","0","0","1"
"Tonbridge","51.19532","0.27363","22","1","0","1","2","0","0","26","7","5","12","1","25","7","1","18","0","26","3","9","12","1","1","26"
"Tonk","26.16638","75.78824","1","0","0","0","0","0","0","1","1","0","0","0","1","0","0","1","0","1","0","0","1","0","0","1"
"Tonota","-21.44236","27.46153","2","0","0","0","0","0","0","2","0","2","0","0","2","2","0","0","0","2","0","2","0","0","0","2"
"Tønsberg","59.26754","10.40762","2","0","0","0","0","0","0","2","0","2","0","0","2","0","0","1","1","2","0","0","0","2","0","2"
"Tonypandy","51.62202","-3.45544","4","0","0","0","0","0","2","6","0","3","3","0","6","3","2","1","0","6","5","0","1","0","0","6"
"Tonyrefail","51.58402","-3.43041","5","0","0","0","0","0","0","5","1","1","3","0","5","1","1","3","0","5","1","1","3","0","0","5"
"Topliţa","45.68333","22.78333","1","0","0","0","0","0","0","1","0","0","1","0","1","0","1","0","0","1","0","0","1","0","0","1"
"Topolšica","46.40028","15.02157","1","0","0","0","0","0","0","1","1","0","0","0","1","1","0","0","0","1","0","0","1","0","0","1"
"Torino di Sangro","42.191","14.54272","1","0","0","0","0","0","0","1","0","1","0","0","1","0","0","1","0","1","1","0","0","0","0","1"
"Toronto","40.46423","-80.60091","18","3","0","0","1","0","0","22","5","8","5","0","18","12","2","8","0","22","2","3","13","2","2","22"
"Toronto","43.70011","-79.4163","18","3","0","0","1","0","0","22","5","8","5","0","18","12","2","8","0","22","2","3","13","2","2","22"
"Toronto","-33.01357","151.59373","18","3","0","0","1","0","0","22","5","8","5","0","18","12","2","8","0","22","2","3","13","2","2","22"
"Tororo","0.69299","34.18085","1","0","0","0","0","0","0","1","0","0","1","0","1","1","0","0","0","1","0","0","0","0","1","1"
"Torquay","50.46198","-3.52522","12","1","0","0","0","0","0","13","1","7","3","0","11","7","0","6","0","13","4","4","5","0","0","13"
"Torquay","-38.33085","144.32638","12","1","0","0","0","0","0","13","1","7","3","0","11","7","0","6","0","13","4","4","5","0","0","13"
"Torquay","-25.28496","152.87886","12","1","0","0","0","0","0","13","1","7","3","0","11","7","0","6","0","13","4","4","5","0","0","13"
"Torrance","33.83585","-118.34063","1","1","0","0","0","0","0","2","1","0","0","0","1","1","0","1","0","2","0","0","2","0","0","2"
"Torrance","55.93995","-4.21025","1","1","0","0","0","0","0","2","1","0","0","0","1","1","0","1","0","2","0","0","2","0","0","2"
"Torrevieja","37.97872","-0.68222","1","0","0","0","0","0","1","2","0","0","0","0","0","0","0","2","0","2","0","1","1","0","0","2"
"Totland","50.68466","-1.53688","1","0","0","0","0","0","0","1","1","0","0","0","1","0","0","1","0","1","0","1","0","0","0","1"
"Totnes","50.43107","-3.6843","5","0","0","0","0","0","0","5","1","1","3","0","5","4","0","1","0","5","1","1","3","0","0","5"
"Toukh","30.35487","31.20105","1","0","0","0","0","0","0","1","0","1","0","0","1","0","1","0","0","1","0","0","0","1","0","1"
"Toulouse","43.60426","1.44367","5","0","0","0","0","0","0","5","1","1","0","0","2","1","0","4","0","5","1","0","4","0","0","5"
"Towcester","52.13359","-0.99057","23","0","0","0","0","0","5","28","5","3","6","0","14","10","4","13","2","29","2","17","10","0","0","29"
"Trabuco Canyon","33.66252","-117.59033","1","0","0","0","0","0","0","1","0","0","1","0","1","0","0","1","0","1","0","0","1","0","0","1"
"Trabzon","41.005","39.72694","1","0","0","0","0","0","0","1","1","0","0","0","1","1","0","0","0","1","1","0","0","0","0","1"
"Tracy","37.73987","-121.42618","1","0","0","0","0","0","0","1","0","0","0","0","0","0","0","1","0","1","0","1","0","0","0","1"
"Tracy","44.23329","-95.61918","1","0","0","0","0","0","0","1","0","0","0","0","0","0","0","1","0","1","0","1","0","0","0","1"
"Tralee","52.27042","-9.70264","1","0","0","0","0","0","1","2","1","0","0","0","1","0","1","1","0","2","0","0","2","0","0","2"
"Traralgon","-38.19528","146.5415","1","0","0","0","0","0","0","1","0","0","1","0","1","0","0","1","0","1","1","0","0","0","0","1"
"Trashigang","27.3331","91.55424","1","0","0","0","0","0","0","1","0","1","0","0","1","0","1","0","0","1","0","0","1","0","0","1"
"Travnik","44.22637","17.66583","2","1","0","0","0","0","0","3","2","0","0","0","2","1","0","2","0","3","1","0","2","0","0","3"
"Trbovlje","46.155","15.05333","0","1","0","0","0","0","0","1","0","0","1","0","1","0","0","1","0","1","0","1","0","0","0","1"
"Tredegar","51.77251","-3.24679","1","0","0","0","0","0","0","1","0","1","0","0","1","0","0","1","0","1","0","0","1","0","0","1"
"Treharris","51.66457","-3.30725","2","0","0","0","0","0","0","2","0","2","0","0","2","1","1","0","0","2","2","0","0","0","0","2"
"Treherbert","51.67139","-3.52972","1","0","0","0","0","0","0","1","0","1","0","0","1","1","0","0","0","1","1","0","0","0","0","1"
"Trelleborg","55.37514","13.15691","1","0","0","0","0","0","0","1","0","1","0","0","1","1","0","0","0","1","0","0","0","0","1","1"
"Trenggalek","-8.0764","111.70641","1","0","0","0","0","0","0","1","0","0","1","0","1","0","0","1","0","1","0","0","1","0","0","1"
"Trento","46.06787","11.12108","1","0","0","0","0","0","0","1","0","0","0","0","0","0","0","1","0","1","0","0","0","0","1","1"
"Trento","8.04583","126.06361","1","0","0","0","0","0","0","1","0","0","0","0","0","0","0","1","0","1","0","0","0","0","1","1"
"Treorchy","51.65958","-3.50587","6","0","0","0","0","0","0","6","0","5","1","0","6","1","2","3","0","6","4","1","1","0","0","6"
"Tres Cantos","40.60092","-3.70806","1","0","0","0","0","0","0","1","0","0","1","0","1","0","1","0","0","1","0","0","1","0","0","1"
"Treviso","45.66673","12.2416","1","0","0","0","0","0","0","1","0","1","0","0","1","0","0","1","0","1","1","0","0","0","0","1"
"Tribuswinkel","48.00623","16.27075","1","0","0","0","0","0","0","1","0","1","0","0","1","0","0","1","0","1","0","0","0","1","0","1"
"Trier","49.75565","6.63935","0","0","0","0","0","0","1","1","0","0","0","0","0","0","0","1","0","1","0","0","1","0","0","1"
"Trieste","45.64953","13.77678","5","0","0","0","0","0","0","5","0","2","3","0","5","0","1","4","0","5","0","1","4","0","0","5"
"Trim","53.555","-6.79167","3","1","0","0","0","0","0","4","1","1","1","1","4","2","0","1","0","3","2","0","2","0","0","4"
"Trimbak","19.93268","73.52907","1","0","0","0","0","0","0","1","1","0","0","0","1","0","1","0","0","1","0","0","1","0","0","1"
"Tring","51.79471","-0.65824","3","0","0","1","1","0","0","5","4","0","1","0","5","2","0","3","0","5","0","2","3","0","0","5"
"Triolet","-20.0576","57.55025","1","0","0","0","0","0","0","1","1","0","0","0","1","1","0","0","0","1","0","0","1","0","0","1"
"Tripoli","42.80804","-92.25823","34","4","0","0","1","0","0","39","14","10","4","3","31","12","12","15","0","39","20","9","8","0","1","38"
"Tripoli","32.88743","13.18733","34","4","0","0","1","0","0","39","14","10","4","3","31","12","12","15","0","39","20","9","8","0","1","38"
"Tripoli","34.43352","35.84415","34","4","0","0","1","0","0","39","14","10","4","3","31","12","12","15","0","39","20","9","8","0","1","38"
"Trollhättan","58.28365","12.28864","1","0","0","0","0","0","0","1","0","0","0","0","0","1","0","0","0","1","1","0","0","0","0","1"
"Trondheim","63.43049","10.39506","1","0","0","0","0","0","0","1","0","0","0","0","0","0","0","1","0","1","0","1","0","0","0","1"
"Troon","55.54359","-4.66335","3","0","0","0","0","0","1","4","1","0","3","0","4","1","0","3","0","4","0","1","3","0","0","4"
"Trowbridge","51.31889","-2.20861","13","2","0","1","1","0","0","17","6","4","5","0","15","8","2","7","0","17","3","6","6","0","1","16"
"Trujillo","23.15966","-103.17917","1","0","0","0","0","0","0","1","1","0","0","0","1","0","0","1","0","1","0","0","1","0","0","1"
"Trujillo","15.91667","-85.95417","1","0","0","0","0","0","0","1","1","0","0","0","1","0","0","1","0","1","0","0","1","0","0","1"
"Trujillo","-8.11599","-79.02998","1","0","0","0","0","0","0","1","1","0","0","0","1","0","0","1","0","1","0","0","1","0","0","1"
"Trujillo","4.21217","-76.31945","1","0","0","0","0","0","0","1","1","0","0","0","1","0","0","1","0","1","0","0","1","0","0","1"
"Trujillo","9.36583","-70.43694","1","0","0","0","0","0","0","1","1","0","0","0","1","0","0","1","0","1","0","0","1","0","0","1"
"Trujillo","39.45786","-5.88203","1","0","0","0","0","0","0","1","1","0","0","0","1","0","0","1","0","1","0","0","1","0","0","1"
"Trujillo Alto","18.35467","-66.00739","1","0","0","0","0","0","0","1","0","1","0","0","1","1","0","0","0","1","1","0","0","0","0","1"
"Truro","41.99344","-70.04975","24","0","0","0","3","0","2","29","2","11","9","1","23","13","3","12","1","29","6","6","15","0","2","29"
"Truro","45.36685","-63.26538","24","0","0","0","3","0","2","29","2","11","9","1","23","13","3","12","1","29","6","6","15","0","2","29"
"Truro","50.26526","-5.05436","24","0","0","0","3","0","2","29","2","11","9","1","23","13","3","12","1","29","6","6","15","0","2","29"
"Truro","-34.40869","139.12743","24","0","0","0","3","0","2","29","2","11","9","1","23","13","3","12","1","29","6","6","15","0","2","29"
"Ts’q’alt’ubo","42.32858","42.59808","1","0","0","0","0","0","0","1","1","0","0","0","1","1","0","0","0","1","0","0","1","0","0","1"
"Tsuchiura","36.09047","140.21047","1","0","0","0","0","0","0","1","0","1","0","0","1","1","0","0","0","1","0","0","1","0","0","1"
"Tuart Hill","-31.89808","115.83495","1","0","0","0","0","0","0","1","0","1","0","0","1","0","0","1","0","1","0","0","1","0","0","1"
"Tübingen","48.52266","9.05222","1","0","0","0","0","0","0","1","0","0","0","0","0","0","0","1","0","1","0","0","1","0","0","1"
"Tucson","32.22174","-110.92648","3","0","0","0","0","0","0","3","0","1","0","0","1","2","0","1","0","3","2","1","0","0","0","3"
"Tucupita","9.05806","-62.05","2","0","0","0","0","0","0","2","1","1","0","0","2","0","1","1","0","2","1","0","0","0","1","2"
"Tuguegarao","17.61577","121.72285","1","0","0","0","0","0","0","1","0","1","0","0","1","1","0","0","0","1","0","0","0","0","1","1"
"Tullamore","53.27389","-7.48889","1","0","0","0","0","0","0","1","0","0","1","0","1","0","0","1","0","1","0","0","1","0","0","1"
"Tullibody","56.13364","-3.83835","2","0","0","0","0","0","0","2","0","1","1","0","2","2","0","0","0","2","0","1","1","0","0","2"
"Tulsīpur","28.13099","82.29726","3","0","0","0","0","0","0","3","2","1","0","0","3","1","2","0","0","3","1","0","2","0","0","3"
"Tulsīpur","27.5337","82.41653","3","0","0","0","0","0","0","3","2","1","0","0","3","1","2","0","0","3","1","0","2","0","0","3"
"Tumkūr","13.34136","77.1022","2","0","0","0","0","0","0","2","1","0","0","0","1","1","1","0","0","2","0","0","2","0","0","2"
"Tunari","44.55","26.15","1","0","0","0","0","0","0","1","0","0","1","0","1","0","1","0","0","1","1","0","0","0","0","1"
"Tuni","17.35905","82.54607","0","0","0","0","0","0","0","0","0","0","0","0","0","0","0","0","0","0","0","0","0","0","0","0"
"Tunis","36.81897","10.16579","8","1","0","0","1","0","0","10","3","1","2","2","8","3","4","3","0","10","4","1","5","0","0","10"
"Tunis","-9.76","124.6056","8","1","0","0","1","0","0","10","3","1","2","2","8","3","4","3","0","10","4","1","5","0","0","10"
"Tunja","5.53528","-73.36778","1","0","0","0","0","0","0","1","0","1","0","0","1","1","0","0","0","1","0","0","1","0","0","1"
"Turbat","26.00122","63.04849","2","0","0","0","0","0","0","2","0","0","0","1","1","0","1","1","0","2","1","0","1","0","0","2"
"Turin","45.07049","7.68682","2","0","0","0","0","0","0","2","2","0","0","0","2","0","1","1","0","2","0","0","2","0","0","2"
"Tustin","33.74585","-117.82617","1","0","0","0","0","0","0","1","0","0","0","0","0","0","1","0","0","1","0","0","1","0","0","1"
"Tuxford","53.23004","-0.89325","1","0","0","0","0","0","0","1","0","0","1","0","1","0","1","0","0","1","0","0","1","0","0","1"
"Tuzla","44.53842","18.66709","5","0","0","0","0","0","0","5","0","1","0","0","1","2","1","2","0","5","3","0","2","0","0","5"
"Tuzla","44","28.63333","5","0","0","0","0","0","0","5","0","1","0","0","1","2","1","2","0","5","3","0","2","0","0","5"
"Tuzla","36.70074","35.08726","5","0","0","0","0","0","0","5","0","1","0","0","1","2","1","2","0","5","3","0","2","0","0","5"
"Twickenham","51.44489","-0.3377","32","3","0","0","2","0","1","38","8","3","14","0","25","13","4","21","0","38","3","10","25","0","0","38"
"Twyford","51.47518","-0.86037","1","0","0","0","0","0","0","1","0","0","0","0","0","1","0","0","0","1","0","0","1","0","0","1"
"Tyachiv","48.01179","23.57061","1","0","0","0","0","0","0","1","1","0","0","0","1","0","0","1","0","1","0","1","0","0","0","1"
"Tynemouth","55.01788","-1.42559","5","1","0","0","0","0","0","6","0","1","1","0","2","4","0","2","0","6","1","0","4","0","1","6"
"Tyre","33.27333","35.19389","1","0","0","0","0","0","0","1","0","1","0","0","1","1","0","0","0","1","0","1","0","0","0","1"
"Týrnavos","39.73778","22.28917","1","0","0","0","0","0","0","1","0","1","0","0","1","1","0","0","0","1","0","0","0","0","1","1"
"Tysons Corner","38.91872","-77.23109","1","0","0","0","0","0","0","1","0","1","0","0","1","1","0","0","0","1","1","0","0","0","0","1"
"Ubauro","28.16429","69.73114","0","0","0","0","0","0","0","0","0","0","0","0","0","0","1","0","0","1","0","0","1","0","0","1"
"Uckfield","50.96948","0.09589","5","1","0","0","0","0","0","6","2","1","2","0","5","1","1","4","0","6","1","1","3","0","1","6"
"Udaipur","24.58584","73.71346","1","0","0","0","0","0","0","1","1","0","0","0","1","0","0","1","0","1","0","0","1","0","0","1"
"Udaipur","27.72297","75.47178","1","0","0","0","0","0","0","1","1","0","0","0","1","0","0","1","0","1","0","0","1","0","0","1"
"Udaipur","23.53333","91.48333","1","0","0","0","0","0","0","1","1","0","0","0","1","0","0","1","0","1","0","0","1","0","0","1"
"Udine","46.0693","13.23715","3","0","0","0","0","0","0","3","2","1","0","0","3","2","0","0","0","2","1","0","0","0","2","3"
"Ufa","54.74306","55.96779","2","0","0","0","0","0","0","2","0","0","1","0","1","1","0","1","0","2","0","0","1","1","0","2"
"Ughelli","5.48956","6.00407","1","0","0","0","0","0","0","1","0","0","1","0","1","0","0","1","0","1","0","0","1","0","0","1"
"Ujjain","23.18239","75.77643","1","0","0","0","0","0","0","1","0","0","1","0","1","0","0","1","0","1","0","0","1","0","0","1"
"Ulan Bator","47.90771","106.88324","1","0","0","0","0","0","0","1","0","0","1","0","1","0","0","1","0","1","0","0","1","0","0","1"
"Ulcinj","41.92936","19.22436","1","0","0","0","0","0","0","1","0","1","0","0","1","1","0","0","0","1","1","0","0","0","0","1"
"Ulhasnagar","19.21667","73.15","2","0","0","0","0","0","0","2","0","0","1","0","1","0","2","0","0","2","0","1","0","0","1","2"
"Uliastay","47.74167","96.84444","1","0","0","0","0","0","0","1","0","0","1","0","1","1","0","0","0","1","0","0","1","0","0","1"
"Ulm","47.43051","-111.50719","1","0","0","0","0","0","0","1","0","0","1","0","1","1","0","0","0","1","0","0","1","0","0","1"
"Ulm","48.39841","9.99155","1","0","0","0","0","0","0","1","0","0","1","0","1","1","0","0","0","1","0","0","1","0","0","1"
"Ulverston","54.19594","-3.09626","7","0","0","0","1","0","0","8","1","2","3","0","6","3","1","4","0","8","2","2","3","0","1","8"
"Ulyanovsk","54.32824","48.38657","1","0","0","0","0","0","0","1","0","0","1","0","1","1","0","0","0","1","0","0","1","0","0","1"
"Umarkhed","19.60144","77.68878","1","0","0","0","0","0","0","1","1","0","0","0","1","0","0","1","0","1","0","0","1","0","0","1"
"Umarkot","25.36329","69.74184","1","0","0","0","0","0","0","1","1","0","0","0","1","0","1","0","0","1","0","0","1","0","0","1"
"Umarkot","19.66529","82.20629","1","0","0","0","0","0","0","1","1","0","0","0","1","0","1","0","0","1","0","0","1","0","0","1"
"Umm Şalāl ‘Alī","25.46972","51.3975","1","0","0","0","0","0","0","1","0","0","0","0","0","0","0","1","0","1","0","0","1","0","0","1"
"Ümraniye","41.03291","29.10137","2","0","0","0","0","0","0","2","0","1","1","0","2","0","0","2","0","2","1","0","1","0","0","2"
"Ungheni","46.48333","24.46667","1","0","0","0","0","0","0","1","1","0","0","0","1","1","0","0","0","1","0","0","1","0","0","1"
"Ungheni","44.5","24.96667","1","0","0","0","0","0","0","1","1","0","0","0","1","1","0","0","0","1","0","0","1","0","0","1"
"Ungheni","47.26467","26.45944","1","0","0","0","0","0","0","1","1","0","0","0","1","1","0","0","0","1","0","0","1","0","0","1"
"Ungheni","47.2","27.78333","1","0","0","0","0","0","0","1","1","0","0","0","1","1","0","0","0","1","0","0","1","0","0","1"
"Ungheni","47.21079","27.80047","1","0","0","0","0","0","0","1","1","0","0","0","1","1","0","0","0","1","0","0","1","0","0","1"
"Union","47.35509","-123.10099","1","0","0","0","0","0","0","1","0","0","1","0","1","0","0","1","0","1","0","0","1","0","0","1"
"Union","45.20847","-117.86521","1","0","0","0","0","0","0","1","0","0","1","0","1","0","0","1","0","1","0","0","1","0","0","1"
"Union","38.45005","-91.00848","1","0","0","0","0","0","0","1","0","0","1","0","1","0","0","1","0","1","0","0","1","0","0","1"
"Union","30.08714","-90.90482","1","0","0","0","0","0","0","1","0","0","1","0","1","0","0","1","0","1","0","0","1","0","0","1"
"Union","32.57153","-89.12145","1","0","0","0","0","0","0","1","0","0","1","0","1","0","0","1","0","1","0","0","1","0","0","1"
"Union","42.23308","-88.54231","1","0","0","0","0","0","0","1","0","0","1","0","1","0","0","1","0","1","0","0","1","0","0","1"
"Union","38.9459","-84.6805","1","0","0","0","0","0","0","1","0","0","1","0","1","0","0","1","0","1","0","0","1","0","0","1"
"Union","39.89783","-84.30633","1","0","0","0","0","0","0","1","0","0","1","0","1","0","0","1","0","1","0","0","1","0","0","1"
"Union","34.71541","-81.62371","1","0","0","0","0","0","0","1","0","0","1","0","1","0","0","1","0","1","0","0","1","0","0","1"
"Union","37.59151","-80.54368","1","0","0","0","0","0","0","1","0","0","1","0","1","0","0","1","0","1","0","0","1","0","0","1"
"Union","40.6976","-74.2632","1","0","0","0","0","0","0","1","0","0","1","0","1","0","0","1","0","1","0","0","1","0","0","1"
"Union","44.21147","-69.27421","1","0","0","0","0","0","0","1","0","0","1","0","1","0","0","1","0","1","0","0","1","0","0","1"
"Union","11.7612","121.8963","1","0","0","0","0","0","0","1","0","0","1","0","1","0","0","1","0","1","0","0","1","0","0","1"
"Union","10.6695","124.3252","1","0","0","0","0","0","0","1","0","0","1","0","1","0","0","1","0","1","0","0","1","0","0","1"
"Union","10.0475","124.5151","1","0","0","0","0","0","0","1","0","0","1","0","1","0","0","1","0","1","0","0","1","0","0","1"
"Union","9.75667","126.11028","1","0","0","0","0","0","0","1","0","0","1","0","1","0","0","1","0","1","0","0","1","0","0","1"
"Unterägeri","47.13645","8.5853","1","0","0","0","0","0","0","1","0","0","0","0","0","0","0","1","0","1","0","1","0","0","0","1"
"Upminster","51.55594","0.2556","9","0","0","0","2","0","2","13","2","4","6","0","12","6","3","4","0","13","0","1","9","1","2","13"
"Upper Hartfield","51.09325","0.09077","1","0","0","0","0","0","0","1","0","0","1","0","1","0","0","1","0","1","0","0","1","0","0","1"
"Upper Heyford","51.93558","-1.25451","1","0","0","0","0","0","0","1","0","1","0","0","1","1","0","0","0","1","0","0","1","0","0","1"
"Uppingham","52.58803","-0.72272","4","1","0","0","1","0","1","7","0","3","4","0","7","3","1","3","0","7","0","3","4","0","0","7"
"Uppsala","59.85882","17.63889","0","0","0","0","1","0","1","2","0","0","0","0","0","0","2","0","0","2","0","0","2","0","0","2"
"Ushirombo","-3.49194","31.96389","0","0","0","0","1","0","0","1","1","0","0","0","1","1","0","0","0","1","0","0","1","0","0","1"
"Usk","51.70347","-2.90332","1","0","0","0","0","0","0","1","0","1","0","0","1","0","0","1","0","1","1","0","0","0","0","1"
"Üsküdar","41.02274","29.01366","1","0","0","0","1","0","0","2","0","0","1","0","1","0","0","1","0","1","0","0","1","1","0","2"
"Utrecht","52.09083","5.12222","1","0","0","0","0","0","0","1","0","0","0","1","1","0","0","0","1","1","0","0","1","0","0","1"
"Utrecht","-27.65862","30.32166","1","0","0","0","0","0","0","1","0","0","0","1","1","0","0","0","1","1","0","0","1","0","0","1"
"Utsunomiya","36.56667","139.88333","1","0","0","0","0","0","0","1","0","1","0","0","1","0","1","0","0","1","1","0","0","0","0","1"
"Uttoxeter","52.89838","-1.86488","2","0","0","0","0","0","1","3","0","1","1","0","2","1","1","1","0","3","1","1","1","0","0","3"
"Uxbridge","44.10012","-79.11628","11","0","0","0","1","0","0","12","1","3","3","0","7","6","1","5","0","12","4","2","6","0","0","12"
"Uxbridge","42.07732","-71.62951","11","0","0","0","1","0","0","12","1","3","3","0","7","6","1","5","0","12","4","2","6","0","0","12"
"Uxbridge","51.5489","-0.48211","11","0","0","0","1","0","0","12","1","3","3","0","7","6","1","5","0","12","4","2","6","0","0","12"
"Uyo","5.05127","7.9335","4","0","0","0","0","0","0","4","0","0","2","0","2","2","1","1","0","4","0","1","2","0","0","3"
"Uzhgorod","48.61667","22.3","3","1","0","0","0","0","0","4","0","0","1","0","1","1","0","3","0","4","1","0","3","0","0","4"
"Užice","43.85861","19.84878","1","0","0","0","0","0","0","1","0","1","0","0","1","0","0","1","0","1","0","0","0","0","1","1"
"Vaasa","63.096","21.61577","1","0","0","0","0","0","0","1","0","0","0","0","0","1","0","0","0","1","1","0","0","0","0","1"
"Vacoas","-20.29806","57.47833","2","0","0","0","0","0","0","2","2","0","0","0","2","1","1","0","0","2","0","1","1","0","0","2"
"Vadodara","22.29941","73.20812","5","0","0","0","0","0","0","5","2","1","0","1","4","2","2","0","1","5","2","0","2","0","1","5"
"Valdina","38.19351","15.3698","1","0","0","0","0","0","0","1","1","0","0","0","1","1","0","0","0","1","0","0","0","1","0","1"
"Val-d'Or","48.0974","-77.79737","1","0","0","0","0","0","0","1","0","0","1","0","1","0","0","1","0","1","0","1","0","0","0","1"
"Valencia","34.44361","-118.60953","7","0","0","0","0","0","0","7","2","3","0","0","5","2","0","5","0","7","1","1","4","0","1","7"
"Valencia","34.7995","-106.7003","7","0","0","0","0","0","0","7","2","3","0","0","5","2","0","5","0","7","1","1","4","0","1","7"
"Valencia","40.67479","-79.9895","7","0","0","0","0","0","0","7","2","3","0","0","5","2","0","5","0","7","1","1","4","0","1","7"
"Valencia","8.25801","-76.14928","7","0","0","0","0","0","0","7","2","3","0","0","5","2","0","5","0","7","1","1","4","0","1","7"
"Valencia","10.16202","-68.00765","7","0","0","0","0","0","0","7","2","3","0","0","5","2","0","5","0","7","1","1","4","0","1","7"
"Valencia","39.46975","-0.37739","7","0","0","0","0","0","0","7","2","3","0","0","5","2","0","5","0","7","1","1","4","0","1","7"
"Valencia","9.2815","123.2455","7","0","0","0","0","0","0","7","2","3","0","0","5","2","0","5","0","7","1","1","4","0","1","7"
"Valencia","9.77158","123.36742","7","0","0","0","0","0","0","7","2","3","0","0","5","2","0","5","0","7","1","1","4","0","1","7"
"Valencia","10.136","123.6126","7","0","0","0","0","0","0","7","2","3","0","0","5","2","0","5","0","7","1","1","4","0","1","7"
"Valencia","9.6097","124.208","7","0","0","0","0","0","0","7","2","3","0","0","5","2","0","5","0","7","1","1","4","0","1","7"
"Valencia","11.10889","124.5725","7","0","0","0","0","0","0","7","2","3","0","0","5","2","0","5","0","7","1","1","4","0","1","7"
"Valera","9.31778","-70.60361","1","0","0","0","0","0","0","1","0","1","0","0","1","1","0","0","0","1","0","0","1","0","0","1"
"Valle de La Pascua","9.21554","-66.00734","1","0","0","0","0","0","0","1","0","0","1","0","1","0","0","1","0","1","1","0","0","0","0","1"
"Vallejo","38.10409","-122.25664","1","0","0","0","0","0","0","1","0","0","1","0","1","0","0","1","0","1","0","1","0","0","0","1"
"Valmiera","57.54108","25.42751","1","0","0","0","0","0","0","1","0","0","0","0","0","0","1","0","0","1","0","0","1","0","0","1"
"Van","32.52486","-95.63718","2","0","0","0","0","0","0","2","2","0","0","0","2","1","0","1","0","2","0","0","2","0","0","2"
"Van","38.49457","43.38323","2","0","0","0","0","0","0","2","2","0","0","0","2","1","0","1","0","2","0","0","2","0","0","2"
"Vanadzor","40.80456","44.4939","1","0","0","0","0","0","0","1","0","0","0","1","1","0","0","0","1","1","0","0","1","0","0","1"
"Vancouver","49.24966","-123.11934","3","0","0","0","3","0","1","7","2","2","1","0","5","5","0","2","0","7","1","4","2","0","0","7"
"Vancouver","45.63873","-122.66149","3","0","0","0","3","0","1","7","2","2","1","0","5","5","0","2","0","7","1","4","2","0","0","7"
"Vanderbijlpark","-26.71171","27.83795","2","0","0","0","0","0","0","2","0","1","0","0","1","2","0","0","0","2","2","0","0","0","0","2"
"Vani","42.08495","42.51192","1","0","0","0","0","0","0","1","1","0","0","0","1","0","1","0","0","1","0","0","0","0","0","0"
"Vaniyambadi","12.68162","78.62014","1","0","0","0","0","0","0","1","1","0","0","0","1","1","0","0","0","1","0","0","1","0","0","1"
"Vapi","20.37175","72.90493","1","0","0","0","0","0","0","1","0","1","0","0","1","0","1","0","0","1","1","0","0","0","0","1"
"Varanasi","25.31668","83.01041","2","0","0","0","0","0","0","2","2","0","0","0","2","1","0","1","0","2","0","0","2","0","0","2"
"Varaždin","46.30444","16.33778","1","0","0","0","0","0","0","1","0","1","0","0","1","0","0","1","0","1","1","0","0","0","0","1"
"Varna","46.73901","11.63749","12","0","0","0","0","0","1","13","1","4","0","1","6","5","3","5","0","13","3","1","7","1","1","13"
"Varna","44.67914","19.6515","12","0","0","0","0","0","1","13","1","4","0","1","6","5","3","5","0","13","3","1","7","1","1","13"
"Varna","43.21667","27.91667","12","0","0","0","0","0","1","13","1","4","0","1","6","5","3","5","0","13","3","1","7","1","1","13"
"Varna","53.38194","60.97472","12","0","0","0","0","0","1","13","1","4","0","1","6","5","3","5","0","13","3","1","7","1","1","13"
"Vatra Dornei","47.35","25.36667","1","0","0","0","0","0","0","1","0","0","1","0","1","0","1","0","0","1","0","0","1","0","0","1"
"Vaughan","43.8361","-79.49827","1","0","0","0","0","0","0","1","0","0","1","0","1","0","0","1","0","1","0","0","1","0","0","1"
"Vayk’","39.6889","45.46668","1","0","0","0","0","0","0","1","1","0","0","0","1","1","0","0","0","1","0","0","1","0","0","1"
"Vedano al Lambro","45.60878","9.26785","1","0","0","0","0","0","0","1","1","0","0","0","1","0","0","1","0","1","0","0","1","0","0","1"
"Veles","41.71556","21.77556","2","0","0","0","0","0","0","2","1","0","0","0","1","0","0","2","0","2","1","0","1","0","0","2"
"Veľký Meder","47.85798","17.76884","1","0","0","0","0","0","0","1","0","0","1","0","1","0","0","1","0","1","0","0","1","0","0","1"
"Vellinge","55.47124","13.01971","1","0","0","0","0","0","0","1","0","0","0","1","1","1","0","0","0","1","0","0","0","0","1","1"
"Vellore","12.9184","79.13255","2","0","0","0","0","0","0","2","2","0","0","0","2","1","0","1","0","2","0","1","1","0","0","2"
"Venice","33.99084","-118.46008","1","0","0","0","0","0","0","1","0","1","0","0","1","1","0","0","0","1","1","0","0","0","0","1"
"Venice","38.67227","-90.16983","1","0","0","0","0","0","0","1","0","1","0","0","1","1","0","0","0","1","1","0","0","0","0","1"
"Venice","27.09978","-82.45426","1","0","0","0","0","0","0","1","0","1","0","0","1","1","0","0","0","1","1","0","0","0","0","1"
"Venice","45.43713","12.33265","1","0","0","0","0","0","0","1","0","1","0","0","1","1","0","0","0","1","1","0","0","0","0","1"
"Ventnor","50.59449","-1.20672","1","0","0","0","0","0","0","1","0","1","0","0","1","1","0","0","0","1","1","0","0","0","0","1"
"Ventnor","-38.46273","145.19497","1","0","0","0","0","0","0","1","0","1","0","0","1","1","0","0","0","1","1","0","0","0","0","1"
"Ventura","34.27834","-119.29317","2","0","0","0","0","0","0","2","0","0","1","0","1","0","0","2","0","2","0","0","2","0","0","2"
"Ventura","43.12635","-93.47771","2","0","0","0","0","0","0","2","0","0","1","0","1","0","0","2","0","2","0","0","2","0","0","2"
"Verbier","46.1002","7.22651","1","1","0","0","0","0","0","2","1","0","0","0","1","1","0","1","0","2","0","0","2","0","0","2"
"Vernon","50.0261","-126.36157","1","0","0","0","0","0","0","1","0","0","0","0","0","1","0","0","0","1","1","0","0","0","0","1"
"Vernon","50.26729","-119.27337","1","0","0","0","0","0","0","1","0","0","0","0","0","1","0","0","0","1","1","0","0","0","0","1"
"Vernon","34.15536","-99.26628","1","0","0","0","0","0","0","1","0","0","0","0","0","1","0","0","0","1","1","0","0","0","0","1"
"Vernon","33.75705","-88.10892","1","0","0","0","0","0","0","1","0","0","0","0","0","1","0","0","0","1","1","0","0","0","0","1"
"Vernon","30.62297","-85.71215","1","0","0","0","0","0","0","1","0","0","0","0","0","1","0","0","0","1","1","0","0","0","0","1"
"Vernon","42.9392","-84.02941","1","0","0","0","0","0","0","1","0","0","0","0","0","1","0","0","0","1","1","0","0","0","0","1"
"Vernon","43.07951","-75.53934","1","0","0","0","0","0","0","1","0","0","0","0","0","1","0","0","0","1","1","0","0","0","0","1"
"Vernon","46.44031","0.47643","1","0","0","0","0","0","0","1","0","0","0","0","0","1","0","0","0","1","1","0","0","0","0","1"
"Vernon","49.09292","1.46332","1","0","0","0","0","0","0","1","0","0","0","0","0","1","0","0","0","1","1","0","0","0","0","1"
"Vernon Hills","42.21947","-87.97952","1","0","0","0","0","0","0","1","0","0","0","0","0","1","0","0","0","1","0","0","1","0","0","1"
"Verona","36.96395","-93.79576","3","0","0","0","0","0","0","3","0","1","0","0","1","2","0","1","0","3","1","0","1","0","1","3"
"Verona","42.99083","-89.53318","3","0","0","0","0","0","0","3","0","1","0","0","1","2","0","1","0","3","1","0","1","0","1","3"
"Verona","34.19427","-88.71977","3","0","0","0","0","0","0","3","0","1","0","0","1","2","0","1","0","3","1","0","1","0","1","3"
"Verona","38.8184","-84.66078","3","0","0","0","0","0","0","3","0","1","0","0","1","2","0","1","0","3","1","0","1","0","1","3"
"Verona","40.50646","-79.8431","3","0","0","0","0","0","0","3","0","1","0","0","1","2","0","1","0","3","1","0","1","0","1","3"
"Verona","38.20208","-79.00836","3","0","0","0","0","0","0","3","0","1","0","0","1","2","0","1","0","3","1","0","1","0","1","3"
"Verona","43.13812","-75.57073","3","0","0","0","0","0","0","3","0","1","0","0","1","2","0","1","0","3","1","0","1","0","1","3"
"Verona","40.82982","-74.24015","3","0","0","0","0","0","0","3","0","1","0","0","1","2","0","1","0","3","1","0","1","0","1","3"
"Verona","44.56535","-68.79031","3","0","0","0","0","0","0","3","0","1","0","0","1","2","0","1","0","3","1","0","1","0","1","3"
"Verona","45.4299","10.98444","3","0","0","0","0","0","0","3","0","1","0","0","1","2","0","1","0","3","1","0","1","0","1","3"
"Versoix","46.28382","6.16214","1","0","0","0","0","0","0","1","0","1","0","0","1","1","0","0","0","1","0","0","1","0","0","1"
"Verwood","50.87575","-1.87023","4","0","0","0","0","0","1","5","0","1","4","0","5","1","0","4","0","5","0","1","4","0","0","5"
"Veymandoo","2.18772","73.09556","1","0","0","0","0","0","0","1","0","1","0","0","1","0","1","0","0","1","0","0","0","0","1","1"
"Vibo Valentia","38.67618","16.10094","1","0","0","0","0","0","0","1","0","0","0","0","0","1","0","0","0","1","1","0","0","0","0","1"
"Vicenza","45.54672","11.5475","1","0","0","0","0","0","0","1","0","0","0","0","0","0","0","0","0","0","0","0","0","0","1","1"
"Viçosa","-20.75389","-42.88194","0","0","0","0","1","0","0","1","1","0","0","0","1","0","1","0","0","1","0","0","1","0","0","1"
"Viçosa","-9.37139","-36.24083","0","0","0","0","1","0","0","1","1","0","0","0","1","0","1","0","0","1","0","0","1","0","0","1"
"Victoria","48.4359","-123.35155","3","0","0","1","0","0","0","4","2","0","0","0","2","2","0","2","0","4","2","1","1","0","0","4"
"Victoria","21.21183","-100.21545","3","0","0","1","0","0","0","4","2","0","0","0","2","2","0","2","0","4","2","1","1","0","0","4"
"Victoria","38.85279","-99.1476","3","0","0","1","0","0","0","4","2","0","0","0","2","2","0","2","0","4","2","1","1","0","0","4"
"Victoria","18.65469","-97.94141","3","0","0","1","0","0","0","4","2","0","0","0","2","2","0","2","0","4","2","1","1","0","0","4"
"Victoria","28.80527","-97.0036","3","0","0","1","0","0","0","4","2","0","0","0","2","2","0","2","0","4","2","1","1","0","0","4"
"Victoria","44.85857","-93.66163","3","0","0","1","0","0","0","4","2","0","0","0","2","2","0","2","0","4","2","1","1","0","0","4"
"Victoria","13.95","-88.63333","3","0","0","1","0","0","0","4","2","0","0","0","2","2","0","2","0","4","2","1","1","0","0","4"
"Victoria","15.50381","-87.82625","3","0","0","1","0","0","0","4","2","0","0","0","2","2","0","2","0","4","2","1","1","0","0","4"
"Victoria","36.99487","-78.22722","3","0","0","1","0","0","0","4","2","0","0","0","2","2","0","2","0","4","2","1","1","0","0","4"
"Victoria","5.31648","-74.91101","3","0","0","1","0","0","0","4","2","0","0","0","2","2","0","2","0","4","2","1","1","0","0","4"
"Victoria","-38.23291","-72.33292","3","0","0","1","0","0","0","4","2","0","0","0","2","2","0","2","0","4","2","1","1","0","0","4"
"Victoria","12.19021","-61.70677","3","0","0","1","0","0","0","4","2","0","0","0","2","2","0","2","0","4","2","1","1","0","0","4"
"Victoria","-32.61841","-60.15478","3","0","0","1","0","0","0","4","2","0","0","0","2","2","0","2","0","4","2","1","1","0","0","4"
"Victoria","51.75","-3.2","3","0","0","1","0","0","0","4","2","0","0","0","2","2","0","2","0","4","2","1","1","0","0","4"
"Victoria","36.04444","14.23972","3","0","0","1","0","0","0","4","2","0","0","0","2","2","0","2","0","4","2","1","1","0","0","4"
"Victoria","45.72968","24.7028","3","0","0","1","0","0","0","4","2","0","0","0","2","2","0","2","0","4","2","1","1","0","0","4"
"Victoria","47.61018","27.1673","3","0","0","1","0","0","0","4","2","0","0","0","2","2","0","2","0","4","2","1","1","0","0","4"
"Victoria","47.28333","27.58333","3","0","0","1","0","0","0","4","2","0","0","0","2","2","0","2","0","4","2","1","1","0","0","4"
"Victoria","44.81667","27.61667","3","0","0","1","0","0","0","4","2","0","0","0","2","2","0","2","0","4","2","1","1","0","0","4"
"Victoria","-4.62001","55.45501","3","0","0","1","0","0","0","4","2","0","0","0","2","2","0","2","0","4","2","1","1","0","0","4"
"Victoria","15.5775","120.6822","3","0","0","1","0","0","0","4","2","0","0","0","2","2","0","2","0","4","2","1","1","0","0","4"
"Victoria","13.17722","121.27806","3","0","0","1","0","0","0","4","2","0","0","0","2","2","0","2","0","4","2","1","1","0","0","4"
"Victoria","14.2277","121.3292","3","0","0","1","0","0","0","4","2","0","0","0","2","2","0","2","0","4","2","1","1","0","0","4"
"Victoria","12.44722","124.31111","3","0","0","1","0","0","0","4","2","0","0","0","2","2","0","2","0","4","2","1","1","0","0","4"
"Victoria Point","-27.58329","153.31172","0","0","0","0","1","0","0","1","0","0","0","0","0","0","0","1","0","1","0","1","0","0","0","1"
"Vidin","43.99159","22.88236","2","0","0","0","0","0","0","2","0","1","0","0","1","0","2","0","0","2","0","0","0","0","2","2"
"Vienna","38.18671","-91.94711","9","0","0","0","0","0","0","9","3","2","2","0","7","3","1","4","1","9","2","1","6","0","0","9"
"Vienna","37.41533","-88.89784","9","0","0","0","0","0","0","9","3","2","2","0","7","3","1","4","1","9","2","1","6","0","0","9"
"Vienna","32.09156","-83.79545","9","0","0","0","0","0","0","9","3","2","2","0","7","3","1","4","1","9","2","1","6","0","0","9"
"Vienna","39.32702","-81.54846","9","0","0","0","0","0","0","9","3","2","2","0","7","3","1","4","1","9","2","1","6","0","0","9"
"Vienna","38.90122","-77.26526","9","0","0","0","0","0","0","9","3","2","2","0","7","3","1","4","1","9","2","1","6","0","0","9"
"Vienna","40.86871","-74.88906","9","0","0","0","0","0","0","9","3","2","2","0","7","3","1","4","1","9","2","1","6","0","0","9"
"Vienna","44.5334","-69.98478","9","0","0","0","0","0","0","9","3","2","2","0","7","3","1","4","1","9","2","1","6","0","0","9"
"Vienna","48.20849","16.37208","9","0","0","0","0","0","0","9","3","2","2","0","7","3","1","4","1","9","2","1","6","0","0","9"
"Vientiane","17.96667","102.6","8","0","0","0","0","0","0","8","0","8","0","0","8","7","0","1","0","8","6","1","0","0","1","8"
"Vierkirchen","48.36667","11.46667","1","1","0","0","0","0","0","2","0","0","2","0","2","0","0","2","0","2","0","0","2","0","0","2"
"Vigo","42.23282","-8.72264","1","0","0","0","0","0","0","1","0","0","0","0","0","0","0","1","0","1","1","0","0","0","0","1"
"Vigo","45.97841","10.98041","1","0","0","0","0","0","0","1","0","0","0","0","0","0","0","1","0","1","1","0","0","0","0","1"
"Vigo","13.82666","120.17922","1","0","0","0","0","0","0","1","0","0","0","0","0","0","0","1","0","1","1","0","0","0","0","1"
"Vihari","30.0445","72.3556","2","0","0","0","0","0","0","2","1","1","0","0","2","0","0","2","0","2","0","0","2","0","0","2"
"Vijayawada","16.50745","80.6466","3","1","0","0","0","0","0","4","4","0","0","0","4","0","1","3","0","4","0","0","4","0","0","4"
"Vila Franca de Xira","38.95525","-8.98966","2","0","0","0","0","0","0","2","1","0","1","0","2","1","0","1","0","2","0","1","1","0","0","2"
"Vila Nova de Famalicão","41.40797","-8.51978","0","1","0","0","0","0","0","1","1","0","0","0","1","0","0","1","0","1","0","1","0","0","0","1"
"Vila Nova de Gaia","41.12401","-8.61241","1","0","0","0","1","0","0","2","0","2","0","0","2","0","1","1","0","2","2","0","0","0","0","2"
"Vila Real","41.30062","-7.74413","1","0","0","0","0","0","0","1","0","1","0","0","1","0","1","0","0","1","1","0","0","0","0","1"
"Villa Allende","-31.29458","-64.29538","1","0","0","0","0","0","0","1","0","0","1","0","1","0","0","1","0","1","0","1","0","0","0","1"
"Villafranca de los Barros","38.56144","-6.3381","1","0","0","0","0","0","0","1","1","0","0","0","1","1","0","0","0","1","0","0","1","0","0","1"
"Villahermosa","16.01667","-93.81917","1","0","0","0","0","0","0","1","1","0","0","0","1","0","0","1","0","1","0","1","0","0","0","1"
"Villahermosa","17.98689","-92.93028","1","0","0","0","0","0","0","1","1","0","0","0","1","0","0","1","0","1","0","1","0","0","0","1"
"Villahermosa","5.03067","-75.11607","1","0","0","0","0","0","0","1","1","0","0","0","1","0","0","1","0","1","0","1","0","0","0","1"
"Villahermosa","38.75023","-2.87066","1","0","0","0","0","0","0","1","1","0","0","0","1","0","0","1","0","1","0","1","0","0","0","1"
"Villahermosa","13.0458","123.7133","1","0","0","0","0","0","0","1","1","0","0","0","1","0","0","1","0","1","0","1","0","0","0","1"
"Villupuram","11.93975","79.49244","0","1","0","0","0","0","0","1","0","1","0","0","1","1","0","0","0","1","0","0","1","0","0","1"
"Vilnius","54.68916","25.2798","6","1","0","0","6","0","0","13","8","0","1","0","9","3","1","9","0","13","1","0","11","1","0","13"
"Viña del Mar","-33.02457","-71.55183","1","0","0","0","0","0","0","1","1","0","0","0","1","0","0","1","0","1","0","0","1","0","0","1"
"Vinchia","22.21027","71.37967","1","0","0","0","0","0","0","1","1","0","0","0","1","0","0","1","0","1","0","1","0","0","0","1"
"Vinh","18.67337","105.69232","1","0","0","0","0","0","0","1","1","0","0","0","1","1","0","0","0","1","0","0","1","0","0","1"
"Vinnytsia","49.23278","28.48097","15","0","0","0","1","0","0","16","4","0","8","0","12","8","2","6","0","16","0","0","15","0","1","16"
"Virginia","47.52326","-92.53657","2","0","0","0","0","0","0","2","0","0","0","0","0","1","1","0","0","2","0","1","1","0","0","2"
"Virginia","39.95116","-90.21234","2","0","0","0","0","0","0","2","0","0","0","0","0","1","1","0","0","2","0","1","1","0","0","2"
"Virginia","53.83389","-7.07556","2","0","0","0","0","0","0","2","0","0","0","0","0","1","1","0","0","2","0","1","1","0","0","2"
"Virginia","-28.10391","26.86593","2","0","0","0","0","0","0","2","0","0","0","0","0","1","1","0","0","2","0","1","1","0","0","2"
"Virginia","-12.51895","131.02844","2","0","0","0","0","0","0","2","0","0","0","0","0","1","1","0","0","2","0","1","1","0","0","2"
"Virginia","-34.6663","138.56027","2","0","0","0","0","0","0","2","0","0","0","0","0","1","1","0","0","2","0","1","1","0","0","2"
"Virginia","-27.38333","153.06667","2","0","0","0","0","0","0","2","0","0","0","0","0","1","1","0","0","2","0","1","1","0","0","2"
"Virginia Beach","36.85293","-75.97799","2","0","0","0","0","0","0","2","0","0","0","0","0","0","1","1","0","2","0","0","2","0","0","2"
"Virginia Water","51.40343","-0.56651","1","0","0","0","0","0","1","2","0","0","1","0","1","1","0","1","0","2","0","1","1","0","0","2"
"Virudunagar","9.58509","77.95787","0","0","0","1","0","0","0","1","1","0","0","0","1","0","1","0","0","1","0","0","1","0","0","1"
"Visakhapatnam","17.68009","83.20161","3","0","0","0","0","0","0","3","1","2","0","0","3","0","1","2","0","3","0","0","3","0","0","3"
"Vitória","-20.31944","-40.33778","0","1","0","0","0","0","0","1","1","0","0","0","1","0","0","1","0","1","0","0","1","0","0","1"
"Vittoriosa","35.89222","14.51833","1","0","0","0","0","0","0","1","0","1","0","0","1","1","0","0","0","1","1","0","0","0","0","1"
"Vizianagaram","18.11692","83.41148","1","0","0","0","0","0","0","1","0","0","1","0","1","1","0","0","0","1","0","1","0","0","0","1"
"Vlorë","40.4686","19.48318","1","0","0","0","0","0","0","1","1","0","0","0","1","1","0","0","0","1","0","1","0","0","0","1"
"Voi","-3.39605","38.55609","1","1","0","0","0","0","0","2","0","0","1","0","1","1","0","1","0","2","1","0","1","0","0","2"
"Voinjama","8.42194","-9.74778","2","0","0","0","0","0","0","2","0","0","0","1","1","2","0","0","0","2","0","0","1","0","1","2"
"Volgograd","48.71939","44.50183","2","1","0","0","0","0","0","3","3","0","0","0","3","0","0","3","0","3","0","0","3","0","0","3"
"Völklingen","49.25162","6.85873","1","0","0","0","0","0","0","1","1","0","0","0","1","1","0","0","0","1","1","0","0","0","0","1"
"Volos","39.36103","22.94248","1","0","0","0","0","0","0","1","0","0","1","0","1","0","0","1","0","1","0","0","1","0","0","1"
"Voluntari","44.49002","26.17338","1","0","0","0","0","0","0","1","1","0","0","0","1","1","0","0","0","1","0","0","1","0","0","1"
"Voorburg","52.07417","4.35972","1","0","0","0","0","0","0","1","0","0","1","0","1","1","0","0","0","1","0","0","1","0","0","1"
"Voronezh","51.67204","39.1843","1","0","0","0","0","0","0","1","1","0","0","0","1","1","0","0","0","1","0","0","1","0","0","1"
"Vranje","42.55139","21.90028","1","0","0","0","0","0","0","1","1","0","0","0","1","0","0","1","0","1","0","0","1","0","0","1"
"Vrilissia","38.03381","23.82962","1","0","0","0","0","0","0","1","0","1","0","0","1","0","0","1","0","1","0","1","0","0","0","1"
"Vryheid","-27.76952","30.79165","1","0","0","0","0","0","0","1","0","0","0","0","0","0","1","0","0","1","0","0","1","0","0","1"
"Vushtrri","42.82306","20.9675","1","0","0","0","0","0","0","1","0","0","0","0","0","0","1","0","0","1","0","0","1","0","0","1"
"Vysoké Mýto","49.9532","16.16169","1","0","0","0","0","0","0","1","0","1","0","0","1","0","0","1","0","1","0","0","0","0","1","1"
"Vysoké Tatry","49.13637","20.24386","0","1","0","0","0","0","0","1","0","0","1","0","1","0","1","0","0","1","0","1","0","0","0","1"
"Wa","10.06069","-2.50192","3","0","0","0","0","0","0","3","0","3","0","1","4","3","0","1","0","4","1","1","2","0","0","4"
"Wadebridge","50.51734","-4.83633","5","0","0","0","0","0","1","6","3","0","2","0","5","4","0","2","0","6","0","2","4","0","0","6"
"Wadhurst","51.0623","0.33929","1","0","0","0","0","0","0","1","0","1","0","0","1","1","0","0","0","1","0","0","1","0","0","1"
"Wajir","1.7471","40.05732","0","0","0","0","0","0","0","0","0","0","0","0","0","0","0","0","0","0","0","0","0","0","0","0"
"Wakefield","39.21333","-97.00557","43","2","0","0","3","0","2","50","7","16","19","0","42","18","6","26","0","50","9","10","31","0","1","51"
"Wakefield","42.26917","-96.86504","43","2","0","0","3","0","2","50","7","16","19","0","42","18","6","26","0","50","9","10","31","0","1","51"
"Wakefield","46.47523","-89.93989","43","2","0","0","3","0","2","50","7","16","19","0","42","18","6","26","0","50","9","10","31","0","1","51"
"Wakefield","18.41211","-77.72183","43","2","0","0","3","0","2","50","7","16","19","0","42","18","6","26","0","50","9","10","31","0","1","51"
"Wakefield","36.96821","-76.98968","43","2","0","0","3","0","2","50","7","16","19","0","42","18","6","26","0","50","9","10","31","0","1","51"
"Wakefield","39.77372","-76.17912","43","2","0","0","3","0","2","50","7","16","19","0","42","18","6","26","0","50","9","10","31","0","1","51"
"Wakefield","45.6668","-75.83265","43","2","0","0","3","0","2","50","7","16","19","0","42","18","6","26","0","50","9","10","31","0","1","51"
"Wakefield","40.89788","-73.85236","43","2","0","0","3","0","2","50","7","16","19","0","42","18","6","26","0","50","9","10","31","0","1","51"
"Wakefield","42.50648","-71.07283","43","2","0","0","3","0","2","50","7","16","19","0","42","18","6","26","0","50","9","10","31","0","1","51"
"Wakefield","43.56813","-71.03007","43","2","0","0","3","0","2","50","7","16","19","0","42","18","6","26","0","50","9","10","31","0","1","51"
"Wakefield","53.68331","-1.49768","43","2","0","0","3","0","2","50","7","16","19","0","42","18","6","26","0","50","9","10","31","0","1","51"
"Wakefield","-41.4","173.05","43","2","0","0","3","0","2","50","7","16","19","0","42","18","6","26","0","50","9","10","31","0","1","51"
"Wakiso","0.40444","32.45944","4","0","0","1","0","0","0","5","0","2","3","0","5","1","2","2","0","5","1","1","2","0","1","5"
"Waldorf","38.62456","-76.93914","0","0","0","0","0","0","1","1","0","0","1","0","1","1","0","0","0","1","0","0","1","0","0","1"
"Waldorf","50.48333","7.23333","0","0","0","0","0","0","1","1","0","0","1","0","1","1","0","0","0","1","0","0","1","0","0","1"
"Wales","43.00445","-88.37676","14","0","0","0","2","0","0","16","5","5","4","0","14","8","1","7","0","16","4","6","5","1","0","16"
"Wales","42.06954","-72.2223","14","0","0","0","2","0","0","16","5","5","4","0","14","8","1","7","0","16","4","6","5","1","0","16"
"Wales","53.34061","-1.28162","14","0","0","0","2","0","0","16","5","5","4","0","14","8","1","7","0","16","4","6","5","1","0","16"
"Walkden","53.51667","-2.4","1","0","0","0","0","0","0","1","0","0","1","0","1","0","1","0","0","1","0","0","1","0","0","1"
"Wallasey","53.42324","-3.06497","6","0","0","0","0","0","1","7","0","2","3","0","5","2","1","4","0","7","0","2","5","0","0","7"
"Wallingford","43.47192","-72.97823","6","0","0","0","2","0","0","8","2","0","3","0","5","3","0","5","0","8","0","1","7","0","0","8"
"Wallingford","41.45704","-72.82316","6","0","0","0","2","0","0","8","2","0","3","0","5","3","0","5","0","8","0","1","7","0","0","8"
"Wallingford","51.59982","-1.1248","6","0","0","0","2","0","0","8","2","0","3","0","5","3","0","5","0","8","0","1","7","0","0","8"
"Wallisellen","47.41499","8.59672","0","0","0","0","0","0","1","1","1","0","0","0","1","0","0","1","0","1","0","0","1","0","0","1"
"Wallsend","54.99111","-1.53397","1","0","0","0","1","0","0","2","0","0","1","0","1","1","1","0","0","2","0","1","1","0","0","2"
"Wallsend","-32.90133","151.66432","1","0","0","0","1","0","0","2","0","0","1","0","1","1","1","0","0","2","0","1","1","0","0","2"
"Walnut Creek","37.90631","-122.06496","4","0","0","0","0","0","0","4","2","2","0","0","4","1","1","2","0","4","1","1","2","0","0","4"
"Walnut Creek","35.13124","-114.12662","4","0","0","0","0","0","0","4","2","2","0","0","4","1","1","2","0","4","1","1","2","0","0","4"
"Walnut Creek","40.54145","-81.7218","4","0","0","0","0","0","0","4","2","2","0","0","4","1","1","2","0","4","1","1","2","0","0","4"
"Walnut Creek","35.30711","-77.86498","4","0","0","0","0","0","0","4","2","2","0","0","4","1","1","2","0","4","1","1","2","0","0","4"
"Walsall","52.58528","-1.98396","27","0","0","0","2","0","3","32","6","11","5","1","23","14","5","13","0","32","7","7","16","2","0","32"
"Waltham Abbey","51.687","-0.00421","2","0","0","0","0","0","0","2","1","0","1","0","2","1","0","1","0","2","0","0","2","0","0","2"
"Waltham Cross","51.68602","-0.03575","2","0","0","1","0","0","0","3","1","1","1","0","3","2","0","1","0","3","0","2","1","0","0","3"
"Walthamstow","51.59067","-0.02077","1","0","0","0","0","0","0","1","1","0","0","0","1","1","0","0","0","1","0","0","1","0","0","1"
"Walton-on-Thames","51.38678","-0.41319","6","1","0","1","2","0","0","10","1","2","6","1","10","2","2","6","0","10","0","3","5","1","1","10"
"Wan Chai","22.28142","114.17258","1","0","0","0","0","0","0","1","0","0","1","0","1","0","1","0","0","1","0","0","1","0","0","1"
"Wandsworth","51.4577","-0.20784","4","0","0","0","0","0","0","4","1","0","1","0","2","2","0","2","0","4","0","0","4","0","0","4"
"Wang Thonglang","13.78546","100.61165","1","0","0","0","0","0","0","1","0","0","1","0","1","0","1","0","0","1","0","0","1","0","0","1"
"Wantage","51.58846","-1.42565","6","0","0","0","1","0","1","8","1","4","3","0","8","4","0","4","0","8","0","2","6","0","0","8"
"Warangal","18","79.58333","1","0","0","0","0","0","0","1","0","0","1","0","1","0","0","1","0","1","0","0","1","0","0","1"
"Ware","42.25981","-72.2398","8","0","0","0","2","0","1","11","2","3","4","0","9","3","2","6","0","11","2","4","5","0","0","11"
"Ware","51.81058","-0.02875","8","0","0","0","2","0","1","11","2","3","4","0","9","3","2","6","0","11","2","4","5","0","0","11"
"Wareham","50.68792","-2.11058","2","0","0","0","1","0","0","3","0","2","0","1","3","0","0","2","1","3","1","0","2","0","0","3"
"Warfield","51.44213","-0.72802","2","0","0","0","0","0","0","2","1","0","1","0","2","0","0","2","0","2","0","0","2","0","0","2"
"Wargrave","51.50068","-0.86577","0","0","0","1","0","0","0","1","1","0","0","0","1","0","0","1","0","1","0","0","1","0","0","1"
"Warlingham","51.30953","-0.05794","0","0","0","0","0","0","1","1","1","0","0","0","1","0","0","1","0","1","0","0","1","0","0","1"
"Warminster","51.20434","-2.17873","1","0","0","0","0","0","0","1","0","1","0","0","1","0","0","1","0","1","1","0","0","0","0","1"
"Warri","5.51737","5.75006","5","0","0","0","0","0","0","5","3","1","0","0","4","3","0","2","0","5","2","1","1","0","1","5"
"Warrington","30.38409","-87.27497","71","1","0","1","5","0","3","81","18","21","17","0","56","30","11","39","1","81","15","15","50","0","1","81"
"Warrington","53.39254","-2.58024","71","1","0","1","5","0","3","81","18","21","17","0","56","30","11","39","1","81","15","15","50","0","1","81"
"Warrington","52.18446","-0.68759","71","1","0","1","5","0","3","81","18","21","17","0","56","30","11","39","1","81","15","15","50","0","1","81"
"Warsaw","44.24941","-93.39383","8","0","0","0","0","0","1","9","2","0","2","0","4","0","3","6","0","9","0","1","8","0","0","9"
"Warsaw","38.24308","-93.38187","8","0","0","0","0","0","1","9","2","0","2","0","4","0","3","6","0","9","0","1","8","0","0","9"
"Warsaw","40.35921","-91.4346","8","0","0","0","0","0","1","9","2","0","2","0","4","0","3","6","0","9","0","1","8","0","0","9"
"Warsaw","41.2381","-85.85305","8","0","0","0","0","0","1","9","2","0","2","0","4","0","3","6","0","9","0","1","8","0","0","9"
"Warsaw","38.7834","-84.90162","8","0","0","0","0","0","1","9","2","0","2","0","4","0","3","6","0","9","0","1","8","0","0","9"
"Warsaw","40.33535","-82.00681","8","0","0","0","0","0","1","9","2","0","2","0","4","0","3","6","0","9","0","1","8","0","0","9"
"Warsaw","42.74006","-78.13279","8","0","0","0","0","0","1","9","2","0","2","0","4","0","3","6","0","9","0","1","8","0","0","9"
"Warsaw","34.99933","-78.0911","8","0","0","0","0","0","1","9","2","0","2","0","4","0","3","6","0","9","0","1","8","0","0","9"
"Warsaw","37.95874","-76.75801","8","0","0","0","0","0","1","9","2","0","2","0","4","0","3","6","0","9","0","1","8","0","0","9"
"Warsaw","52.22977","21.01178","8","0","0","0","0","0","1","9","2","0","2","0","4","0","3","6","0","9","0","1","8","0","0","9"
"Warwick","41.25648","-74.35988","19","0","0","0","3","0","4","26","2","9","8","0","19","12","6","8","0","26","4","4","17","0","1","26"
"Warwick","42.68203","-72.33897","19","0","0","0","3","0","4","26","2","9","8","0","19","12","6","8","0","26","4","4","17","0","1","26"
"Warwick","45.95007","-71.9824","19","0","0","0","3","0","4","26","2","9","8","0","19","12","6","8","0","26","4","4","17","0","1","26"
"Warwick","41.7001","-71.41617","19","0","0","0","3","0","4","26","2","9","8","0","19","12","6","8","0","26","4","4","17","0","1","26"
"Warwick","52.28333","-1.58333","19","0","0","0","3","0","4","26","2","9","8","0","19","12","6","8","0","26","4","4","17","0","1","26"
"Warwick","-31.83974","115.80855","19","0","0","0","3","0","4","26","2","9","8","0","19","12","6","8","0","26","4","4","17","0","1","26"
"Warwick","-28.21901","152.03438","19","0","0","0","3","0","4","26","2","9","8","0","19","12","6","8","0","26","4","4","17","0","1","26"
"Washington","37.13054","-113.50829","19","0","0","0","1","0","0","20","1","5","10","0","16","8","5","7","0","20","2","6","12","0","0","20"
"Washington","35.05896","-97.48448","19","0","0","0","1","0","0","20","1","5","10","0","16","8","5","7","0","20","2","6","12","0","0","20"
"Washington","39.81806","-97.05086","19","0","0","0","1","0","0","20","1","5","10","0","16","8","5","7","0","20","2","6","12","0","0","20"
"Washington","30.61631","-92.05706","19","0","0","0","1","0","0","20","1","5","10","0","16","8","5","7","0","20","2","6","12","0","0","20"
"Washington","41.29918","-91.69294","19","0","0","0","1","0","0","20","1","5","10","0","16","8","5","7","0","20","2","6","12","0","0","20"
"Washington","38.55811","-91.01209","19","0","0","0","1","0","0","20","1","5","10","0","16","8","5","7","0","20","2","6","12","0","0","20"
"Washington","40.70365","-89.40731","19","0","0","0","1","0","0","20","1","5","10","0","16","8","5","7","0","20","2","6","12","0","0","20"
"Washington","38.65922","-87.17279","19","0","0","0","1","0","0","20","1","5","10","0","16","8","5","7","0","20","2","6","12","0","0","20"
"Washington","45.3947","-86.93151","19","0","0","0","1","0","0","20","1","5","10","0","16","8","5","7","0","20","2","6","12","0","0","20"
"Washington","33.73679","-82.73931","19","0","0","0","1","0","0","20","1","5","10","0","16","8","5","7","0","20","2","6","12","0","0","20"
"Washington","39.26119","-81.6718","19","0","0","0","1","0","0","20","1","5","10","0","16","8","5","7","0","20","2","6","12","0","0","20"
"Washington","40.17396","-80.24617","19","0","0","0","1","0","0","20","1","5","10","0","16","8","5","7","0","20","2","6","12","0","0","20"
"Washington","38.71345","-78.15944","19","0","0","0","1","0","0","20","1","5","10","0","16","8","5","7","0","20","2","6","12","0","0","20"
"Washington","35.54655","-77.05217","19","0","0","0","1","0","0","20","1","5","10","0","16","8","5","7","0","20","2","6","12","0","0","20"
"Washington","40.75843","-74.97934","19","0","0","0","1","0","0","20","1","5","10","0","16","8","5","7","0","20","2","6","12","0","0","20"
"Washington","41.63148","-73.31067","19","0","0","0","1","0","0","20","1","5","10","0","16","8","5","7","0","20","2","6","12","0","0","20"
"Washington","42.36592","-73.11621","19","0","0","0","1","0","0","20","1","5","10","0","16","8","5","7","0","20","2","6","12","0","0","20"
"Washington","44.10562","-72.4326","19","0","0","0","1","0","0","20","1","5","10","0","16","8","5","7","0","20","2","6","12","0","0","20"
"Washington","43.17591","-72.09675","19","0","0","0","1","0","0","20","1","5","10","0","16","8","5","7","0","20","2","6","12","0","0","20"
"Washington","44.27369","-69.36727","19","0","0","0","1","0","0","20","1","5","10","0","16","8","5","7","0","20","2","6","12","0","0","20"
"Washington","54.9","-1.51667","19","0","0","0","1","0","0","20","1","5","10","0","16","8","5","7","0","20","2","6","12","0","0","20"
"Washington","50.90487","-0.40649","19","0","0","0","1","0","0","20","1","5","10","0","16","8","5","7","0","20","2","6","12","0","0","20"
"Washington Boro","39.9926","-76.46719","1","0","0","0","0","0","0","1","0","0","1","0","1","0","0","1","0","1","0","0","1","0","0","1"
"Wassenaar","52.14583","4.40278","1","0","0","0","0","0","0","1","0","0","0","0","0","1","0","0","0","1","0","1","0","0","0","1"
"Waterford","37.64132","-120.76048","2","0","0","0","0","0","0","2","0","1","1","0","2","1","0","1","0","2","2","0","0","0","0","2"
"Waterford","42.76307","-88.21426","2","0","0","0","0","0","0","2","0","1","1","0","2","1","0","1","0","2","2","0","0","0","0","2"
"Waterford","42.69303","-83.41181","2","0","0","0","0","0","0","2","0","1","1","0","2","1","0","1","0","2","2","0","0","0","0","2"
"Waterford","42.9334","-80.28296","2","0","0","0","0","0","0","2","0","1","1","0","2","1","0","1","0","2","2","0","0","0","0","2"
"Waterford","41.94283","-79.9845","2","0","0","0","0","0","0","2","0","1","1","0","2","1","0","1","0","2","2","0","0","0","0","2"
"Waterford","40.25452","-79.16753","2","0","0","0","0","0","0","2","0","1","1","0","2","1","0","1","0","2","2","0","0","0","0","2"
"Waterford","42.79258","-73.68123","2","0","0","0","0","0","0","2","0","1","1","0","2","1","0","1","0","2","2","0","0","0","0","2"
"Waterford","41.3417","-72.13597","2","0","0","0","0","0","0","2","0","1","1","0","2","1","0","1","0","2","2","0","0","0","0","2"
"Waterford","52.25833","-7.11194","2","0","0","0","0","0","0","2","0","1","1","0","2","1","0","1","0","2","2","0","0","0","0","2"
"Waterford","-32.01574","115.88662","2","0","0","0","0","0","0","2","0","1","1","0","2","1","0","1","0","2","2","0","0","0","0","2"
"Wateringbury","51.25543","0.42317","1","0","0","0","0","0","0","1","0","0","1","0","1","0","0","1","0","1","0","0","1","0","0","1"
"Waterloo","38.03464","-121.18689","1","0","0","0","0","0","0","1","0","0","0","0","0","0","0","1","0","1","0","0","1","0","0","1"
"Waterloo","41.28694","-96.28558","1","0","0","0","0","0","0","1","0","0","0","0","0","0","0","1","0","1","0","0","1","0","0","1"
"Waterloo","42.49276","-92.34296","1","0","0","0","0","0","0","1","0","0","0","0","0","0","0","1","0","1","0","0","1","0","0","1"
"Waterloo","38.33589","-90.14983","1","0","0","0","0","0","0","1","0","0","0","0","0","0","0","1","0","1","0","0","1","0","0","1"
"Waterloo","43.18388","-88.98844","1","0","0","0","0","0","0","1","0","0","0","0","0","0","0","1","0","1","0","0","1","0","0","1"
"Waterloo","39.56255","-86.19749","1","0","0","0","0","0","0","1","0","0","0","0","0","0","0","1","0","1","0","0","1","0","0","1"
"Waterloo","41.43199","-85.01997","1","0","0","0","0","0","0","1","0","0","0","0","0","0","0","1","0","1","0","0","1","0","0","1"
"Waterloo","43.4668","-80.51639","1","0","0","0","0","0","0","1","0","0","0","0","0","0","0","1","0","1","0","0","1","0","0","1"
"Waterloo","42.90479","-76.86274","1","0","0","0","0","0","0","1","0","0","0","0","0","0","0","1","0","1","0","0","1","0","0","1"
"Waterloo","45.35008","-72.51582","1","0","0","0","0","0","0","1","0","0","0","0","0","0","0","1","0","1","0","0","1","0","0","1"
"Waterloo","8.3389","-13.07091","1","0","0","0","0","0","0","1","0","0","0","0","0","0","0","1","0","1","0","0","1","0","0","1"
"Waterloo","53.47454","-3.03017","1","0","0","0","0","0","0","1","0","0","0","0","0","0","0","1","0","1","0","0","1","0","0","1"
"Waterloo","50.71469","4.3991","1","0","0","0","0","0","0","1","0","0","0","0","0","0","0","1","0","1","0","0","1","0","0","1"
"Waterlooville","50.88067","-1.0304","15","1","0","5","5","0","0","26","10","7","7","0","24","6","8","12","0","26","3","6","17","0","0","26"
"Watford","42.95008","-81.88309","28","1","0","5","3","0","4","41","5","11","18","0","34","18","6","17","0","41","5","8","24","3","1","41"
"Watford","51.65531","-0.39602","28","1","0","5","3","0","4","41","5","11","18","0","34","18","6","17","0","41","5","8","24","3","1","41"
"Watkinsville","33.8629","-83.40877","8","0","0","0","1","0","0","9","0","1","0","0","1","6","1","2","0","9","5","1","3","0","0","9"
"Wattala","6.98918","79.89167","1","0","0","0","0","0","0","1","1","0","0","0","1","0","0","1","0","1","0","0","1","0","0","1"
"Wattegama","6.7989","81.4808","1","0","0","0","0","0","0","1","1","0","0","0","1","1","0","0","0","1","0","0","1","0","0","1"
"Waverton","53.16667","-2.8","1","0","0","0","0","0","0","1","0","0","0","0","0","1","0","0","0","1","0","0","1","0","0","1"
"Waverton","-33.83863","151.20046","1","0","0","0","0","0","0","1","0","0","0","0","0","1","0","0","0","1","0","0","1","0","0","1"
"Wayland","41.14724","-91.66072","2","0","0","0","0","0","0","2","0","0","1","0","1","1","0","1","0","2","0","1","1","0","0","2"
"Wayland","40.39449","-91.58321","2","0","0","0","0","0","0","2","0","0","1","0","1","1","0","1","0","2","0","1","1","0","0","2"
"Wayland","42.67392","-85.64474","2","0","0","0","0","0","0","2","0","0","1","0","1","1","0","1","0","2","0","1","1","0","0","2"
"Wayland","42.56784","-77.58971","2","0","0","0","0","0","0","2","0","0","1","0","1","1","0","1","0","2","0","1","1","0","0","2"
"Wayland","42.3626","-71.36145","2","0","0","0","0","0","0","2","0","0","1","0","1","1","0","1","0","2","0","1","1","0","0","2"
"Wayne","34.91813","-97.31447","1","0","0","0","0","0","0","1","0","0","0","0","0","0","0","1","0","1","0","0","1","0","0","1"
"Wayne","42.23056","-97.01782","1","0","0","0","0","0","0","1","0","0","0","0","0","0","0","1","0","1","0","0","1","0","0","1"
"Wayne","41.95086","-88.2423","1","0","0","0","0","0","0","1","0","0","0","0","0","0","0","1","0","1","0","0","1","0","0","1"
"Wayne","41.30144","-83.47354","1","0","0","0","0","0","0","1","0","0","0","0","0","0","0","1","0","1","0","0","1","0","0","1"
"Wayne","42.28143","-83.38632","1","0","0","0","0","0","0","1","0","0","0","0","0","0","0","1","0","1","0","0","1","0","0","1"
"Wayne","38.22147","-82.44237","1","0","0","0","0","0","0","1","0","0","0","0","0","0","0","1","0","1","0","0","1","0","0","1"
"Wayne","40.044","-75.38769","1","0","0","0","0","0","0","1","0","0","0","0","0","0","0","1","0","1","0","0","1","0","0","1"
"Wayne","40.92538","-74.27654","1","0","0","0","0","0","0","1","0","0","0","0","0","0","0","1","0","1","0","0","1","0","0","1"
"Wayne","44.34868","-70.06616","1","0","0","0","0","0","0","1","0","0","0","0","0","0","0","1","0","1","0","0","1","0","0","1"
"Wedmore","51.22727","-2.81152","0","0","0","1","0","0","0","1","1","0","0","0","1","0","0","1","0","1","0","0","1","0","0","1"
"Wednesbury","52.5514","-2.02355","2","2","0","0","1","0","1","6","3","0","1","1","5","2","1","2","1","6","2","3","1","0","0","6"
"Weehawken","40.76955","-74.02042","1","0","0","0","0","0","0","1","0","0","0","0","0","0","0","1","0","1","0","0","1","0","0","1"
"Weifang","36.71","119.10194","1","0","0","0","0","0","0","1","1","0","0","0","1","0","1","0","0","1","0","0","1","0","0","1"
"Weil am Rhein","47.59331","7.62082","1","0","0","0","0","0","0","1","0","0","0","0","0","0","0","1","0","1","1","0","0","0","0","1"
"Weiler-la-Tour","49.54083","6.20083","1","0","0","0","0","0","0","1","0","1","0","0","1","0","0","1","0","1","0","1","0","0","0","1"
"Weingarten","49.25946","8.2862","1","0","0","0","0","0","0","1","0","0","1","0","1","0","1","0","0","1","0","1","0","0","0","1"
"Weingarten","49.05457","8.52678","1","0","0","0","0","0","0","1","0","0","1","0","1","0","1","0","0","1","0","1","0","0","0","1"
"Weingarten","47.81009","9.63863","1","0","0","0","0","0","0","1","0","0","1","0","1","0","1","0","0","1","0","1","0","0","0","1"
"Weisenheim am Berg","49.51306","8.15389","1","0","0","0","0","0","0","1","0","0","1","0","1","1","0","0","0","1","0","1","0","0","0","1"
"Welkom","-27.97742","26.73506","2","0","0","0","0","0","0","2","0","0","0","0","0","2","0","0","0","2","1","0","1","0","0","2"
"Welland","42.98342","-79.24958","4","0","0","0","0","0","0","4","0","2","2","0","4","1","0","3","0","4","1","2","1","0","0","4"
"Welland","52.05756","-2.2994","4","0","0","0","0","0","0","4","0","2","2","0","4","1","0","3","0","4","1","2","1","0","0","4"
"Welland","-34.90366","138.55841","4","0","0","0","0","0","0","4","0","2","2","0","4","1","0","3","0","4","1","2","1","0","0","4"
"Welling","35.87787","-94.90106","5","0","0","0","0","0","1","6","3","1","1","0","5","3","2","1","0","6","1","2","2","1","0","6"
"Welling","51.46246","0.10759","5","0","0","0","0","0","1","6","3","1","1","0","5","3","2","1","0","6","1","2","2","1","0","6"
"Welling","50.33333","7.31667","5","0","0","0","0","0","1","6","3","1","1","0","5","3","2","1","0","6","1","2","2","1","0","6"
"Wellingborough","52.30273","-0.69446","11","0","0","2","0","0","0","13","2","9","1","0","12","1","4","8","0","13","4","3","4","1","1","13"
"Wellington","39.54247","-110.73543","6","0","0","0","0","0","0","6","0","2","1","0","3","3","0","3","0","6","2","0","4","0","0","6"
"Wellington","40.70387","-105.00859","6","0","0","0","0","0","0","6","0","2","1","0","3","3","0","3","0","6","2","0","4","0","0","6"
"Wellington","34.85617","-100.21373","6","0","0","0","0","0","0","6","0","2","1","0","3","3","0","3","0","6","2","0","4","0","0","6"
"Wellington","37.2653","-97.37171","6","0","0","0","0","0","0","6","0","2","1","0","3","3","0","3","0","6","2","0","4","0","0","6"
"Wellington","39.13418","-93.98272","6","0","0","0","0","0","0","6","0","2","1","0","3","3","0","3","0","6","2","0","4","0","0","6"
"Wellington","38.21646","-85.66913","6","0","0","0","0","0","0","6","0","2","1","0","3","3","0","3","0","6","2","0","4","0","0","6"
"Wellington","41.16894","-82.21794","6","0","0","0","0","0","0","6","0","2","1","0","3","3","0","3","0","6","2","0","4","0","0","6"
"Wellington","26.65868","-80.24144","6","0","0","0","0","0","0","6","0","2","1","0","3","3","0","3","0","6","2","0","4","0","0","6"
"Wellington","52.12934","-2.74214","6","0","0","0","0","0","0","6","0","2","1","0","3","3","0","3","0","6","2","0","4","0","0","6"
"Wellington","52.7","-2.51667","6","0","0","0","0","0","0","6","0","2","1","0","3","3","0","3","0","6","2","0","4","0","0","6"
"Wellington","-33.63981","19.0112","6","0","0","0","0","0","0","6","0","2","1","0","3","3","0","3","0","6","2","0","4","0","0","6"
"Wellington","11.36552","76.78442","6","0","0","0","0","0","0","6","0","2","1","0","3","3","0","3","0","6","2","0","4","0","0","6"
"Wellington","-32.55588","148.94508","6","0","0","0","0","0","0","6","0","2","1","0","3","3","0","3","0","6","2","0","4","0","0","6"
"Wellington","-41.28664","174.77557","6","0","0","0","0","0","0","6","0","2","1","0","3","3","0","3","0","6","2","0","4","0","0","6"
"Wells","41.11159","-114.96449","5","0","0","0","0","0","0","5","1","1","1","1","4","3","0","2","0","5","0","1","4","0","0","5"
"Wells","31.48851","-94.93993","5","0","0","0","0","0","0","5","1","1","1","1","4","3","0","2","0","5","0","1","4","0","0","5"
"Wells","43.74607","-93.72884","5","0","0","0","0","0","0","5","1","1","1","1","4","3","0","2","0","5","0","1","4","0","0","5"
"Wells","45.39274","-65.92313","5","0","0","0","0","0","0","5","1","1","1","1","4","3","0","2","0","5","0","1","4","0","0","5"
"Wells","51.20794","-2.64896","5","0","0","0","0","0","0","5","1","1","1","1","4","3","0","2","0","5","0","1","4","0","0","5"
"Welshpool","52.65973","-3.1471","3","0","0","0","1","0","1","5","2","1","1","0","4","3","0","2","0","5","0","0","5","0","0","5"
"Welwyn","51.8331","-0.21359","1","0","0","0","0","0","0","1","0","0","0","0","0","0","0","1","0","1","0","0","0","0","1","1"
"Welwyn Garden City","51.80174","-0.20691","12","1","0","0","2","0","1","16","5","3","3","0","11","6","1","9","0","16","1","2","12","0","1","16"
"Wembley","55.14995","-119.13602","4","0","0","0","0","0","0","4","3","0","0","0","3","1","0","3","0","4","0","1","3","0","0","4"
"Wembley","51.55242","-0.29686","4","0","0","0","0","0","0","4","3","0","0","0","3","1","0","3","0","4","0","1","3","0","0","4"
"Wembley","-31.93308","115.81783","4","0","0","0","0","0","0","4","3","0","0","0","3","1","0","3","0","4","0","1","3","0","0","4"
"Wendover","40.73715","-114.03751","2","0","0","0","0","0","1","3","1","0","1","0","2","1","0","2","0","3","0","1","2","0","0","3"
"Wendover","45.57275","-75.12757","2","0","0","0","0","0","1","3","1","0","1","0","2","1","0","2","0","3","0","1","2","0","0","3"
"Wendover","51.76194","-0.73986","2","0","0","0","0","0","1","3","1","0","1","0","2","1","0","2","0","3","0","1","2","0","0","3"
"West Bridgford","52.92979","-1.12537","3","0","0","0","0","0","0","3","0","1","2","0","3","1","1","1","0","3","0","0","3","0","0","3"
"West Bromwich","52.51868","-1.9945","6","0","0","0","1","0","0","7","0","3","4","0","7","2","2","3","0","7","2","3","2","0","0","7"
"Westbury","40.75566","-73.58763","3","0","0","0","0","0","0","3","0","1","1","1","3","0","1","2","0","3","2","0","1","0","0","3"
"Westbury","52.67856","-2.95433","3","0","0","0","0","0","0","3","0","1","1","1","3","0","1","2","0","3","2","0","1","0","0","3"
"Westbury","51.26","-2.1875","3","0","0","0","0","0","0","3","0","1","1","1","3","0","1","2","0","3","2","0","1","0","0","3"
"Westbury","-41.52914","146.83914","3","0","0","0","0","0","0","3","0","1","1","1","3","0","1","2","0","3","2","0","1","0","0","3"
"West Byfleet","51.33764","-0.50649","0","0","0","0","0","0","1","1","0","0","0","0","0","1","0","0","0","1","0","0","1","0","0","1"
"West Calder","55.85188","-3.56981","1","0","0","0","0","0","0","1","0","1","0","0","1","0","0","1","0","1","1","0","0","0","0","1"
"Westcliff-on-Sea","51.54424","0.69179","4","1","0","0","0","0","1","6","2","0","2","0","4","1","2","3","0","6","1","2","3","0","0","6"
"Westerham","51.26632","0.06892","1","0","0","0","0","0","0","1","0","1","0","0","1","0","0","1","0","1","0","1","0","0","0","1"
"West Haddon","52.34168","-1.07804","1","0","0","0","1","0","0","2","1","1","0","0","2","0","1","1","0","2","0","1","1","0","0","2"
"Westhill","57.47323","-4.14893","1","0","0","0","0","0","0","1","0","1","0","0","1","0","0","1","0","1","0","0","1","0","0","1"
"Westhill","57.15263","-2.27966","1","0","0","0","0","0","0","1","0","1","0","0","1","0","0","1","0","1","0","0","1","0","0","1"
"West Hill","41.23283","-80.51924","1","0","0","0","0","0","0","1","0","1","0","0","1","0","0","1","0","1","0","1","0","0","0","1"
"West Hollywood","34.09001","-118.36174","1","0","0","0","0","0","0","1","0","0","1","0","1","1","0","0","0","1","0","0","1","0","0","1"
"West Hollywood","26.02065","-80.18394","1","0","0","0","0","0","0","1","0","0","1","0","1","1","0","0","0","1","0","0","1","0","0","1"
"West Kilbride","55.69004","-4.85771","1","0","0","0","0","0","0","1","0","1","0","0","1","1","0","0","0","1","0","0","1","0","0","1"
"West Kirby","53.37302","-3.18417","5","0","0","0","1","0","0","6","2","1","1","0","4","4","0","2","0","6","0","2","3","1","0","6"
"West Lafayette","40.42587","-86.90807","1","0","0","0","0","0","0","1","0","0","0","0","0","0","0","1","0","1","0","0","1","0","0","1"
"West Lafayette","40.27535","-81.75096","1","0","0","0","0","0","0","1","0","0","0","0","0","0","0","1","0","1","0","0","1","0","0","1"
"Westland","42.3242","-83.40021","1","0","0","0","0","0","0","1","0","0","1","0","1","0","0","1","0","1","1","0","0","0","0","1"
"West Malling","51.29273","0.40907","7","0","0","0","1","0","0","8","3","2","3","0","8","2","1","5","0","8","0","1","7","0","0","8"
"Westmead","-33.80383","150.98768","1","0","0","0","0","0","0","1","0","1","0","0","1","1","0","0","0","1","1","0","0","0","0","1"
"West Milford","39.20092","-80.40426","0","0","0","1","0","0","0","1","1","0","0","0","1","0","0","1","0","1","1","0","0","0","0","1"
"West Milford","41.13121","-74.36737","0","0","0","1","0","0","0","1","1","0","0","0","1","0","0","1","0","1","1","0","0","0","0","1"
"Westminster","33.75918","-118.00673","1","0","0","0","0","0","0","1","0","0","0","0","0","0","1","0","0","1","0","1","0","0","0","1"
"Westminster","39.83665","-105.0372","1","0","0","0","0","0","0","1","0","0","0","0","0","0","1","0","0","1","0","1","0","0","0","1"
"Westminster","33.36261","-96.46193","1","0","0","0","0","0","0","1","0","0","0","0","0","0","1","0","0","1","0","1","0","0","0","1"
"Westminster","30.4138","-91.0876","1","0","0","0","0","0","0","1","0","0","0","0","0","0","1","0","0","1","0","1","0","0","0","1"
"Westminster","34.66482","-83.09654","1","0","0","0","0","0","0","1","0","0","0","0","0","0","1","0","0","1","0","1","0","0","0","1"
"Westminster","39.57538","-76.99581","1","0","0","0","0","0","0","1","0","0","0","0","0","0","1","0","0","1","0","1","0","0","0","1"
"Westminster","42.54592","-71.91063","1","0","0","0","0","0","0","1","0","0","0","0","0","0","1","0","0","1","0","1","0","0","0","1"
"Westminster","-31.86744","115.83919","1","0","0","0","0","0","0","1","0","0","0","0","0","0","1","0","0","1","0","1","0","0","0","1"
"West Molesey","51.39985","-0.37997","2","0","0","0","0","0","0","2","0","0","1","0","1","0","0","2","0","2","0","0","2","0","0","2"
"West New York","40.78788","-74.01431","1","0","0","0","0","0","1","2","1","1","0","0","2","1","1","0","0","2","0","0","2","0","0","2"
"Weston","45.81374","-118.42469","3","0","0","0","0","0","0","3","0","2","0","0","2","1","1","1","0","3","2","0","1","0","0","3"
"Weston","39.41111","-94.90163","3","0","0","0","0","0","0","3","0","2","0","0","2","1","1","1","0","3","2","0","1","0","0","3"
"Weston","44.8908","-89.54762","3","0","0","0","0","0","0","3","0","2","0","0","2","1","1","1","0","3","2","0","1","0","0","3"
"Weston","41.34477","-83.79716","3","0","0","0","0","0","0","3","0","2","0","0","2","1","1","1","0","3","2","0","1","0","0","3"
"Weston","39.03843","-80.46731","3","0","0","0","0","0","0","3","0","2","0","0","2","1","1","1","0","3","2","0","1","0","0","3"
"Weston","26.10037","-80.39977","3","0","0","0","0","0","0","3","0","2","0","0","2","1","1","1","0","3","2","0","1","0","0","3"
"Weston","40.5351","-74.59071","3","0","0","0","0","0","0","3","0","2","0","0","2","1","1","1","0","3","2","0","1","0","0","3"
"Weston","43.29119","-72.79315","3","0","0","0","0","0","0","3","0","2","0","0","2","1","1","1","0","3","2","0","1","0","0","3"
"Weston","42.36676","-71.30311","3","0","0","0","0","0","0","3","0","2","0","0","2","1","1","1","0","3","2","0","1","0","0","3"
"Weston","53.06667","-2.4","3","0","0","0","0","0","0","3","0","2","0","0","2","1","1","1","0","3","2","0","1","0","0","3"
"Weston","-35.33582","149.05929","3","0","0","0","0","0","0","3","0","2","0","0","2","1","1","1","0","3","2","0","1","0","0","3"
"Weston-super-Mare","51.34603","-2.97665","14","0","0","0","0","0","0","14","4","5","5","0","14","10","2","2","0","14","5","2","7","0","0","14"
"Weston Turville","51.79168","-0.75767","1","0","0","0","0","0","0","1","0","0","1","0","1","0","0","1","0","1","0","0","1","0","0","1"
"West Palm Beach","26.71534","-80.05337","1","0","0","0","0","0","0","1","0","0","1","0","1","0","0","1","0","1","0","0","1","0","0","1"
"West Pennant Hills","-33.7457","151.04764","1","0","0","0","0","0","0","1","0","0","1","0","1","0","0","1","0","1","0","0","1","0","0","1"
"Westport","46.89009","-124.10406","1","1","0","0","0","0","0","2","0","1","1","0","2","1","0","1","0","2","0","2","0","0","0","2"
"Westport","39.17589","-85.57303","1","1","0","0","0","0","0","2","0","1","1","0","2","1","0","1","0","2","0","2","0","0","0","2"
"Westport","35.50125","-80.97869","1","1","0","0","0","0","0","2","0","1","1","0","2","1","0","1","0","2","0","2","0","0","0","2"
"Westport","44.18394","-73.43568","1","1","0","0","0","0","0","2","0","1","1","0","2","1","0","1","0","2","0","2","0","0","0","2"
"Westport","41.14149","-73.3579","1","1","0","0","0","0","0","2","0","1","1","0","2","1","0","1","0","2","0","2","0","0","0","2"
"Westport","43.89925","-69.70838","1","1","0","0","0","0","0","2","0","1","1","0","2","1","0","1","0","2","0","2","0","0","0","2"
"Westport","53.8","-9.51667","1","1","0","0","0","0","0","2","0","1","1","0","2","1","0","1","0","2","0","2","0","0","0","2"
"Westport","-41.75262","171.6037","1","1","0","0","0","0","0","2","0","1","1","0","2","1","0","1","0","2","0","2","0","0","0","2"
"West Wickham","51.36667","-0.01667","2","0","0","0","1","0","1","4","1","0","1","1","3","1","1","2","0","4","2","1","1","0","0","4"
"Wetherby","53.92836","-1.38672","3","0","0","0","0","0","0","3","1","0","2","0","3","2","0","1","0","3","0","1","2","0","0","3"
"Wethersfield","41.71427","-72.65259","1","0","0","0","0","0","0","1","0","0","1","0","1","0","0","1","0","1","0","0","1","0","0","1"
"Wethersfield","51.95358","0.48885","1","0","0","0","0","0","0","1","0","0","1","0","1","0","0","1","0","1","0","0","1","0","0","1"
"Weybridge","51.37178","-0.45975","8","0","0","2","0","1","1","12","3","2","5","0","10","2","3","7","0","12","0","1","11","0","0","12"
"Weymouth","42.22093","-70.93977","5","0","0","0","1","0","1","7","0","5","0","0","5","1","3","3","0","7","3","2","1","0","1","7"
"Weymouth","50.61448","-2.45991","5","0","0","0","1","0","1","7","0","5","0","0","5","1","3","3","0","7","3","2","1","0","1","7"
"Whalley","53.82209","-2.40712","1","0","0","0","0","0","0","1","0","0","1","0","1","0","0","1","0","1","0","0","1","0","0","1"
"Wheathampstead","51.81148","-0.29371","1","0","0","0","0","0","0","1","1","0","0","0","1","0","0","1","0","1","0","0","1","0","0","1"
"Wheatley","51.74731","-1.13936","1","0","0","0","0","0","0","1","0","1","0","0","1","1","0","0","0","1","1","0","0","0","0","1"
"Wheeler","35.44533","-100.27096","1","0","0","0","0","0","0","1","0","0","0","0","0","0","0","1","0","1","0","1","0","0","0","1"
"Whistler","50.11817","-122.95396","2","0","0","0","0","0","0","2","1","1","0","0","2","0","1","1","0","2","1","0","1","0","0","2"
"Whitburn","55.86667","-3.68333","2","0","0","0","1","0","0","3","1","0","2","0","3","2","0","1","0","3","0","1","2","0","0","3"
"Whitburn","54.95333","-1.36861","2","0","0","0","1","0","0","3","1","0","2","0","3","2","0","1","0","3","0","1","2","0","0","3"
"Whitby","54.48774","-0.61498","2","0","0","0","0","0","1","3","0","1","2","0","3","1","0","2","0","3","0","1","1","0","1","3"
"Whitchurch","52.96667","-2.68333","1","2","0","0","1","0","0","4","1","1","2","0","4","0","1","3","0","4","0","0","4","0","0","4"
"Whitchurch","51.85","-2.65","1","2","0","0","1","0","0","4","1","1","2","0","4","0","1","3","0","4","0","0","4","0","0","4"
"Whitchurch","51.40606","-2.56265","1","2","0","0","1","0","0","4","1","1","2","0","4","0","1","3","0","4","0","0","4","0","0","4"
"Whitchurch","51.8816","-0.83784","1","2","0","0","1","0","0","4","1","1","2","0","4","0","1","3","0","4","0","0","4","0","0","4"
"Whitefield","44.37312","-71.61008","1","0","0","0","0","0","0","1","0","1","0","0","1","1","0","0","0","1","0","1","0","0","0","1"
"Whitefield","44.17007","-69.62532","1","0","0","0","0","0","0","1","0","1","0","0","1","1","0","0","0","1","0","1","0","0","0","1"
"Whitefield","53.55","-2.3","1","0","0","0","0","0","0","1","0","1","0","0","1","1","0","0","0","1","0","1","0","0","0","1"
"White Hall","34.27399","-92.09098","1","0","0","0","0","0","0","1","0","0","0","0","0","1","0","0","0","1","0","0","1","0","0","1"
"White Hall","39.43699","-90.40318","1","0","0","0","0","0","0","1","0","0","0","0","0","1","0","0","0","1","0","0","1","0","0","1"
"White Hall","32.32708","-86.71192","1","0","0","0","0","0","0","1","0","0","0","0","0","1","0","0","0","1","0","0","1","0","0","1"
"White Hall","39.4212","-80.18258","1","0","0","0","0","0","0","1","0","0","0","0","0","1","0","0","0","1","0","0","1","0","0","1"
"Whitehaven","54.54897","-3.58412","3","0","0","1","0","0","0","4","1","0","2","0","3","1","1","2","0","4","1","0","3","0","0","4"
"Whitland","51.81889","-4.61528","4","0","0","0","1","0","0","5","3","0","0","0","3","5","0","0","0","5","2","0","3","0","0","5"
"Whitley Bay","55.03973","-1.44713","14","1","0","0","1","0","1","17","4","2","3","0","9","7","3","7","0","17","4","3","10","0","0","17"
"Whitstable","51.3607","1.0257","9","0","0","0","0","0","1","10","2","2","4","0","8","3","1","6","0","10","1","2","7","0","0","10"
"Whittier","33.97918","-118.03284","1","0","0","0","0","0","0","1","0","0","0","0","0","1","0","0","0","1","1","0","0","0","0","1"
"Whittlesford","52.11345","0.14969","1","0","0","0","0","0","0","1","0","1","0","0","1","1","0","0","0","1","1","0","0","0","0","1"
"Whitton","52.3","-3.06667","1","0","0","0","0","0","0","1","1","0","1","0","2","0","0","2","0","2","0","0","2","0","0","2"
"Whitton","53.7","-0.63333","1","0","0","0","0","0","0","1","1","0","1","0","2","0","0","2","0","2","0","0","2","0","0","2"
"Whyteleafe","51.30808","-0.08429","0","0","0","0","1","0","0","1","0","0","1","0","1","0","0","1","0","1","0","0","1","0","0","1"
"Wick","51.43944","-3.54944","2","0","0","0","0","0","0","2","1","1","0","0","2","0","0","2","0","2","2","0","0","0","0","2"
"Wick","58.43906","-3.09424","2","0","0","0","0","0","0","2","1","1","0","0","2","0","0","2","0","2","2","0","0","0","0","2"
"Wick","51.45306","-2.42361","2","0","0","0","0","0","0","2","1","1","0","0","2","0","0","2","0","2","2","0","0","0","0","2"
"Wickford","51.61101","0.52331","6","0","0","0","0","0","1","7","0","1","4","0","5","0","1","6","0","7","2","4","1","0","0","7"
"Wickham Bishops","51.7783","0.66823","0","0","0","0","0","0","1","1","0","0","1","0","1","0","0","1","0","1","0","0","1","0","0","1"
"Wicklow","52.975","-6.04944","3","0","0","0","0","0","0","3","1","1","0","0","2","0","1","2","0","3","0","2","1","0","0","3"
"Widnes","53.3618","-2.73406","12","0","0","0","1","0","2","15","4","2","4","0","10","3","5","7","0","15","5","4","6","0","0","15"
"Wiesbaden","50.08258","8.24932","1","0","0","0","0","0","0","1","0","0","0","0","0","1","0","0","0","1","1","0","0","0","0","1"
"Wigan","53.54296","-2.63706","26","1","0","1","3","0","2","33","10","6","11","0","27","12","5","16","0","33","6","10","17","0","0","33"
"Wigston Magna","52.58128","-1.09248","1","0","0","0","0","0","0","1","1","0","0","0","1","0","0","1","0","1","0","1","0","0","0","1"
"Wilberfoss","53.94854","-0.88945","1","0","0","0","0","0","0","1","0","0","0","0","0","1","0","0","0","1","0","0","1","0","0","1"
"Willemstad","12.1084","-68.93354","3","0","0","0","0","0","0","3","1","1","0","0","2","2","0","1","0","3","0","0","2","0","1","3"
"Willemstad","51.69167","4.43889","3","0","0","0","0","0","0","3","1","1","0","0","2","2","0","1","0","3","0","0","2","0","1","3"
"Willenhall","52.58514","-2.05934","4","0","0","0","0","0","0","4","1","2","1","0","4","3","0","1","0","4","0","2","1","1","0","4"
"Wilmslow","53.32803","-2.23148","12","0","0","0","1","0","1","14","2","6","4","0","12","4","1","9","0","14","2","3","9","0","0","14"
"Wimborne Minster","50.78333","-1.98333","8","0","0","0","0","0","1","9","2","2","4","0","8","5","1","3","0","9","1","3","5","0","0","9"
"Wincanton","51.05676","-2.40574","2","0","0","0","0","0","0","2","1","1","0","0","2","2","0","0","0","2","0","1","1","0","0","2"
"Winchburgh","55.95795","-3.46464","0","0","0","0","1","0","0","1","0","0","1","0","1","1","0","0","0","1","0","0","1","0","0","1"
"Winchester","33.70697","-117.08447","19","1","0","0","5","0","2","27","6","6","9","0","21","9","3","15","0","27","5","5","16","0","0","26"
"Winchester","36.12997","-115.11889","19","1","0","0","5","0","2","27","6","6","9","0","21","9","3","15","0","27","5","5","16","0","0","26"
"Winchester","35.78621","-95.99222","19","1","0","0","5","0","2","27","6","6","9","0","21","9","3","15","0","27","5","5","16","0","0","26"
"Winchester","39.32222","-95.26692","19","1","0","0","5","0","2","27","6","6","9","0","21","9","3","15","0","27","5","5","16","0","0","26"
"Winchester","38.59033","-90.5279","19","1","0","0","5","0","2","27","6","6","9","0","21","9","3","15","0","27","5","5","16","0","0","26"
"Winchester","39.62977","-90.45624","19","1","0","0","5","0","2","27","6","6","9","0","21","9","3","15","0","27","5","5","16","0","0","26"
"Winchester","44.19859","-88.66483","19","1","0","0","5","0","2","27","6","6","9","0","21","9","3","15","0","27","5","5","16","0","0","26"
"Winchester","35.18592","-86.11221","19","1","0","0","5","0","2","27","6","6","9","0","21","9","3","15","0","27","5","5","16","0","0","26"
"Winchester","40.17199","-84.98135","19","1","0","0","5","0","2","27","6","6","9","0","21","9","3","15","0","27","5","5","16","0","0","26"
"Winchester","37.99008","-84.17965","19","1","0","0","5","0","2","27","6","6","9","0","21","9","3","15","0","27","5","5","16","0","0","26"
"Winchester","38.94174","-83.65075","19","1","0","0","5","0","2","27","6","6","9","0","21","9","3","15","0","27","5","5","16","0","0","26"
"Winchester","39.18566","-78.16333","19","1","0","0","5","0","2","27","6","6","9","0","21","9","3","15","0","27","5","5","16","0","0","26"
"Winchester","45.0834","-75.34933","19","1","0","0","5","0","2","27","6","6","9","0","21","9","3","15","0","27","5","5","16","0","0","26"
"Winchester","42.77342","-72.38314","19","1","0","0","5","0","2","27","6","6","9","0","21","9","3","15","0","27","5","5","16","0","0","26"
"Winchester","42.45232","-71.137","19","1","0","0","5","0","2","27","6","6","9","0","21","9","3","15","0","27","5","5","16","0","0","26"
"Winchester","51.06513","-1.3187","19","1","0","0","5","0","2","27","6","6","9","0","21","9","3","15","0","27","5","5","16","0","0","26"
"Windham","41.23506","-81.04926","1","0","0","0","0","0","0","1","0","1","0","0","1","1","0","0","0","1","0","0","1","0","0","1"
"Windham","41.69982","-72.15702","1","0","0","0","0","0","0","1","0","1","0","0","1","1","0","0","0","1","0","0","1","0","0","1"
"Windham","42.80064","-71.30423","1","0","0","0","0","0","0","1","0","1","0","0","1","1","0","0","0","1","0","0","1","0","0","1"
"Windhoek","-22.55941","17.08323","10","2","0","1","0","0","0","13","1","4","4","0","9","7","2","4","0","13","5","0","7","1","0","13"
"Windsor","38.54713","-122.81638","18","0","0","2","1","0","1","22","4","5","8","0","17","8","3","12","0","23","2","8","12","0","1","23"
"Windsor","40.47748","-104.90136","18","0","0","2","1","0","1","22","4","5","8","0","17","8","3","12","0","23","2","8","12","0","1","23"
"Windsor","38.53224","-93.52215","18","0","0","2","1","0","1","22","4","5","8","0","17","8","3","12","0","23","2","8","12","0","1","23"
"Windsor","43.21833","-89.34151","18","0","0","2","1","0","1","22","4","5","8","0","17","8","3","12","0","23","2","8","12","0","1","23"
"Windsor","39.44087","-88.59478","18","0","0","2","1","0","1","22","4","5","8","0","17","8","3","12","0","23","2","8","12","0","1","23"
"Windsor","42.30008","-83.01654","18","0","0","2","1","0","1","22","4","5","8","0","17","8","3","12","0","23","2","8","12","0","1","23"
"Windsor","35.55294","-77.36108","18","0","0","2","1","0","1","22","4","5","8","0","17","8","3","12","0","23","2","8","12","0","1","23"
"Windsor","35.99849","-76.94606","18","0","0","2","1","0","1","22","4","5","8","0","17","8","3","12","0","23","2","8","12","0","1","23"
"Windsor","36.80848","-76.74412","18","0","0","2","1","0","1","22","4","5","8","0","17","8","3","12","0","23","2","8","12","0","1","23"
"Windsor","39.91621","-76.58441","18","0","0","2","1","0","1","22","4","5","8","0","17","8","3","12","0","23","2","8","12","0","1","23"
"Windsor","42.07591","-75.64046","18","0","0","2","1","0","1","22","4","5","8","0","17","8","3","12","0","23","2","8","12","0","1","23"
"Windsor","42.51175","-73.05788","18","0","0","2","1","0","1","22","4","5","8","0","17","8","3","12","0","23","2","8","12","0","1","23"
"Windsor","41.8526","-72.6437","18","0","0","2","1","0","1","22","4","5","8","0","17","8","3","12","0","23","2","8","12","0","1","23"
"Windsor","43.48035","-72.38481","18","0","0","2","1","0","1","22","4","5","8","0","17","8","3","12","0","23","2","8","12","0","1","23"
"Windsor","45.56678","-71.99909","18","0","0","2","1","0","1","22","4","5","8","0","17","8","3","12","0","23","2","8","12","0","1","23"
"Windsor","44.31063","-69.5806","18","0","0","2","1","0","1","22","4","5","8","0","17","8","3","12","0","23","2","8","12","0","1","23"
"Windsor","44.98345","-64.13204","18","0","0","2","1","0","1","22","4","5","8","0","17","8","3","12","0","23","2","8","12","0","1","23"
"Windsor","51.48333","-0.6","18","0","0","2","1","0","1","22","4","5","8","0","17","8","3","12","0","23","2","8","12","0","1","23"
"Windsor","-37.85344","144.99241","18","0","0","2","1","0","1","22","4","5","8","0","17","8","3","12","0","23","2","8","12","0","1","23"
"Windsor","-33.61309","150.81416","18","0","0","2","1","0","1","22","4","5","8","0","17","8","3","12","0","23","2","8","12","0","1","23"
"Windsor","-27.43631","153.02882","18","0","0","2","1","0","1","22","4","5","8","0","17","8","3","12","0","23","2","8","12","0","1","23"
"Winford","51.38333","-2.66111","1","0","0","0","0","0","0","1","0","0","0","0","0","0","0","1","0","1","1","0","0","0","0","1"
"Wing","51.89524","-0.71956","1","0","0","0","0","0","0","1","0","1","0","0","1","0","0","1","0","1","0","1","0","0","0","1"
"Wing","52.61775","-0.6827","1","0","0","0","0","0","0","1","0","1","0","0","1","0","0","1","0","1","0","1","0","0","0","1"
"Winkleigh","50.85581","-3.943","2","0","0","0","0","0","0","2","0","1","0","0","1","1","0","1","0","2","0","0","2","0","0","2"
"Winnersh","51.42747","-0.87994","1","0","0","0","0","0","0","1","0","0","1","0","1","0","0","1","0","1","0","0","1","0","0","1"
"Winnipeg","49.8844","-97.14704","3","0","0","0","1","0","0","4","1","2","0","0","3","1","0","3","0","4","1","3","0","0","0","4"
"Winscombe","51.3181","-2.83224","1","0","0","0","0","0","0","1","0","0","1","0","1","0","0","1","0","1","0","1","0","0","0","1"
"Winsford","53.19146","-2.52398","1","0","0","0","0","0","1","2","1","0","1","0","2","0","0","2","0","2","0","1","1","0","0","2"
"Winslow","35.02419","-110.69736","2","0","0","0","0","0","0","2","0","1","1","0","2","0","0","2","0","2","1","0","1","0","0","2"
"Winslow","38.38227","-87.21279","2","0","0","0","0","0","0","2","0","1","1","0","2","0","0","2","0","2","1","0","1","0","0","2"
"Winslow","44.54701","-69.62116","2","0","0","0","0","0","0","2","0","1","1","0","2","0","0","2","0","2","1","0","1","0","0","2"
"Winslow","51.94284","-0.88131","2","0","0","0","0","0","0","2","0","1","1","0","2","0","0","2","0","2","1","0","1","0","0","2"
"Winster","53.1418","-1.64258","1","0","0","0","0","0","0","1","0","1","0","0","1","0","1","0","0","1","0","1","0","0","0","1"
"Winter Garden","28.56528","-81.58618","1","0","0","0","0","0","0","1","0","0","0","0","0","0","0","1","0","1","0","0","1","0","0","1"
"Winthrop","44.54302","-94.36637","1","0","0","0","0","0","0","1","0","0","0","0","0","1","0","0","0","1","0","0","1","0","0","1"
"Winthrop","42.47332","-91.73433","1","0","0","0","0","0","0","1","0","0","0","0","0","1","0","0","0","1","0","0","1","0","0","1"
"Winthrop","44.79478","-74.78686","1","0","0","0","0","0","0","1","0","0","0","0","0","1","0","0","0","1","0","0","1","0","0","1"
"Winthrop","42.3751","-70.98283","1","0","0","0","0","0","0","1","0","0","0","0","0","1","0","0","0","1","0","0","1","0","0","1"
"Winthrop","44.30507","-69.977","1","0","0","0","0","0","0","1","0","0","0","0","0","1","0","0","0","1","0","0","1","0","0","1"
"Winthrop","-32.05216","115.82972","1","0","0","0","0","0","0","1","0","0","0","0","0","1","0","0","0","1","0","0","1","0","0","1"
"Wisbech","52.66622","0.15938","5","0","0","0","0","0","0","5","0","3","2","0","5","1","1","3","0","5","1","2","2","0","0","5"
"Wisconsin Dells","43.62748","-89.77096","1","0","0","0","0","0","0","1","0","1","0","0","1","1","0","0","0","1","1","0","0","0","0","1"
"Wishaw","55.76667","-3.91667","5","2","0","0","0","0","0","7","3","4","0","0","7","2","1","4","0","7","2","3","1","0","1","7"
"Witbank","-25.87133","29.23323","1","0","0","0","0","0","0","1","1","0","0","0","1","0","1","0","0","1","0","0","1","0","0","1"
"Witham","51.80007","0.64038","5","0","0","0","0","0","0","5","0","2","3","0","5","2","1","2","0","5","1","2","1","0","1","5"
"Withernsea","53.73115","0.03195","1","0","0","0","0","0","0","1","0","1","0","0","1","0","0","1","0","1","0","0","0","0","1","1"
"Witney","51.7836","-1.4854","7","0","0","0","0","0","2","9","2","3","0","1","6","3","1","5","0","9","4","1","4","0","0","9"
"Wiveliscombe","51.04139","-3.31278","1","0","0","0","0","0","0","1","0","0","1","0","1","1","0","0","0","1","0","0","1","0","0","1"
"Woburn Sands","52.01579","-0.64982","1","0","0","0","0","0","0","1","0","0","0","0","0","0","0","1","0","1","0","0","1","0","0","1"
"Woking","51.31903","-0.55893","32","4","0","2","3","0","4","45","12","8","17","1","38","12","6","27","0","45","2","11","32","0","0","45"
"Wokingham","51.4112","-0.83565","25","2","0","3","1","0","1","32","6","10","11","1","28","8","5","19","0","32","6","11","15","0","0","32"
"Wolverhampton","52.58547","-2.12296","35","2","0","3","1","0","3","44","10","15","10","1","36","16","8","19","1","44","11","8","22","2","1","44"
"Wombourn","52.53333","-2.18333","1","0","0","0","0","0","0","1","1","0","0","0","1","0","0","1","0","1","0","1","0","0","0","1"
"Wommelgem","51.20452","4.5225","1","0","0","0","0","0","0","1","1","0","0","0","1","1","0","0","0","1","0","0","1","0","0","1"
"Woodbridge","38.15408","-121.30134","3","0","0","0","1","0","0","4","2","1","0","0","3","2","1","1","0","4","0","0","4","0","0","4"
"Woodbridge","38.65817","-77.2497","3","0","0","0","1","0","0","4","2","1","0","0","3","2","1","1","0","4","0","0","4","0","0","4"
"Woodbridge","40.5576","-74.28459","3","0","0","0","1","0","0","4","2","1","0","0","3","2","1","1","0","4","0","0","4","0","0","4"
"Woodbridge","41.3526","-73.00844","3","0","0","0","1","0","0","4","2","1","0","0","3","2","1","1","0","4","0","0","4","0","0","4"
"Woodbridge","52.09332","1.32042","3","0","0","0","1","0","0","4","2","1","0","0","3","2","1","1","0","4","0","0","4","0","0","4"
"Woodbridge","-31.88695","115.99196","3","0","0","0","1","0","0","4","2","1","0","0","3","2","1","1","0","4","0","0","4","0","0","4"
"Wood Dale","41.96336","-87.97896","1","0","0","0","0","0","0","1","0","0","0","0","0","0","1","0","0","1","0","0","1","0","0","1"
"Woodford","51.11667","-1.83333","1","0","0","0","0","0","0","1","0","1","0","0","1","0","0","1","0","1","0","0","1","0","0","1"
"Woodford","52.38231","-0.58099","1","0","0","0","0","0","0","1","0","1","0","0","1","0","0","1","0","1","0","0","1","0","0","1"
"Woodford","-33.73333","150.48333","1","0","0","0","0","0","0","1","0","1","0","0","1","0","0","1","0","1","0","0","1","0","0","1"
"Woodford","-26.95291","152.77747","1","0","0","0","0","0","0","1","0","1","0","0","1","0","0","1","0","1","0","0","1","0","0","1"
"Woodford Green","51.60938","0.02329","3","1","0","0","0","0","0","4","0","1","1","0","2","1","1","2","0","4","2","0","2","0","0","4"
"Woodhall Spa","53.15215","-0.21453","2","0","0","0","0","0","0","2","1","1","0","0","2","1","1","0","0","2","0","1","1","0","0","2"
"Woodley","51.45","-0.88333","1","0","0","0","0","0","0","1","0","0","1","0","1","0","0","1","0","1","0","1","0","0","0","1"
"Woodstock","42.31474","-88.4487","2","0","0","0","0","0","0","2","0","0","0","0","0","0","2","0","0","2","0","0","2","0","0","2"
"Woodstock","33.20678","-87.15","2","0","0","0","0","0","0","2","0","0","0","0","0","0","2","0","0","2","0","0","2","0","0","2"
"Woodstock","34.10149","-84.51938","2","0","0","0","0","0","0","2","0","0","0","0","0","0","2","0","0","2","0","0","2","0","0","2"
"Woodstock","43.13339","-80.7497","2","0","0","0","0","0","0","2","0","0","0","0","0","0","2","0","0","2","0","0","2","0","0","2"
"Woodstock","38.88178","-78.50584","2","0","0","0","0","0","0","2","0","0","0","0","0","0","2","0","0","2","0","0","2","0","0","2"
"Woodstock","42.04092","-74.1182","2","0","0","0","0","0","0","2","0","0","0","0","0","0","2","0","0","2","0","0","2","0","0","2"
"Woodstock","43.62424","-72.51843","2","0","0","0","0","0","0","2","0","0","0","0","0","0","2","0","0","2","0","0","2","0","0","2"
"Woodstock","43.97757","-71.68508","2","0","0","0","0","0","0","2","0","0","0","0","0","0","2","0","0","2","0","0","2","0","0","2"
"Woodstock","44.37494","-70.60849","2","0","0","0","0","0","0","2","0","0","0","0","0","0","2","0","0","2","0","0","2","0","0","2"
"Woodstock","51.8485","-1.35132","2","0","0","0","0","0","0","2","0","0","0","0","0","0","2","0","0","2","0","0","2","0","0","2"
"Woodstock","-33.74457","148.84892","2","0","0","0","0","0","0","2","0","0","0","0","0","0","2","0","0","2","0","0","2","0","0","2"
"Woodvale","-31.78928","115.79676","1","0","0","0","0","0","0","1","0","1","0","0","1","1","0","0","0","1","1","0","0","0","0","1"
"Woolacombe","51.17296","-4.20689","1","0","0","0","0","0","0","1","0","1","0","0","1","0","0","1","0","1","1","0","0","0","0","1"
"Wooler","55.54755","-2.01186","1","0","0","0","0","0","0","1","0","1","0","0","1","1","0","0","0","1","1","0","0","0","0","1"
"Woolwich","43.91869","-69.80116","3","0","0","0","0","0","1","4","0","0","2","0","2","0","1","3","0","4","0","1","3","0","0","4"
"Woolwich","51.491","0.0648","3","0","0","0","0","0","1","4","0","0","2","0","2","0","1","3","0","4","0","1","3","0","0","4"
"Woolwich","-33.84019","151.16939","3","0","0","0","0","0","1","4","0","0","2","0","2","0","1","3","0","4","0","1","3","0","0","4"
"Woore","52.97701","-2.40235","0","0","0","1","0","0","0","1","1","0","0","0","1","0","0","1","0","1","0","0","1","0","0","1"
"Worcester","42.59146","-74.75043","47","1","0","1","6","0","4","59","11","21","20","1","53","22","4","33","0","59","12","19","27","0","1","59"
"Worcester","42.26259","-71.80229","47","1","0","1","6","0","4","59","11","21","20","1","53","22","4","33","0","59","12","19","27","0","1","59"
"Worcester","52.18935","-2.22001","47","1","0","1","6","0","4","59","11","21","20","1","53","22","4","33","0","59","12","19","27","0","1","59"
"Worcester","-33.64651","19.44852","47","1","0","1","6","0","4","59","11","21","20","1","53","22","4","33","0","59","12","19","27","0","1","59"
"Worcester Park","51.37992","-0.24445","2","1","0","0","1","0","1","5","2","2","1","0","5","2","0","3","0","5","2","0","3","0","0","5"
"Workington","54.6425","-3.54413","5","0","0","1","0","0","0","6","0","2","4","0","6","1","3","2","0","6","2","1","3","0","0","6"
"Worksop","53.30182","-1.12404","12","1","0","0","1","0","1","15","1","7","7","0","15","4","3","8","0","15","4","4","7","0","0","15"
"Worlaby","53.6113","-0.46685","1","0","0","0","0","0","0","1","0","1","0","0","1","0","0","0","0","0","0","0","0","0","0","0"
"Wormley","51.13622","-0.64673","0","1","0","0","0","0","0","1","1","0","0","0","1","1","0","0","0","1","1","0","0","0","0","1"
"Worthing","43.32915","-96.76283","16","1","0","1","6","0","3","27","5","6","9","1","21","10","4","13","0","27","7","4","15","0","1","27"
"Worthing","50.81795","-0.37538","16","1","0","1","6","0","3","27","5","6","9","1","21","10","4","13","0","27","7","4","15","0","1","27"
"Wote","-1.78079","37.62882","1","0","0","0","0","0","0","1","0","0","0","0","0","0","1","0","0","1","0","0","0","0","1","1"
"Wotton-under-Edge","51.63242","-2.34512","2","0","0","0","1","0","0","3","1","0","0","0","1","0","2","1","0","3","3","0","0","0","0","3"
"Wrea Green","53.77651","-2.91573","1","0","0","0","0","0","0","1","1","0","0","0","1","0","0","1","0","1","0","0","1","0","0","1"
"Wrexham","53.04664","-2.99132","29","0","0","1","5","0","1","36","5","10","17","1","33","11","6","19","0","36","10","10","15","0","1","36"
"Wrington","51.36173","-2.76319","1","0","0","0","0","0","0","1","0","0","1","0","1","0","0","1","0","1","0","0","1","0","0","1"
"Writtle","51.72906","0.42938","1","0","0","0","0","0","0","1","0","1","0","0","1","0","0","1","0","1","1","0","0","0","0","1"
"Wrocław","51.1","17.03333","1","0","0","0","0","0","0","1","1","0","0","0","1","1","0","0","0","1","0","0","1","0","0","1"
"Wuhan","30.58333","114.26667","2","0","0","0","0","0","0","2","1","0","0","1","2","1","0","0","1","2","0","0","2","0","0","2"
"Wustrow","52.9237","11.12846","1","0","0","0","0","0","0","1","0","0","0","1","1","0","0","0","1","1","0","0","0","0","1","1"
"Wustrow","53.47765","13.15569","1","0","0","0","0","0","0","1","0","0","0","1","1","0","0","0","1","1","0","0","0","0","1","1"
"Wuxi","26.5844","111.859","1","0","0","0","0","0","0","1","1","0","0","0","1","1","0","0","0","1","0","0","1","0","0","1"
"Wuxi","31.30897","118.65629","1","0","0","0","0","0","0","1","1","0","0","0","1","1","0","0","0","1","0","0","1","0","0","1"
"Wuxi","31.56887","120.28857","1","0","0","0","0","0","0","1","1","0","0","0","1","1","0","0","0","1","0","0","1","0","0","1"
"Wylam","54.97654","-1.82187","3","0","0","0","0","0","0","3","1","1","0","0","2","0","0","2","1","3","1","0","2","0","0","3"
"Xánthi","41.13488","24.888","1","0","0","0","0","0","0","1","1","0","0","0","1","0","0","1","0","1","0","0","1","0","0","1"
"Xiamen","24.47979","118.08187","1","0","0","0","0","0","0","1","1","0","0","0","1","1","0","0","0","1","0","0","1","0","0","1"
"Yala","0.09438","34.53602","0","0","0","0","2","0","0","2","0","2","0","0","2","2","0","0","0","2","2","0","0","0","0","2"
"Yala","6.53995","101.28128","0","0","0","0","2","0","0","2","0","2","0","0","2","2","0","0","0","2","2","0","0","0","0","2"
"Yalding","51.22387","0.4292","1","0","0","0","0","0","0","1","0","0","1","0","1","0","0","1","0","1","0","0","1","0","0","1"
"Yalova","40.65501","29.27693","1","0","0","0","0","0","0","1","0","0","0","0","0","1","0","0","0","1","0","0","0","1","0","1"
"Yamunānagar","30.12796","77.28371","4","0","0","0","0","0","0","4","4","0","0","0","4","1","0","3","0","4","0","1","3","0","0","4"
"Yanbu","24.08954","38.0618","4","0","0","0","0","0","0","4","0","3","0","1","4","0","1","2","1","4","2","0","2","0","0","4"
"Yangon","16.80528","96.15611","35","0","0","0","0","0","0","35","3","10","2","8","23","18","9","3","4","34","16","1","8","7","3","35"
"Yantzaza","-3.83261","-78.76076","2","0","0","0","0","0","0","2","0","0","0","1","1","1","0","1","0","2","1","1","0","0","0","2"
"Yaoundé","3.86667","11.51667","10","1","0","1","0","0","0","12","3","6","2","1","12","5","7","0","0","12","5","0","6","0","1","12"
"Yarm","54.50364","-1.35793","2","0","0","0","0","0","0","2","0","0","1","0","1","1","0","1","0","2","0","1","1","0","0","2"
"Yate","51.54074","-2.41839","3","0","0","0","0","0","0","3","0","2","0","0","2","0","0","3","0","3","1","0","2","0","0","3"
"Yaté-Barrage","-22.15","166.88333","1","0","0","0","0","0","0","1","0","1","0","0","1","0","1","0","0","1","1","0","0","0","0","1"
"Yateley","51.34305","-0.82985","3","0","0","0","0","0","0","3","0","1","2","0","3","1","0","2","0","3","0","1","1","1","0","3"
"Yatton","51.38839","-2.82353","1","0","0","0","0","0","0","1","0","1","0","0","1","0","0","1","0","1","0","0","1","0","0","1"
"Yatton","51.96667","-2.53333","1","0","0","0","0","0","0","1","0","1","0","0","1","0","0","1","0","1","0","0","1","0","0","1"
"Yellowknife","62.45411","-114.37248","1","0","0","0","0","0","0","1","0","0","1","0","1","0","0","1","0","1","0","0","1","0","0","1"
"Yelverton","50.4929","-4.08382","2","0","0","0","0","0","0","2","0","0","0","0","0","2","0","0","0","2","0","2","0","0","0","2"
"Yenagoa","4.92675","6.26764","1","0","0","0","0","0","0","1","0","0","0","0","0","1","0","0","0","1","0","1","0","0","0","1"
"Yendi","9.44272","-0.00991","1","0","0","0","0","0","0","1","1","0","0","0","1","1","0","0","0","1","0","0","1","0","0","1"
"Yeovil","50.94159","-2.63211","9","0","0","0","0","0","0","9","0","6","2","0","8","3","0","6","0","9","3","4","2","0","0","9"
"Yerevan","40.18111","44.51361","17","1","0","0","0","0","0","18","5","6","2","0","13","8","5","4","1","18","6","0","9","1","2","18"
"Y Felinheli","53.18737","-4.20476","1","0","0","0","0","0","0","1","0","0","0","0","0","0","0","1","0","1","0","1","0","0","0","1"
"Ynysybwl","51.63922","-3.36036","0","1","0","0","0","0","0","1","1","0","0","0","1","0","1","0","0","1","0","0","1","0","0","1"
"Yogyakarta","-7.80139","110.36472","0","0","0","0","0","0","1","1","0","1","0","0","1","0","1","0","0","1","0","0","1","0","0","1"
"Yola","9.20839","12.48146","2","0","0","0","0","0","0","2","0","1","0","1","2","2","0","0","0","2","1","0","0","0","1","2"
"York","32.89368","-109.20284","58","4","0","7","8","0","3","80","25","17","20","0","62","19","14","46","1","80","10","21","47","1","1","80"
"York","40.86807","-97.592","58","4","0","7","8","0","3","80","25","17","20","0","62","19","14","46","1","80","10","21","47","1","1","80"
"York","32.48625","-88.29642","58","4","0","7","8","0","3","80","25","17","20","0","62","19","14","46","1","80","10","21","47","1","1","80"
"York","34.9943","-81.24202","58","4","0","7","8","0","3","80","25","17","20","0","62","19","14","46","1","80","10","21","47","1","1","80"
"York","39.9626","-76.72774","58","4","0","7","8","0","3","80","25","17","20","0","62","19","14","46","1","80","10","21","47","1","1","80"
"York","53.95763","-1.08271","58","4","0","7","8","0","3","80","25","17","20","0","62","19","14","46","1","80","10","21","47","1","1","80"
"York","-31.88809","116.7678","58","4","0","7","8","0","3","80","25","17","20","0","62","19","14","46","1","80","10","21","47","1","1","80"
"Yoshkar-Ola","56.63877","47.89078","2","0","0","0","0","0","0","2","1","0","0","0","1","2","0","0","0","2","0","0","2","0","0","2"
"Ystradgynlais","51.76667","-3.76667","0","0","0","1","0","0","0","1","1","0","0","0","1","1","0","0","0","1","0","0","1","0","0","1"
"Yucatán","19.34472","-96.36167","1","0","0","0","0","0","0","1","0","1","0","0","1","0","1","0","0","1","1","0","0","0","0","1"
"Yukon","35.50672","-97.76254","1","0","0","0","0","0","0","1","0","0","0","1","1","1","0","0","0","1","0","0","1","0","0","1"
"Yukon","40.21257","-79.68282","1","0","0","0","0","0","0","1","0","0","0","1","1","1","0","0","0","1","0","0","1","0","0","1"
"Yuma","32.72532","-114.6244","0","0","0","0","0","0","1","1","0","0","0","0","0","1","0","0","0","1","0","0","1","0","0","1"
"Yuma","40.12221","-102.72521","0","0","0","0","0","0","1","1","0","0","0","0","0","1","0","0","0","1","0","0","1","0","0","1"
"Zadar","44.11578","15.22514","2","0","0","0","0","0","0","2","1","0","0","0","1","2","0","0","0","2","1","0","1","0","0","2"
"Zafarwal","32.34464","74.8999","0","0","0","1","0","0","0","1","0","1","0","0","1","0","1","0","0","1","1","0","0","0","0","1"
"Zagazig","30.58768","31.502","14","1","0","0","2","0","2","19","10","4","2","1","17","5","7","7","0","19","1","1","12","3","3","20"
"Zagreb","45.81444","15.97798","21","2","0","0","0","0","0","23","5","4","7","1","17","7","4","12","0","23","11","3","11","0","0","25"
"Zahirābād","17.68138","77.60743","1","0","0","0","0","0","0","1","1","0","0","0","1","1","0","0","0","1","0","0","1","0","0","1"
"Zahlé","33.84675","35.90203","0","0","0","0","1","0","0","1","0","0","0","0","0","0","0","1","0","1","0","1","0","0","0","1"
"Zaječar","43.90358","22.26405","1","0","0","0","0","0","0","1","1","0","0","0","1","0","0","1","0","1","0","1","0","0","0","1"
"Zamboanga","6.91028","122.07389","3","0","0","0","0","0","0","3","0","2","0","0","2","1","2","0","0","3","3","0","0","0","0","3"
"Zambrów","52.9855","22.24319","1","0","0","0","0","0","0","1","0","1","0","0","1","1","0","0","0","1","1","0","0","0","0","1"
"Zamora","19.9855","-102.28387","2","0","0","0","0","0","0","2","2","0","0","0","2","0","0","2","0","2","0","0","2","0","0","2"
"Zamora","18.58101","-95.48361","2","0","0","0","0","0","0","2","2","0","0","0","2","0","0","2","0","2","0","0","2","0","0","2"
"Zamora","15.63333","-86.06667","2","0","0","0","0","0","0","2","2","0","0","0","2","0","0","2","0","2","0","0","2","0","0","2"
"Zamora","-4.06685","-78.95488","2","0","0","0","0","0","0","2","2","0","0","0","2","0","0","2","0","2","0","0","2","0","0","2"
"Zamora","41.50633","-5.74456","2","0","0","0","0","0","0","2","2","0","0","0","2","0","0","2","0","2","0","0","2","0","0","2"
"Zanzibar","-6.16394","39.19793","4","0","0","0","0","0","0","4","0","4","0","0","4","1","2","1","0","4","0","0","2","0","2","4"
"Zapopan","20.72356","-103.38479","2","0","0","0","1","0","0","3","1","1","0","0","2","0","1","2","0","3","2","0","1","0","0","3"
"Zaporizhia","47.82289","35.19031","3","1","0","0","0","0","0","4","0","2","1","1","4","2","0","1","1","4","1","0","2","1","0","4"
"Zaprešić","45.85639","15.80778","1","0","0","0","0","0","0","1","0","0","1","0","1","0","0","1","0","1","0","1","0","0","0","1"
"Zaria","11.11128","7.7227","1","0","0","0","0","0","0","1","1","0","0","0","1","1","0","0","0","1","0","0","1","0","0","1"
"Zarqa","32.07275","36.08796","4","0","0","0","0","0","0","4","2","2","0","0","4","0","2","2","0","4","2","1","1","0","0","4"
"Zarzis","33.50398","11.11215","1","0","0","0","0","0","0","1","0","1","0","0","1","0","1","0","0","1","1","0","0","0","0","1"
"Zavidovići","44.44583","18.14972","2","0","0","0","0","0","0","2","0","0","2","0","2","0","0","2","0","2","0","0","2","0","0","2"
"Zawiya","32.75222","12.72778","1","0","0","0","0","0","0","1","0","0","0","0","0","1","0","0","0","1","1","0","0","0","0","1"
"Zaxo","37.14871","42.68591","4","0","0","0","0","0","0","4","3","0","1","0","4","1","0","3","0","4","0","2","2","0","0","4"
"Zefta","30.7142","31.24425","3","0","0","0","0","0","0","3","1","0","1","0","2","1","2","0","0","3","0","0","2","0","1","3"
"Zenica","44.20169","17.90397","3","1","0","0","0","0","0","4","0","3","0","0","3","0","2","2","0","4","3","0","0","0","1","4"
"Zghartā","34.39739","35.89493","0","1","0","0","0","0","0","1","1","0","0","0","1","0","0","1","0","1","0","0","1","0","0","1"
"Zhengzhou","34.75778","113.64861","1","0","0","0","0","0","0","1","1","0","0","0","1","0","1","0","0","1","0","0","1","0","0","1"
"Zhob","31.34082","69.4493","1","0","0","0","0","0","0","1","1","0","0","0","1","1","0","0","0","1","0","0","1","0","0","1"
"Žilina","50.09987","14.00575","2","0","0","0","0","0","0","2","1","0","1","0","2","0","0","2","0","2","0","0","2","0","0","2"
"Žilina","49.22315","18.73941","2","0","0","0","0","0","0","2","1","0","1","0","2","0","0","2","0","2","0","0","2","0","0","2"
"Zira","30.96853","74.99106","1","0","0","0","0","0","0","1","1","0","0","0","1","0","0","1","0","1","0","0","1","0","0","1"
"Zirc","47.26362","17.87373","1","0","0","0","0","0","0","1","0","1","0","0","1","0","1","0","0","1","1","0","0","0","0","1"
"Zliten","32.46739","14.56874","1","0","0","0","0","0","0","1","0","0","1","0","1","1","0","0","0","1","1","0","0","0","0","1"
"Zográfos","37.97574","23.76911","1","0","0","0","0","0","0","1","0","1","0","0","1","0","1","0","0","1","1","0","0","0","0","1"
"Zomba","46.41084","18.56577","1","1","0","0","0","0","0","2","1","0","0","0","1","1","1","0","0","2","1","0","0","0","1","2"
"Zomba","-15.38596","35.3188","1","1","0","0","0","0","0","2","1","0","0","0","1","1","1","0","0","2","1","0","0","0","1","2"
"Zrenjanin","45.38361","20.38194","2","0","0","0","0","0","0","2","0","2","0","0","2","1","0","1","0","2","2","0","0","0","0","2"
"Zürich","47.36667","8.55","3","0","0","0","0","0","0","3","1","0","0","0","1","3","0","0","0","3","0","0","2","1","0","3"
"Zürich (Kreis 10) / Höngg","47.40313","8.4971","0","0","0","1","0","0","0","1","0","0","0","0","0","0","0","1","0","1","0","0","0","1","0","1"
"Zürich (Kreis 7) / Fluntern","47.38013","8.56133","1","0","0","0","0","0","0","1","0","0","1","0","1","0","0","1","0","1","0","0","1","0","0","1"
"Zürich (Kreis 8) / Seefeld","47.35462","8.55537","1","0","0","0","0","0","0","1","0","0","0","0","0","1","0","0","0","1","0","0","0","0","1","1"
"Zwolle","31.63156","-93.64407","1","0","0","0","0","0","0","1","0","0","0","0","0","1","0","0","0","1","1","0","0","0","0","1"
"Zwolle","52.5125","6.09444","1","0","0","0","0","0","0","1","0","0","0","0","0","1","0","0","0","1","1","0","0","0","0","1"
NULL,NULL,NULL,"10711","477","34","397","789","28","705","13141","3024","2252","1736","616","7628","4225","1860","4071","353","10509","2093","1989","4518","252","604","9456"
