"city","country","point_latitude","point_longitude","covid_status_no_symptoms","covid_status_self_isolation_after_exposure","covid_status_test_positive","covid_status_symptoms","covid_status_symptoms_not_covid","covid_status_test_positive_recovered","covid_status_symptoms_recovered","covid_status_total_responses","self_isolation_steps_not_leaving_house","self_isolation_steps_work_and_essentials","self_isolation_steps_essentials","self_isolation_steps_none","self_isolation_steps_total_responses","amount_of_contact_no_large_groups","amount_of_contact_reduced_contact","amount_of_contact_minimal_contact","amount_of_contact_none","amount_of_contact_total_responses","current_work_car","current_work_retired","current_work_wfh","current_work_public_transport","current_work_bike_or_walk","current_work_total_responses"
"Abberton","GB","51.83435","0.91084","50","2","0","1","3","0","1","57","11","9","18","1","39","15","6","34","2","57","9","16","31","1","0","57"
"Abbey Dore","GB","51.96667","-2.9","305","13","1","24","47","0","30","420","75","137","124","10","346","168","57","189","7","421","74","88","244","4","11","421"
"Abbey Wood","GB","51.48688","0.10747","26","1","0","1","4","0","1","33","3","7","18","0","28","17","4","13","0","34","6","9","18","0","1","34"
"Abbots Bromley","GB","52.81705","-1.87694","13","0","0","0","1","0","0","14","2","3","2","0","7","7","1","6","0","14","2","3","9","0","0","14"
"Abbotskerswell","GB","50.50816","-3.61342","4","1","0","0","0","0","0","5","0","2","2","0","4","2","2","1","0","5","0","0","5","0","0","5"
"Abbots Langley","GB","51.70573","-0.41757","7","0","0","0","2","0","0","9","2","0","2","3","7","3","1","3","2","9","0","3","6","0","0","9"
"Abbotts Ann","GB","51.19016","-1.53234","1","0","0","0","0","0","0","1","1","0","0","0","1","0","0","1","0","1","0","0","1","0","0","1"
"Āb-e Kamarī","GB","35.08796","63.0678","1","0","0","0","0","0","0","1","0","0","1","0","1","0","1","0","0","1","0","0","1","0","0","1"
"Aber","GB","53.23333","-4.01667","2","0","0","0","0","0","0","2","0","0","1","0","1","2","0","0","0","2","0","1","1","0","0","2"
"Abercanaid","GB","51.72361","-3.36611","2","0","0","0","0","0","0","2","0","1","1","0","2","1","1","0","0","2","1","1","0","0","0","2"
"Abercarn","GB","51.64733","-3.13476","3","0","0","0","0","0","0","3","1","0","2","0","3","0","1","2","0","3","1","2","0","0","0","3"
"Abercynon","GB","51.64548","-3.32727","1","0","0","0","0","0","1","2","0","0","1","0","1","0","0","2","0","2","0","0","2","0","0","2"
"Aberdare","GB","51.71438","-3.44918","8","0","0","0","0","0","0","8","1","6","1","0","8","3","3","2","0","8","3","2","2","1","0","8"
"Aberdare","GB","-32.84112","151.38168","8","0","0","0","0","0","0","8","1","6","1","0","8","3","3","2","0","8","3","2","2","1","0","8"
"Aberdeen","GB","46.97537","-123.81572","23","0","0","0","3","0","1","27","7","9","9","0","25","9","6","12","0","27","3","7","16","0","1","27"
"Aberdeen","GB","42.94408","-112.83833","23","0","0","0","3","0","1","27","7","9","9","0","25","9","6","12","0","27","3","7","16","0","1","27"
"Aberdeen","GB","45.4647","-98.48648","23","0","0","0","3","0","1","27","7","9","9","0","25","9","6","12","0","27","3","7","16","0","1","27"
"Aberdeen","GB","33.82511","-88.54366","23","0","0","0","3","0","1","27","7","9","9","0","25","9","6","12","0","27","3","7","16","0","1","27"
"Aberdeen","GB","41.43893","-87.11142","23","0","0","0","3","0","1","27","7","9","9","0","25","9","6","12","0","27","3","7","16","0","1","27"
"Aberdeen","GB","38.65563","-83.76103","23","0","0","0","3","0","1","27","7","9","9","0","25","9","6","12","0","27","3","7","16","0","1","27"
"Aberdeen","GB","26.55063","-80.14866","23","0","0","0","3","0","1","27","7","9","9","0","25","9","6","12","0","27","3","7","16","0","1","27"
"Aberdeen","GB","35.13155","-79.42948","23","0","0","0","3","0","1","27","7","9","9","0","25","9","6","12","0","27","3","7","16","0","1","27"
"Aberdeen","GB","39.50956","-76.16412","23","0","0","0","3","0","1","27","7","9","9","0","25","9","6","12","0","27","3","7","16","0","1","27"
"Aberdeen","GB","57.14369","-2.09814","23","0","0","0","3","0","1","27","7","9","9","0","25","9","6","12","0","27","3","7","16","0","1","27"
"Aberdeen","GB","-32.16588","150.89003","23","0","0","0","3","0","1","27","7","9","9","0","25","9","6","12","0","27","3","7","16","0","1","27"
"Aberdyfi","GB","52.544","-4.04606","1","0","0","0","0","0","1","2","0","1","0","0","1","1","1","0","0","2","0","2","0","0","0","2"
"Aberfan","GB","51.68892","-3.34178","0","0","0","0","1","0","0","1","0","0","1","0","1","0","0","1","0","1","1","0","0","0","0","1"
"Aberfeldy","GB","56.62196","-3.86693","2","0","0","0","0","0","0","2","0","0","2","0","2","1","0","1","0","2","0","0","2","0","0","2"
"Aberford","GB","53.82604","-1.34231","0","0","0","0","1","0","0","1","1","0","0","0","1","1","0","0","0","1","0","0","1","0","0","1"
"Abergavenny","GB","51.82098","-3.01743","17","2","0","0","1","0","0","20","3","7","9","0","19","4","4","12","0","20","7","3","10","0","0","20"
"Abergele","GB","53.28436","-3.5822","1","0","0","0","0","0","0","1","0","1","0","0","1","0","1","0","0","1","1","0","0","0","0","1"
"Abergwili","GB","51.86593","-4.26969","1","0","0","0","0","0","0","1","0","1","0","0","1","1","0","0","0","1","1","0","0","0","0","1"
"Abersoch","GB","52.82437","-4.50584","1","0","0","0","0","0","0","1","0","1","0","0","1","1","0","0","0","1","0","1","0","0","0","1"
"Abertillery","GB","51.72981","-3.13432","3","0","0","0","1","0","0","4","2","0","2","0","4","0","1","2","1","4","0","2","2","0","0","4"
"Abertridwr","GB","51.59583","-3.26833","0","0","0","0","1","0","0","1","0","1","0","0","1","0","0","1","0","1","1","0","0","0","0","1"
"Aberystwyth","GB","52.41548","-4.08292","4","0","0","0","1","0","0","5","2","0","3","0","5","0","1","4","0","5","1","0","4","0","0","5"
"Abingdon","GB","40.80448","-90.4018","9","1","0","0","1","0","1","12","1","2","7","0","10","3","3","6","0","12","2","1","9","0","0","12"
"Abingdon","GB","36.70983","-81.97735","9","1","0","0","1","0","1","12","1","2","7","0","10","3","3","6","0","12","2","1","9","0","0","12"
"Abingdon","GB","51.67109","-1.28278","9","1","0","0","1","0","1","12","1","2","7","0","10","3","3","6","0","12","2","1","9","0","0","12"
"Aboyne","GB","57.07546","-2.78023","1","0","0","0","1","0","0","2","0","0","2","0","2","0","0","2","0","2","0","1","1","0","0","2"
"Accrington","GB","53.75379","-2.35863","8","0","0","0","0","0","1","9","2","5","2","0","9","2","1","5","0","8","1","1","7","0","0","9"
"Acton","GB","34.46999","-118.19674","1","0","0","0","0","0","0","1","0","0","0","0","0","1","0","0","0","1","0","0","1","0","0","1"
"Acton","GB","42.48509","-71.43284","1","0","0","0","0","0","0","1","0","0","0","0","0","1","0","0","0","1","0","0","1","0","0","1"
"Acton","GB","43.53425","-70.90978","1","0","0","0","0","0","0","1","0","0","0","0","0","1","0","0","0","1","0","0","1","0","0","1"
"Acton","GB","52.45","-3.01667","1","0","0","0","0","0","0","1","0","0","0","0","0","1","0","0","0","1","0","0","1","0","0","1"
"Acton","GB","51.50901","-0.2762","1","0","0","0","0","0","0","1","0","0","0","0","0","1","0","0","0","1","0","0","1","0","0","1"
"Acton","GB","-35.27767","149.11829","1","0","0","0","0","0","0","1","0","0","0","0","0","1","0","0","0","1","0","0","1","0","0","1"
"Addingham","GB","53.94452","-1.88424","1","0","0","0","0","0","0","1","0","1","1","0","2","0","0","2","0","2","0","0","2","0","0","2"
"Addlestone","GB","51.37135","-0.49353","5","0","0","1","0","0","0","6","1","2","2","0","5","3","0","3","0","6","1","2","3","0","0","6"
"Adlington","GB","53.61323","-2.60676","1","0","0","0","0","0","0","1","0","0","1","0","1","0","0","1","0","1","0","0","1","0","0","1"
"Adlington","GB","53.32042","-2.13658","1","0","0","0","0","0","0","1","0","0","1","0","1","0","0","1","0","1","0","0","1","0","0","1"
"Adwick le Street","GB","53.57077","-1.18454","6","0","0","0","0","0","0","6","5","1","0","0","6","1","0","5","0","6","1","0","5","0","0","6"
"Airdrie","GB","51.30011","-114.03528","6","0","0","0","0","0","0","6","0","3","3","0","6","2","2","2","0","6","1","3","2","0","0","6"
"Airdrie","GB","55.86602","-3.98025","6","0","0","0","0","0","0","6","0","3","3","0","6","2","2","2","0","6","1","3","2","0","0","6"
"Albrighton","GB","52.6364","-2.27966","1","0","0","0","0","0","0","1","0","1","0","0","1","0","0","1","0","1","0","0","0","0","1","1"
"Alcester","GB","43.02138","-96.63087","0","1","0","0","1","0","2","4","1","2","1","0","4","0","0","4","0","4","1","1","2","0","0","4"
"Alcester","GB","52.21667","-1.86667","0","1","0","0","1","0","2","4","1","2","1","0","4","0","0","4","0","4","1","1","2","0","0","4"
"Aldbourne","GB","51.48098","-1.61827","1","0","0","0","0","0","0","1","0","1","0","0","1","1","0","0","0","1","0","0","1","0","0","1"
"Alderley Edge","GB","53.30393","-2.23773","1","0","0","1","0","0","1","3","1","1","1","0","3","0","0","3","0","3","1","0","2","0","0","3"
"Aldershot","GB","51.24827","-0.76389","10","0","0","0","1","0","1","12","2","6","3","0","11","4","4","4","0","12","5","4","3","0","0","12"
"Aldershot","GB","-25.46312","152.66348","10","0","0","0","1","0","1","12","2","6","3","0","11","4","4","4","0","12","5","4","3","0","0","12"
"Alexandria","GB","43.65359","-97.78285","1","0","0","0","0","0","0","1","0","1","0","0","1","0","1","0","0","1","1","0","0","0","0","1"
"Alexandria","GB","45.88524","-95.37754","1","0","0","0","0","0","0","1","0","1","0","0","1","0","1","0","0","1","1","0","0","0","0","1"
"Alexandria","GB","31.31129","-92.44514","1","0","0","0","0","0","0","1","0","1","0","0","1","0","1","0","0","1","1","0","0","0","0","1"
"Alexandria","GB","36.07756","-86.03332","1","0","0","0","0","0","0","1","0","1","0","0","1","0","1","0","0","1","1","0","0","0","0","1"
"Alexandria","GB","33.77399","-85.88552","1","0","0","0","0","0","0","1","0","1","0","0","1","0","1","0","0","1","1","0","0","0","0","1"
"Alexandria","GB","40.26282","-85.67581","1","0","0","0","0","0","0","1","0","1","0","0","1","0","1","0","0","1","1","0","0","0","0","1"
"Alexandria","GB","38.95951","-84.38799","1","0","0","0","0","0","0","1","0","1","0","0","1","0","1","0","0","1","1","0","0","0","0","1"
"Alexandria","GB","40.08895","-82.61239","1","0","0","0","0","0","0","1","0","1","0","0","1","0","1","0","0","1","1","0","0","0","0","1"
"Alexandria","GB","18.30768","-77.35335","1","0","0","0","0","0","0","1","0","1","0","0","1","0","1","0","0","1","1","0","0","0","0","1"
"Alexandria","GB","38.80484","-77.04692","1","0","0","0","0","0","0","1","0","1","0","0","1","0","1","0","0","1","1","0","0","0","0","1"
"Alexandria","GB","43.61146","-71.79286","1","0","0","0","0","0","0","1","0","1","0","0","1","0","1","0","0","1","1","0","0","0","0","1"
"Alexandria","GB","-6.4125","-38.01583","1","0","0","0","0","0","0","1","0","1","0","0","1","0","1","0","0","1","1","0","0","0","0","1"
"Alexandria","GB","55.99379","-4.5864","1","0","0","0","0","0","0","1","0","1","0","0","1","0","1","0","0","1","1","0","0","0","0","1"
"Alexandria","GB","43.98333","25.33333","1","0","0","0","0","0","0","1","0","1","0","0","1","0","1","0","0","1","1","0","0","0","0","1"
"Alexandria","GB","31.20176","29.91582","1","0","0","0","0","0","0","1","0","1","0","0","1","0","1","0","0","1","1","0","0","0","0","1"
"Alexandria","GB","-33.89989","151.19951","1","0","0","0","0","0","0","1","0","1","0","0","1","0","1","0","0","1","1","0","0","0","0","1"
"Alfreton","GB","53.09766","-1.38376","9","0","0","1","1","0","0","11","1","7","1","0","9","3","1","7","0","11","5","3","3","0","0","11"
"Allanton","GB","55.79945","-3.83492","0","0","0","0","0","0","2","2","0","0","1","1","2","1","0","1","0","2","1","1","0","0","0","2"
"Allanton","GB","55.78333","-2.21667","0","0","0","0","0","0","2","2","0","0","1","1","2","1","0","1","0","2","1","1","0","0","0","2"
"Alloa","GB","56.11586","-3.78997","2","0","0","0","1","0","0","3","1","0","2","0","3","1","1","1","0","3","0","0","3","0","0","3"
"Alness","GB","57.69596","-4.2551","2","0","0","0","0","0","0","2","1","0","1","0","2","2","0","0","0","2","0","2","0","0","0","2"
"Alnmouth","GB","55.4","-1.6","7","0","0","0","0","0","0","7","2","2","3","0","7","0","1","6","0","7","1","3","3","0","0","7"
"Alnwick","GB","55.41318","-1.70563","7","0","0","0","0","0","1","8","3","1","2","0","6","1","2","5","0","8","0","4","3","0","1","8"
"Alpington","GB","52.56728","1.38229","7","0","0","0","2","0","2","11","1","2","4","2","9","4","2","5","0","11","4","5","2","0","0","11"
"Alresford","GB","51.85389","1.00203","4","1","0","1","0","0","0","6","2","2","1","0","5","0","0","6","0","6","0","3","2","0","1","6"
"Alrewas","GB","52.73278","-1.74968","2","0","0","0","0","0","0","2","0","1","1","0","2","1","0","1","0","2","0","2","0","0","0","2"
"Alsager","GB","53.09617","-2.30649","2","0","0","0","0","0","0","2","0","0","2","0","2","0","0","2","0","2","0","2","0","0","0","2"
"Althorne","GB","51.65722","0.76085","2","0","0","0","0","0","0","2","0","0","2","0","2","1","0","1","0","2","0","2","0","0","0","2"
"Alton","GB","26.28729","-98.31335","8","0","0","0","0","0","0","8","2","1","3","0","6","2","0","6","0","8","0","5","3","0","0","8"
"Alton","GB","42.98749","-96.01057","8","0","0","0","0","0","0","8","2","1","3","0","6","2","0","6","0","8","0","5","3","0","0","8"
"Alton","GB","36.69423","-91.3993","8","0","0","0","0","0","0","8","2","1","3","0","6","2","0","6","0","8","0","5","3","0","0","8"
"Alton","GB","38.8906","-90.18428","8","0","0","0","0","0","0","8","2","1","3","0","6","2","0","6","0","8","0","5","3","0","0","8"
"Alton","GB","43.4523","-71.21757","8","0","0","0","0","0","0","8","2","1","3","0","6","2","0","6","0","8","0","5","3","0","0","8"
"Alton","GB","45.03145","-68.72865","8","0","0","0","0","0","0","8","2","1","3","0","6","2","0","6","0","8","0","5","3","0","0","8"
"Alton","GB","51.14931","-0.97469","8","0","0","0","0","0","0","8","2","1","3","0","6","2","0","6","0","8","0","5","3","0","0","8"
"Altrincham","GB","53.38752","-2.34848","8","3","0","1","0","0","2","14","8","1","2","0","11","7","1","6","0","14","0","2","12","0","0","14"
"Alvechurch","GB","52.35173","-1.96531","2","0","0","0","0","0","0","2","0","1","1","0","2","1","0","1","0","2","1","0","1","0","0","2"
"Ambleside","GB","54.43261","-2.96167","2","0","0","0","0","0","0","2","0","1","0","0","1","0","1","1","0","2","1","1","0","0","0","2"
"Ambleside","GB","-41.20316","146.37225","2","0","0","0","0","0","0","2","0","1","0","0","1","0","1","1","0","2","1","1","0","0","0","2"
"Amersham","GB","51.66667","-0.61667","4","0","0","0","0","0","1","5","1","1","2","0","4","2","1","2","0","5","0","1","4","0","0","5"
"Amersham on the Hill","GB","51.67468","-0.60742","3","0","0","0","0","0","1","4","0","1","2","0","3","1","0","3","0","4","0","0","4","0","0","4"
"Amesbury","GB","42.85842","-70.93005","1","0","0","0","0","0","0","1","0","1","0","0","1","0","0","1","0","1","0","0","1","0","0","1"
"Amesbury","GB","51.17509","-1.78064","1","0","0","0","0","0","0","1","0","1","0","0","1","0","0","1","0","1","0","0","1","0","0","1"
"Amlwch","GB","53.40986","-4.34712","1","0","0","0","0","0","0","1","0","0","1","0","1","0","0","1","0","1","0","0","1","0","0","1"
"Ammanford","GB","51.79279","-3.98833","4","1","0","0","0","0","1","6","1","3","2","0","6","4","0","2","0","6","0","3","3","0","0","6"
"Ampleforth","GB","54.19956","-1.10691","1","0","0","0","0","0","0","1","0","0","1","0","1","0","0","1","0","1","0","0","1","0","0","1"
"Ampthill","GB","52.02694","-0.49567","5","0","0","0","1","0","0","6","1","1","4","0","6","3","2","1","0","6","0","0","6","0","0","6"
"Andover","GB","37.7139","-97.13643","9","0","0","2","1","0","2","14","4","3","4","0","11","7","0","7","0","14","1","2","10","0","1","14"
"Andover","GB","45.2333","-93.29134","9","0","0","2","1","0","2","14","4","3","4","0","11","7","0","7","0","14","1","2","10","0","1","14"
"Andover","GB","41.29392","-90.29207","9","0","0","2","1","0","2","14","4","3","4","0","11","7","0","7","0","14","1","2","10","0","1","14"
"Andover","GB","41.60672","-80.5723","9","0","0","2","1","0","2","14","4","3","4","0","11","7","0","7","0","14","1","2","10","0","1","14"
"Andover","GB","25.96843","-80.21283","9","0","0","2","1","0","2","14","4","3","4","0","11","7","0","7","0","14","1","2","10","0","1","14"
"Andover","GB","42.15646","-77.79555","9","0","0","2","1","0","2","14","4","3","4","0","11","7","0","7","0","14","1","2","10","0","1","14"
"Andover","GB","40.98593","-74.74211","9","0","0","2","1","0","2","14","4","3","4","0","11","7","0","7","0","14","1","2","10","0","1","14"
"Andover","GB","43.43702","-71.82341","9","0","0","2","1","0","2","14","4","3","4","0","11","7","0","7","0","14","1","2","10","0","1","14"
"Andover","GB","42.65843","-71.137","9","0","0","2","1","0","2","14","4","3","4","0","11","7","0","7","0","14","1","2","10","0","1","14"
"Andover","GB","44.63562","-70.75118","9","0","0","2","1","0","2","14","4","3","4","0","11","7","0","7","0","14","1","2","10","0","1","14"
"Andover","GB","51.21135","-1.49393","9","0","0","2","1","0","2","14","4","3","4","0","11","7","0","7","0","14","1","2","10","0","1","14"
"Antrim","GB","43.03091","-71.93897","3","0","0","0","0","0","0","3","0","2","1","0","3","3","0","0","0","3","1","1","1","0","0","3"
"Antrim","GB","54.7","-6.2","3","0","0","0","0","0","0","3","0","2","1","0","3","3","0","0","0","3","1","1","1","0","0","3"
"Arbroath","GB","56.56317","-2.58736","2","0","0","0","0","0","0","2","0","1","1","0","2","1","0","1","0","2","1","0","1","0","0","2"
"Arlesey","GB","52.00713","-0.26565","0","0","0","0","0","0","1","1","0","0","1","0","1","0","1","0","0","1","0","1","0","0","0","1"
"Armagh","GB","54.35","-6.66667","2","1","0","0","0","0","1","4","1","1","2","0","4","0","2","2","0","4","0","2","2","0","0","4"
"Arundel","GB","43.38259","-70.47783","4","0","0","0","0","0","0","4","2","0","1","0","3","2","0","2","0","4","0","3","1","0","0","4"
"Arundel","GB","50.85423","-0.55393","4","0","0","0","0","0","0","4","2","0","1","0","3","2","0","2","0","4","0","3","1","0","0","4"
"Arundel","GB","-27.93768","153.36302","4","0","0","0","0","0","0","4","2","0","1","0","3","2","0","2","0","4","0","3","1","0","0","4"
"Ascot","GB","51.41082","-0.6748","8","0","0","0","0","0","3","11","2","5","2","0","9","5","1","5","0","11","0","3","7","0","1","11"
"Ascot","GB","-31.93818","115.92258","8","0","0","0","0","0","3","11","2","5","2","0","9","5","1","5","0","11","0","3","7","0","1","11"
"Ascot","GB","-36.7","144.33333","8","0","0","0","0","0","3","11","2","5","2","0","9","5","1","5","0","11","0","3","7","0","1","11"
"Ascot","GB","-27.43154","153.058","8","0","0","0","0","0","3","11","2","5","2","0","9","5","1","5","0","11","0","3","7","0","1","11"
"Ashbourne","GB","53.51163","-6.39821","6","0","0","0","0","0","0","6","0","5","0","0","5","6","0","0","0","6","6","0","0","0","0","6"
"Ashbourne","GB","53.01667","-1.73333","6","0","0","0","0","0","0","6","0","5","0","0","5","6","0","0","0","6","6","0","0","0","0","6"
"Ashby-de-la-Zouch","GB","52.74632","-1.4732","1","0","0","0","0","0","0","1","0","0","1","0","1","0","0","1","0","1","0","0","1","0","0","1"
"Ashford","GB","43.58694","-88.37066","27","2","0","2","1","0","1","33","5","13","15","0","33","11","5","16","1","33","6","11","15","0","1","33"
"Ashford","GB","31.18296","-85.23632","27","2","0","2","1","0","1","33","5","13","15","0","33","11","5","16","1","33","6","11","15","0","1","33"
"Ashford","GB","53.00833","-6.11139","27","2","0","2","1","0","1","33","5","13","15","0","33","11","5","16","1","33","6","11","15","0","1","33"
"Ashford","GB","51.43173","-0.45761","27","2","0","2","1","0","1","33","5","13","15","0","33","11","5","16","1","33","6","11","15","0","1","33"
"Ashford","GB","51.14648","0.87376","27","2","0","2","1","0","1","33","5","13","15","0","33","11","5","16","1","33","6","11","15","0","1","33"
"Ashford","GB","-34.94859","138.57457","27","2","0","2","1","0","1","33","5","13","15","0","33","11","5","16","1","33","6","11","15","0","1","33"
"Ashford","GB","-29.32191","151.09308","27","2","0","2","1","0","1","33","5","13","15","0","33","11","5","16","1","33","6","11","15","0","1","33"
"Ashington","GB","55.17719","-1.56412","5","0","0","0","2","0","0","7","1","3","0","0","4","4","0","3","0","7","1","2","3","0","1","7"
"Ashington","GB","50.93312","-0.39087","5","0","0","0","2","0","0","7","1","3","0","0","4","4","0","3","0","7","1","2","3","0","1","7"
"Ashtead","GB","51.30873","-0.29972","4","1","0","0","0","0","0","5","1","1","2","0","4","1","0","4","0","5","0","1","3","0","1","5"
"Ashton-under-Lyne","GB","53.48876","-2.0989","2","0","0","0","0","0","0","2","0","0","1","0","1","1","1","0","0","2","0","0","2","0","0","2"
"Astley","GB","52.76667","-2.7","1","0","0","0","0","0","0","1","1","0","0","0","1","1","0","0","0","1","0","0","1","0","0","1"
"Aston Clinton","GB","51.8002","-0.7254","1","0","0","0","0","0","0","1","0","1","0","0","1","1","0","0","0","1","0","0","1","0","0","1"
"Atherstone","GB","52.57536","-1.54693","2","1","0","0","0","0","0","3","2","1","0","0","3","2","1","0","0","3","0","1","2","0","0","3"
"Atworth","GB","51.39234","-2.19297","1","0","0","0","0","0","0","1","0","1","0","0","1","0","0","1","0","1","1","0","0","0","0","1"
"Auchinleck","GB","55.47157","-4.29337","1","0","0","0","0","0","0","1","0","1","0","0","1","0","1","0","0","1","0","0","1","0","0","1"
"Auchterarder","GB","56.29612","-3.70692","0","0","0","0","1","0","0","1","0","1","0","0","1","0","0","1","0","1","0","0","1","0","0","1"
"Audlem","GB","52.98956","-2.50706","1","0","0","0","0","0","0","1","0","0","0","0","0","0","0","1","0","1","0","0","1","0","0","1"
"Avoch","GB","57.56898","-4.17675","0","0","0","0","1","0","0","1","0","0","1","0","1","1","0","0","0","1","1","0","0","0","0","1"
"Axminster","GB","50.78259","-2.99787","4","0","0","0","0","0","0","4","1","0","0","0","1","2","0","2","0","4","0","2","2","0","0","4"
"Aylburton","GB","51.71506","-2.55312","1","0","0","0","0","0","0","1","0","0","1","0","1","0","0","1","0","1","0","1","0","0","0","1"
"Aylesbury","GB","51.81665","-0.81458","18","2","0","1","2","0","2","25","5","11","5","0","21","11","0","12","1","24","5","12","7","0","1","25"
"Aylesford","GB","51.30374","0.47936","2","0","0","0","0","0","0","2","0","2","0","0","2","1","0","1","0","2","1","0","1","0","0","2"
"Ayr","GB","55.46273","-4.63393","2","1","0","0","0","0","1","4","0","0","4","0","4","3","0","1","0","4","0","2","2","0","0","4"
"Ayr","GB","-19.57393","147.40666","2","1","0","0","0","0","1","4","0","0","4","0","4","3","0","1","0","4","0","2","2","0","0","4"
"Babworth","GB","53.31799","-0.97583","1","0","0","0","0","0","0","1","0","0","0","0","0","0","0","1","0","1","0","0","1","0","0","1"
"Bacup","GB","53.70336","-2.2007","2","0","0","0","0","0","0","2","0","0","1","0","1","0","0","2","0","2","0","1","1","0","0","2"
"Bagshot","GB","51.36069","-0.68802","4","0","0","0","0","0","0","4","0","1","1","0","2","0","0","4","0","4","0","2","1","0","1","4"
"Bakewell","GB","53.21338","-1.67481","3","0","0","0","0","0","0","3","1","2","0","0","3","0","0","3","0","3","0","2","1","0","0","3"
"Bakewell","GB","-12.49684","130.99344","3","0","0","0","0","0","0","3","1","2","0","0","3","0","0","3","0","3","0","2","1","0","0","3"
"Baldock","GB","51.98781","-0.18835","5","0","0","1","0","0","0","6","1","2","2","0","5","2","1","3","0","6","2","1","3","0","0","6"
"Ballater","GB","57.05011","-3.03798","1","0","0","0","0","0","0","1","0","1","0","0","1","1","0","0","0","1","1","0","0","0","0","1"
"Ballingry","GB","56.16392","-3.32841","1","0","0","0","0","0","0","1","0","1","0","0","1","1","0","0","0","1","1","0","0","0","0","1"
"Ballymena","GB","54.86357","-6.27628","3","0","0","0","0","0","1","4","1","0","3","0","4","1","0","3","0","4","0","2","2","0","0","4"
"Ballymoney","GB","55.0708","-6.51009","7","0","0","0","1","0","0","8","1","0","7","0","8","0","8","0","0","8","0","2","6","0","0","8"
"Bampton","GB","51.72634","-1.54547","1","0","0","0","0","0","1","2","1","1","0","0","2","1","0","1","0","2","1","0","1","0","0","2"
"Banbridge","GB","54.35","-6.28333","2","0","0","0","1","0","0","3","0","0","2","0","2","1","0","2","0","3","2","0","1","0","0","3"
"Banbury","GB","52.0632","-1.34222","18","0","0","0","3","0","2","23","2","9","9","0","20","9","3","10","0","22","5","7","11","0","0","23"
"Banchory","GB","57.05168","-2.48824","1","0","0","0","0","0","0","1","0","0","1","0","1","0","0","1","0","1","0","0","1","0","0","1"
"Bangor","GB","39.3885","-121.40524","10","0","0","1","1","0","0","12","1","4","6","0","11","3","3","6","0","12","2","2","8","0","0","12"
"Bangor","GB","43.89302","-90.99041","10","0","0","1","1","0","0","12","1","4","6","0","11","3","3","6","0","12","2","2","8","0","0","12"
"Bangor","GB","42.31254","-86.11308","10","0","0","1","1","0","0","12","1","4","6","0","11","3","3","6","0","12","2","2","8","0","0","12"
"Bangor","GB","40.86565","-75.20657","10","0","0","1","1","0","0","12","1","4","6","0","11","3","3","6","0","12","2","2","8","0","0","12"
"Bangor","GB","44.80118","-68.77781","10","0","0","1","1","0","0","12","1","4","6","0","11","3","3","6","0","12","2","2","8","0","0","12"
"Bangor","GB","54.65338","-5.66895","10","0","0","1","1","0","0","12","1","4","6","0","11","3","3","6","0","12","2","2","8","0","0","12"
"Bangor","GB","53.22752","-4.12936","10","0","0","1","1","0","0","12","1","4","6","0","11","3","3","6","0","12","2","2","8","0","0","12"
"Bangor","GB","47.31557","-3.1894","10","0","0","1","1","0","0","12","1","4","6","0","11","3","3","6","0","12","2","2","8","0","0","12"
"Bangor","GB","-34.01667","151.03333","10","0","0","1","1","0","0","12","1","4","6","0","11","3","3","6","0","12","2","2","8","0","0","12"
"Banstead","GB","51.32233","-0.20685","5","1","0","0","1","0","1","8","2","3","2","0","7","1","2","5","0","8","2","1","5","0","0","8"
"Bargoed","GB","51.68333","-3.23333","1","1","0","0","1","0","1","4","1","1","2","0","4","2","2","0","0","4","2","1","1","0","0","4"
"Barking","GB","51.53333","0.08333","1","0","0","0","0","0","0","1","0","0","1","0","1","0","0","1","0","1","0","0","0","1","0","1"
"Barnard Castle","GB","54.5415","-1.919","4","0","0","0","0","0","0","4","1","1","2","0","4","3","0","1","0","4","0","0","3","0","1","4"
"Barnet","GB","51.65","-0.2","15","0","0","2","2","0","0","19","8","0","4","0","12","3","6","10","0","19","0","10","9","0","0","19"
"Barnoldswick","GB","53.91711","-2.18705","4","0","0","0","1","0","0","5","1","3","1","0","5","1","1","3","0","5","2","1","2","0","0","5"
"Barnsley","GB","53.55","-1.48333","14","1","0","0","0","0","0","15","2","7","3","0","12","4","4","6","1","15","5","6","4","0","0","15"
"Barnsley","GB","-32.93333","151.58333","14","1","0","0","0","0","0","15","2","7","3","0","12","4","4","6","1","15","5","6","4","0","0","15"
"Barnstaple","GB","51.08022","-4.05808","6","0","0","0","1","0","0","7","1","3","3","0","7","4","0","3","0","7","1","0","5","0","1","7"
"Barrow in Furness","GB","54.11094","-3.22758","14","0","0","1","0","0","1","16","3","9","3","0","15","7","5","4","0","16","6","2","8","0","0","16"
"Barrow upon Soar","GB","52.75178","-1.14601","0","0","0","0","1","0","0","1","1","0","0","0","1","0","0","1","0","1","0","0","1","0","0","1"
"Barry","GB","39.69421","-91.03902","13","0","0","0","0","0","3","16","4","6","5","1","16","6","2","8","0","16","6","4","6","0","0","16"
"Barry","GB","51.39979","-3.2838","13","0","0","0","0","0","3","16","4","6","5","1","16","6","2","8","0","16","6","4","6","0","0","16"
"Bartley Green","GB","52.43532","-1.99707","0","0","0","0","0","0","1","1","1","0","0","0","1","1","0","0","0","1","0","0","1","0","0","1"
"Baschurch","GB","52.78848","-2.85284","1","0","0","0","0","0","0","1","0","1","0","0","1","0","0","1","0","1","0","0","1","0","0","1"
"Basildon","GB","51.56844","0.45782","11","0","0","0","1","0","0","12","0","6","4","0","10","5","3","4","0","12","4","2","5","0","1","12"
"Basingstoke","GB","51.26249","-1.08708","51","2","1","3","2","0","3","62","18","10","22","0","50","20","16","30","0","66","7","16","40","2","1","66"
"Bath","GB","42.81864","-84.44859","58","0","0","2","4","0","5","69","12","17","17","0","46","25","7","36","0","68","6","9","53","0","1","69"
"Bath","GB","42.33702","-77.31776","58","0","0","2","4","0","5","69","12","17","17","0","46","25","7","36","0","68","6","9","53","0","1","69"
"Bath","GB","44.18342","-76.78273","58","0","0","2","4","0","5","69","12","17","17","0","46","25","7","36","0","68","6","9","53","0","1","69"
"Bath","GB","17.9482","-76.34916","58","0","0","2","4","0","5","69","12","17","17","0","46","25","7","36","0","68","6","9","53","0","1","69"
"Bath","GB","40.72565","-75.39407","58","0","0","2","4","0","5","69","12","17","17","0","46","25","7","36","0","68","6","9","53","0","1","69"
"Bath","GB","44.16701","-71.9662","58","0","0","2","4","0","5","69","12","17","17","0","46","25","7","36","0","68","6","9","53","0","1","69"
"Bath","GB","43.91064","-69.8206","58","0","0","2","4","0","5","69","12","17","17","0","46","25","7","36","0","68","6","9","53","0","1","69"
"Bath","GB","51.3751","-2.36172","58","0","0","2","4","0","5","69","12","17","17","0","46","25","7","36","0","68","6","9","53","0","1","69"
"Bathgate","GB","55.90204","-3.64398","11","0","0","1","0","0","1","13","2","0","10","0","12","3","1","9","0","13","0","6","7","0","0","13"
"Batley","GB","53.70291","-1.6337","2","0","0","0","1","0","0","3","0","0","3","0","3","1","0","2","0","3","0","1","2","0","0","3"
"Battle","GB","50.91732","0.48417","6","0","0","1","3","0","0","10","5","2","3","0","10","1","1","8","0","10","4","4","2","0","0","10"
"Beaconsfield","GB","45.43341","-73.86586","5","0","0","0","1","0","1","7","2","0","2","0","4","3","2","6","0","11","0","6","5","0","0","11"
"Beaconsfield","GB","51.61219","-0.64732","5","0","0","0","1","0","1","7","2","0","2","0","4","3","2","6","0","11","0","6","5","0","0","11"
"Beaconsfield","GB","-32.06748","115.76401","5","0","0","0","1","0","1","7","2","0","2","0","4","3","2","6","0","11","0","6","5","0","0","11"
"Beaconsfield","GB","-38.05","145.36667","5","0","0","0","1","0","1","7","2","0","2","0","4","3","2","6","0","11","0","6","5","0","0","11"
"Beaconsfield","GB","-41.20227","146.81723","5","0","0","0","1","0","1","7","2","0","2","0","4","3","2","6","0","11","0","6","5","0","0","11"
"Beaconsfield","GB","-21.09121","149.16544","5","0","0","0","1","0","1","7","2","0","2","0","4","3","2","6","0","11","0","6","5","0","0","11"
"Beaconsfield","GB","-33.91147","151.20038","5","0","0","0","1","0","1","7","2","0","2","0","4","3","2","6","0","11","0","6","5","0","0","11"
"Beaminster","GB","50.809","-2.7391","1","0","0","1","2","0","0","4","1","0","2","0","3","2","0","2","0","4","2","0","2","0","0","4"
"Beauly","GB","57.48345","-4.46144","1","0","0","0","0","0","0","1","1","0","0","0","1","0","0","1","0","1","0","1","0","0","0","1"
"Bebington","GB","53.35","-3.01667","3","2","0","0","0","0","0","5","3","0","2","0","5","0","0","5","0","5","1","1","3","0","0","5"
"Beccles","GB","52.45936","1.56465","2","0","0","1","2","0","0","5","2","0","3","0","5","2","1","2","0","5","0","2","3","0","0","5"
"Beckenham","GB","51.40878","-0.02526","9","0","0","0","1","0","0","10","3","3","2","0","8","4","1","5","0","10","0","3","7","0","0","10"
"Beckenham","GB","-32.02481","115.95989","9","0","0","0","1","0","0","10","3","3","2","0","8","4","1","5","0","10","0","3","7","0","0","10"
"Beckington","GB","51.26444","-2.28722","3","0","0","0","0","0","0","3","0","2","0","0","2","2","1","0","0","3","0","3","0","0","0","3"
"Bedale","GB","54.28811","-1.59181","2","0","0","0","1","0","0","3","0","2","1","0","3","2","0","1","0","3","1","1","1","0","0","3"
"Beddau","GB","51.55398","-3.35814","3","0","0","0","0","0","0","3","0","0","0","0","0","2","0","1","0","3","0","0","3","0","0","3"
"Bedford","GB","32.84402","-97.14307","36","1","0","2","2","0","3","44","7","12","17","2","38","11","4","27","2","44","10","8","25","1","0","44"
"Bedford","GB","40.66693","-94.72136","36","1","0","2","2","0","3","44","7","12","17","2","38","11","4","27","2","44","10","8","25","1","0","44"
"Bedford","GB","38.86116","-86.48721","36","1","0","2","2","0","3","44","7","12","17","2","38","11","4","27","2","44","10","8","25","1","0","44"
"Bedford","GB","38.59256","-85.31773","36","1","0","2","2","0","3","44","7","12","17","2","38","11","4","27","2","44","10","8","25","1","0","44"
"Bedford","GB","41.39311","-81.53651","36","1","0","2","2","0","3","44","7","12","17","2","38","11","4","27","2","44","10","8","25","1","0","44"
"Bedford","GB","37.33431","-79.52309","36","1","0","2","2","0","3","44","7","12","17","2","38","11","4","27","2","44","10","8","25","1","0","44"
"Bedford","GB","40.01869","-78.50391","36","1","0","2","2","0","3","44","7","12","17","2","38","11","4","27","2","44","10","8","25","1","0","44"
"Bedford","GB","41.20426","-73.64374","36","1","0","2","2","0","3","44","7","12","17","2","38","11","4","27","2","44","10","8","25","1","0","44"
"Bedford","GB","45.11678","-72.98244","36","1","0","2","2","0","3","44","7","12","17","2","38","11","4","27","2","44","10","8","25","1","0","44"
"Bedford","GB","42.94647","-71.5159","36","1","0","2","2","0","3","44","7","12","17","2","38","11","4","27","2","44","10","8","25","1","0","44"
"Bedford","GB","42.49065","-71.27617","36","1","0","2","2","0","3","44","7","12","17","2","38","11","4","27","2","44","10","8","25","1","0","44"
"Bedford","GB","52.13459","-0.46632","36","1","0","2","2","0","3","44","7","12","17","2","38","11","4","27","2","44","10","8","25","1","0","44"
"Bedford","GB","-31.91132","115.8892","36","1","0","2","2","0","3","44","7","12","17","2","38","11","4","27","2","44","10","8","25","1","0","44"
"Bedlington","GB","55.13061","-1.59319","8","0","0","0","1","0","1","10","2","3","1","0","6","1","3","6","0","10","5","1","5","0","0","11"
"Bedlinog","GB","51.70432","-3.31306","1","0","0","0","0","0","0","1","0","0","1","0","1","0","0","1","0","1","0","1","0","0","0","1"
"Bedworth","GB","52.4791","-1.46909","3","0","0","1","0","0","0","4","1","2","0","0","3","0","0","4","0","4","2","1","1","0","0","4"
"Beeston","GB","53.11667","-2.68333","2","1","0","0","0","0","0","3","2","1","0","0","3","2","1","0","0","3","1","0","2","0","0","3"
"Beeston","GB","52.7","0.81667","2","1","0","0","0","0","0","3","2","1","0","0","3","2","1","0","0","3","1","0","2","0","0","3"
"Beith","GB","55.74923","-4.6368","0","0","0","0","0","0","0","0","0","0","0","0","0","0","0","0","0","0","0","0","1","0","0","1"
"Belfast","GB","42.34284","-78.1114","53","1","0","2","2","0","5","63","13","17","19","2","51","26","7","29","1","63","16","13","29","1","3","62"
"Belfast","GB","40.78065","-75.27796","53","1","0","2","2","0","5","63","13","17","19","2","51","26","7","29","1","63","16","13","29","1","3","62"
"Belfast","GB","44.42591","-69.00642","53","1","0","2","2","0","5","63","13","17","19","2","51","26","7","29","1","63","16","13","29","1","3","62"
"Belfast","GB","46.08341","-62.88197","53","1","0","2","2","0","5","63","13","17","19","2","51","26","7","29","1","63","16","13","29","1","3","62"
"Belfast","GB","54.59682","-5.92541","53","1","0","2","2","0","5","63","13","17","19","2","51","26","7","29","1","63","16","13","29","1","3","62"
"Belfast","GB","-25.68991","30.03504","53","1","0","2","2","0","5","63","13","17","19","2","51","26","7","29","1","63","16","13","29","1","3","62"
"Bellshill","GB","55.81667","-4.01667","3","0","0","0","0","0","0","3","0","2","1","0","3","0","2","1","0","3","0","1","1","0","1","3"
"Belper","GB","53.0233","-1.48119","6","0","0","0","1","0","1","8","0","4","0","0","4","4","3","1","0","8","2","1","5","0","0","8"
"Bembridge","GB","50.68634","-1.08275","1","0","0","0","0","0","0","1","1","0","0","0","1","0","0","1","0","1","0","0","1","0","0","1"
"Benbecula","GB","57.44737","-7.34273","1","0","0","0","0","0","0","1","1","0","0","0","1","1","0","0","0","1","0","1","0","0","0","1"
"Benson","GB","41.78743","-111.93022","1","0","0","0","0","0","0","1","0","0","1","0","1","0","0","1","0","1","0","0","1","0","0","1"
"Benson","GB","31.96786","-110.29452","1","0","0","0","0","0","0","1","0","0","1","0","1","0","0","1","0","1","0","0","1","0","0","1"
"Benson","GB","45.315","-95.6025","1","0","0","0","0","0","0","1","0","0","1","0","1","0","0","1","0","1","0","0","1","0","0","1"
"Benson","GB","35.38211","-78.54862","1","0","0","0","0","0","0","1","0","0","1","0","1","0","0","1","0","1","0","0","1","0","0","1"
"Benson","GB","51.62073","-1.10979","1","0","0","0","0","0","0","1","0","0","1","0","1","0","0","1","0","1","0","0","1","0","0","1"
"Berkeley","GB","37.87159","-122.27275","1","0","0","0","0","0","1","2","2","0","0","0","2","1","0","1","0","2","0","0","2","0","0","2"
"Berkeley","GB","38.7545","-90.33123","1","0","0","0","0","0","1","2","2","0","0","0","2","1","0","1","0","2","0","0","2","0","0","2"
"Berkeley","GB","41.88892","-87.9034","1","0","0","0","0","0","1","2","2","0","0","0","2","1","0","1","0","2","0","0","2","0","0","2"
"Berkeley","GB","51.69111","-2.45917","1","0","0","0","0","0","1","2","2","0","0","0","2","1","0","1","0","2","0","0","2","0","0","2"
"Berkeley","GB","-34.48333","150.85","1","0","0","0","0","0","1","2","2","0","0","0","2","1","0","1","0","2","0","0","2","0","0","2"
"Berkhamsted","GB","51.7604","-0.56528","7","1","0","1","2","0","1","12","3","2","4","1","10","5","2","5","0","12","1","2","9","0","0","12"
"Betchworth","GB","51.23374","-0.26655","1","0","0","0","0","0","0","1","0","0","1","0","1","0","0","1","0","1","0","0","1","0","0","1"
"Betws-y-Coed","GB","53.09382","-3.80668","1","0","0","0","0","0","0","1","0","0","1","0","1","0","1","0","0","1","0","0","1","0","0","1"
"Beverley","GB","53.84587","-0.42332","9","0","0","0","1","0","1","11","2","4","3","0","9","6","1","4","0","11","4","4","3","0","0","11"
"Beverley","GB","-32.10839","116.92736","9","0","0","0","1","0","1","11","2","4","3","0","9","6","1","4","0","11","4","4","3","0","0","11"
"Beverley","GB","-34.89512","138.54633","9","0","0","0","1","0","1","11","2","4","3","0","9","6","1","4","0","11","4","4","3","0","0","11"
"Bewdley","GB","52.3757","-2.31833","1","0","0","0","0","0","0","1","0","1","0","0","1","0","0","1","0","1","0","1","0","0","0","1"
"Bexhill-on-Sea","GB","50.85023","0.47095","109","5","0","8","9","0","8","139","38","44","52","1","135","39","25","75","0","139","25","68","38","2","6","139"
"Bexley","GB","39.96895","-82.93768","6","0","0","0","0","0","1","7","1","2","2","0","5","1","4","2","0","7","3","1","3","0","0","7"
"Bexley","GB","51.44162","0.14866","6","0","0","0","0","0","1","7","1","2","2","0","5","1","4","2","0","7","3","1","3","0","0","7"
"Bexley","GB","-33.95","151.11667","6","0","0","0","0","0","1","7","1","2","2","0","5","1","4","2","0","7","3","1","3","0","0","7"
"Bexleyheath","GB","51.46291","0.13943","13","1","0","1","0","0","1","16","2","5","6","0","13","6","3","6","1","16","1","2","12","1","0","16"
"Bicester","GB","51.89998","-1.15357","16","1","0","1","1","0","0","19","5","8","3","0","16","9","3","7","0","19","5","5","7","0","2","19"
"Bideford","GB","51.01678","-4.20832","3","0","0","0","0","0","0","3","1","1","1","0","3","1","0","2","0","3","1","0","2","0","0","3"
"Biggar","GB","52.0668","-108.00135","0","1","0","0","0","0","0","1","1","0","0","0","1","1","0","0","0","1","0","0","1","0","0","1"
"Biggar","GB","55.62297","-3.52455","0","1","0","0","0","0","0","1","1","0","0","0","1","1","0","0","0","1","0","0","1","0","0","1"
"Biggleswade","GB","52.08652","-0.26493","6","0","0","0","0","0","0","6","0","3","0","1","4","2","1","3","0","6","3","0","3","0","0","6"
"Billericay","GB","51.62867","0.41963","8","1","0","0","0","0","1","10","3","5","1","0","9","3","0","7","0","10","1","2","6","1","0","10"
"Billingham","GB","54.58881","-1.29034","2","0","0","0","0","0","0","2","1","0","0","0","1","0","0","2","0","2","1","1","0","0","0","2"
"Billingshurst","GB","51.02312","-0.45359","1","0","0","1","0","0","0","2","1","0","1","0","2","2","0","0","0","2","0","0","2","0","0","2"
"Bilston","GB","55.8703","-3.17814","2","0","0","0","0","0","0","2","0","1","1","0","2","1","0","1","0","2","0","1","1","0","0","2"
"Bilston","GB","52.56568","-2.07367","2","0","0","0","0","0","0","2","0","1","1","0","2","1","0","1","0","2","0","1","1","0","0","2"
"Binfield","GB","51.43159","-0.7881","1","0","0","0","0","0","0","1","1","0","0","0","1","1","0","0","0","1","0","0","1","0","0","1"
"Bingley","GB","53.84861","-1.83857","1","0","0","0","0","0","0","1","0","0","1","0","1","0","0","1","0","1","0","0","1","0","0","1"
"Birchington-on-Sea","GB","51.37575","1.3048","3","0","0","0","0","0","0","3","0","2","1","0","3","0","2","1","0","3","1","1","1","0","0","3"
"Birkenhead","GB","53.39337","-3.01479","8","0","0","1","2","0","1","12","1","6","2","1","10","7","1","4","0","12","5","1","5","0","1","12"
"Birkenhead","GB","-34.83685","138.49788","8","0","0","1","2","0","1","12","1","6","2","1","10","7","1","4","0","12","5","1","5","0","1","12"
"Birmingham","GB","33.52066","-86.80249","214","12","0","11","34","0","19","290","61","68","81","5","215","114","30","143","3","290","55","65","162","5","4","291"
"Birmingham","GB","42.5467","-83.21132","214","12","0","11","34","0","19","290","61","68","81","5","215","114","30","143","3","290","55","65","162","5","4","291"
"Birmingham","GB","52.48142","-1.89983","214","12","0","11","34","0","19","290","61","68","81","5","215","114","30","143","3","290","55","65","162","5","4","291"
"Birtley","GB","55.08333","-2.18333","1","0","0","0","0","0","0","1","0","0","0","0","0","0","1","0","0","1","0","1","0","0","0","1"
"Bishop Auckland","GB","54.65554","-1.67706","4","0","0","0","1","0","2","7","3","1","3","0","7","3","0","4","0","7","1","3","3","0","0","7"
"Bishopbriggs","GB","55.90669","-4.21869","1","0","0","0","0","0","0","1","0","0","1","0","1","0","0","1","0","1","0","0","1","0","0","1"
"Bishops Stortford","GB","51.87113","0.15868","10","0","0","0","3","0","3","16","5","4","5","0","14","5","3","8","0","16","0","4","12","0","0","16"
"Bishopton","GB","55.90969","-4.5056","1","0","0","0","0","0","0","1","0","1","0","0","1","0","1","0","0","1","1","0","0","0","0","1"
"Bishopton","GB","54.58333","-1.43333","1","0","0","0","0","0","0","1","0","1","0","0","1","0","1","0","0","1","1","0","0","0","0","1"
"Bitton","GB","51.42479","-2.45965","1","0","0","0","0","0","0","1","0","1","0","0","1","1","0","0","0","1","0","0","1","0","0","1"
"Blackburn","GB","55.86667","-3.63333","17","0","0","1","1","0","1","20","5","8","4","1","18","10","2","8","0","20","9","3","6","1","1","20"
"Blackburn","GB","53.75","-2.48333","17","0","0","1","1","0","1","20","5","8","4","1","18","10","2","8","0","20","9","3","6","1","1","20"
"Blackburn","GB","57.20376","-2.28842","17","0","0","1","1","0","1","20","5","8","4","1","18","10","2","8","0","20","9","3","6","1","1","20"
"Blackburn","GB","-37.81901","145.15326","17","0","0","1","1","0","1","20","5","8","4","1","18","10","2","8","0","20","9","3","6","1","1","20"
"Blackpool","GB","53.81667","-3.05","23","4","0","3","1","0","2","33","9","12","9","0","30","12","4","17","0","33","9","11","12","1","0","33"
"Blackridge","GB","55.88523","-3.77479","1","0","0","0","0","0","0","1","0","1","0","0","1","0","1","0","0","1","1","0","0","0","0","1"
"Blackwood","GB","39.80234","-75.06406","13","0","0","0","1","0","0","14","2","8","3","1","14","3","4","7","0","14","4","2","7","0","1","14"
"Blackwood","GB","53.29308","-6.81843","13","0","0","0","1","0","0","14","2","8","3","1","14","3","4","7","0","14","4","2","7","0","1","14"
"Blackwood","GB","55.66667","-3.91667","13","0","0","0","1","0","0","14","2","8","3","1","14","3","4","7","0","14","4","2","7","0","1","14"
"Blackwood","GB","51.66778","-3.2075","13","0","0","0","1","0","0","14","2","8","3","1","14","3","4","7","0","14","4","2","7","0","1","14"
"Blackwood","GB","-35.02139","138.61429","13","0","0","0","1","0","0","14","2","8","3","1","14","3","4","7","0","14","4","2","7","0","1","14"
"Blandford Forum","GB","50.86073","-2.16174","2","0","0","0","1","0","0","3","1","0","1","0","2","0","0","3","0","3","0","2","1","0","0","3"
"Blantyre","GB","55.79634","-4.09485","1","0","0","0","0","0","1","2","1","0","1","0","2","0","1","1","0","2","0","0","2","0","0","2"
"Blantyre","GB","-15.78499","35.00854","1","0","0","0","0","0","1","2","1","0","1","0","2","0","1","1","0","2","0","0","2","0","0","2"
"Blaydon-on-Tyne","GB","54.96461","-1.71392","4","0","0","0","1","0","0","5","1","2","2","0","5","1","0","4","0","5","1","1","3","0","0","5"
"Blewbury","GB","51.5688","-1.23261","1","0","0","0","0","0","0","1","0","0","1","0","1","0","0","1","0","1","0","0","1","0","0","1"
"Blidworth","GB","53.09849","-1.11689","1","0","0","0","0","0","0","1","0","0","1","0","1","1","0","0","0","1","0","1","0","0","0","1"
"Blyth","GB","55.12708","-1.50856","25","1","0","0","5","0","0","31","5","6","7","0","18","8","3","20","0","31","10","7","11","1","2","31"
"Bodmin","GB","50.47151","-4.7243","2","0","0","0","2","0","0","4","4","0","0","0","4","1","0","3","0","4","0","3","1","0","0","4"
"Bognor Regis","GB","50.78206","-0.67978","10","0","0","0","1","0","1","12","1","7","3","0","11","2","3","7","0","12","5","1","4","1","1","12"
"Bollington","GB","53.29446","-2.10963","2","0","0","0","0","0","0","2","0","0","2","0","2","1","0","1","0","2","0","2","0","0","0","2"
"Bolney","GB","50.99534","-0.20303","1","0","0","0","0","0","0","1","0","0","0","0","0","0","0","1","0","1","0","0","1","0","0","1"
"Bolton","GB","32.34931","-90.4601","28","4","0","1","4","0","2","39","8","9","19","0","36","15","4","20","0","39","5","9","25","0","0","39"
"Bolton","GB","34.32072","-78.40195","28","4","0","1","4","0","2","39","8","9","19","0","36","15","4","20","0","39","5","9","25","0","0","39"
"Bolton","GB","42.43343","-71.60784","28","4","0","1","4","0","2","39","8","9","19","0","36","15","4","20","0","39","5","9","25","0","0","39"
"Bolton","GB","53.58333","-2.43333","28","4","0","1","4","0","2","39","8","9","19","0","36","15","4","20","0","39","5","9","25","0","0","39"
"Bolton le Sands","GB","54.09632","-2.80017","1","0","0","0","0","0","0","1","0","0","0","0","0","0","0","0","0","0","0","1","0","0","0","1"
"Bonnybridge","GB","56.00152","-3.8886","2","0","0","0","0","0","0","2","0","0","2","0","2","0","0","2","0","2","0","0","2","0","0","2"
"Bootle","GB","53.46667","-3.01667","1","0","0","1","0","0","0","2","1","1","0","0","2","1","1","0","0","2","1","0","1","0","0","2"
"Bordon","GB","51.11357","-0.86245","4","0","0","0","0","0","0","4","1","0","3","0","4","3","0","1","0","4","0","0","4","0","0","4"
"Borehamwood","GB","51.65468","-0.27762","8","0","0","1","1","0","0","10","2","5","1","0","8","3","1","6","0","10","2","2","6","0","0","10"
"Borough Green","GB","51.29158","0.30478","1","0","0","0","0","0","0","1","0","1","0","0","1","1","0","0","0","1","0","1","0","0","0","1"
"Bosham","GB","50.83088","-0.85384","1","0","0","0","0","0","0","1","1","0","0","0","1","0","1","0","0","1","0","0","1","0","0","1"
"Boston","GB","30.79186","-83.78989","5","0","0","0","0","0","0","5","0","2","2","0","4","3","1","1","0","5","2","3","0","0","0","5"
"Boston","GB","40.31201","-79.8231","5","0","0","0","0","0","0","5","0","2","2","0","4","3","1","1","0","5","2","3","0","0","0","5"
"Boston","GB","42.62895","-78.73753","5","0","0","0","0","0","0","5","0","2","2","0","4","3","1","1","0","5","2","3","0","0","0","5"
"Boston","GB","37.6093","-75.84271","5","0","0","0","0","0","0","5","0","2","2","0","4","3","1","1","0","5","2","3","0","0","0","5"
"Boston","GB","42.35843","-71.05977","5","0","0","0","0","0","0","5","0","2","2","0","4","3","1","1","0","5","2","3","0","0","0","5"
"Boston","GB","53.03083","-8.93167","5","0","0","0","0","0","0","5","0","2","2","0","4","3","1","1","0","5","2","3","0","0","0","5"
"Boston","GB","52.97633","-0.02664","5","0","0","0","0","0","0","5","0","2","2","0","4","3","1","1","0","5","2","3","0","0","0","5"
"Boston","GB","7.87111","126.36417","5","0","0","0","0","0","0","5","0","2","2","0","4","3","1","1","0","5","2","3","0","0","0","5"
"Boughton","GB","53.2","-0.98333","1","0","0","0","0","0","0","1","1","0","0","0","1","0","0","0","1","1","0","1","0","0","0","1"
"Bourne","GB","41.74122","-70.59892","5","0","0","0","0","0","0","5","0","1","2","0","3","2","0","3","0","5","2","1","2","0","0","5"
"Bourne","GB","52.76667","-0.38333","5","0","0","0","0","0","0","5","0","1","2","0","3","2","0","3","0","5","2","1","2","0","0","5"
"Bourne End","GB","51.57622","-0.71291","2","0","0","0","0","1","0","3","1","0","0","0","1","1","1","1","0","3","0","0","3","0","0","3"
"Bournemouth","GB","50.72048","-1.8795","35","2","0","0","6","0","1","44","8","14","18","1","41","14","8","21","1","44","8","8","24","1","3","44"
"Bourton on the Water","GB","51.88584","-1.75492","0","0","0","0","1","0","0","1","0","0","1","0","1","1","0","0","0","1","0","0","1","0","0","1"
"Bovingdon","GB","51.72312","-0.5367","1","0","0","0","0","0","0","1","0","1","0","0","1","1","0","0","0","1","0","0","1","0","0","1"
"Bowmore","GB","55.75583","-6.28426","1","0","0","0","0","0","0","1","0","1","0","0","1","0","0","1","0","1","0","0","0","0","1","1"
"Box","GB","51.41472","-2.24556","1","0","0","0","0","0","0","1","0","0","1","0","1","0","0","1","0","1","0","0","1","0","0","1"
"Brackley","GB","52.03333","-1.15","6","0","0","0","1","0","0","7","1","1","3","0","5","1","1","5","0","7","1","2","4","0","0","7"
"Bracknell","GB","51.41363","-0.75054","43","0","0","0","1","0","3","47","8","9","20","0","37","19","3","25","0","47","7","12","27","0","1","47"
"Bradford","GB","35.42314","-91.45596","38","2","0","3","2","0","5","50","15","6","19","0","40","16","8","26","0","50","3","10","36","0","1","50"
"Bradford","GB","41.17726","-89.6576","38","2","0","3","2","0","5","50","15","6","19","0","40","16","8","26","0","50","3","10","36","0","1","50"
"Bradford","GB","36.07645","-88.81006","38","2","0","3","2","0","5","50","15","6","19","0","40","16","8","26","0","50","3","10","36","0","1","50"
"Bradford","GB","40.13227","-84.43078","38","2","0","3","2","0","5","50","15","6","19","0","40","16","8","26","0","50","3","10","36","0","1","50"
"Bradford","GB","41.9559","-78.64392","38","2","0","3","2","0","5","50","15","6","19","0","40","16","8","26","0","50","3","10","36","0","1","50"
"Bradford","GB","43.99257","-72.12898","38","2","0","3","2","0","5","50","15","6","19","0","40","16","8","26","0","50","3","10","36","0","1","50"
"Bradford","GB","41.39899","-71.73701","38","2","0","3","2","0","5","50","15","6","19","0","40","16","8","26","0","50","3","10","36","0","1","50"
"Bradford","GB","45.06673","-68.93781","38","2","0","3","2","0","5","50","15","6","19","0","40","16","8","26","0","50","3","10","36","0","1","50"
"Bradford","GB","53.79391","-1.75206","38","2","0","3","2","0","5","50","15","6","19","0","40","16","8","26","0","50","3","10","36","0","1","50"
"Bradford Abbas","GB","50.92643","-2.58751","2","0","0","0","0","0","0","2","1","0","1","0","2","1","1","0","0","2","0","0","2","0","0","2"
"Bradford-on-Avon","GB","51.34772","-2.25065","3","0","0","0","0","0","0","3","0","1","1","0","2","1","2","0","0","3","0","1","2","0","0","3"
"Braintree","GB","42.20384","-71.00215","9","1","0","0","1","0","0","11","1","5","3","0","9","5","1","5","0","11","6","1","4","0","0","11"
"Braintree","GB","51.87819","0.55292","9","1","0","0","1","0","0","11","1","5","3","0","9","5","1","5","0","11","6","1","4","0","0","11"
"Bramhall","GB","53.35801","-2.16539","1","0","0","1","1","0","0","3","1","1","1","0","3","2","0","1","0","3","0","1","2","0","0","3"
"Bramhope","GB","53.88489","-1.61641","0","0","0","1","0","0","0","1","0","0","1","0","1","0","0","1","0","1","0","0","1","0","0","1"
"Bramley","GB","53.41667","-1.26667","1","0","0","0","0","0","0","1","0","1","0","0","1","1","0","0","0","1","1","0","0","0","0","1"
"Bramley","GB","51.32677","-1.05938","1","0","0","0","0","0","0","1","0","1","0","0","1","1","0","0","0","1","1","0","0","0","0","1"
"Bramley","GB","51.19451","-0.55927","1","0","0","0","0","0","0","1","0","1","0","0","1","1","0","0","0","1","1","0","0","0","0","1"
"Brandon","GB","49.84692","-99.95306","1","0","0","0","0","0","0","1","0","0","1","0","1","0","0","1","0","1","0","1","0","0","0","1"
"Brandon","GB","43.5947","-96.57199","1","0","0","0","0","0","0","1","0","0","1","0","1","0","0","1","0","1","0","1","0","0","0","1"
"Brandon","GB","32.2732","-89.98592","1","0","0","0","0","0","0","1","0","0","1","0","1","0","0","1","0","1","0","1","0","0","0","1"
"Brandon","GB","43.73526","-88.78122","1","0","0","0","0","0","0","1","0","0","1","0","1","0","0","1","0","1","0","1","0","0","0","1"
"Brandon","GB","27.9378","-82.28592","1","0","0","0","0","0","0","1","0","0","1","0","1","0","0","1","0","1","0","1","0","0","0","1"
"Brandon","GB","43.79812","-73.08761","1","0","0","0","0","0","0","1","0","0","1","0","1","0","0","1","0","1","0","1","0","0","0","1"
"Brandon","GB","54.75","-1.61667","1","0","0","0","0","0","0","1","0","0","1","0","1","0","0","1","0","1","0","1","0","0","0","1"
"Brandon","GB","52.38432","-1.3996","1","0","0","0","0","0","0","1","0","0","1","0","1","0","0","1","0","1","0","1","0","0","0","1"
"Brandon","GB","-19.55389","147.35304","1","0","0","0","0","0","0","1","0","0","1","0","1","0","0","1","0","1","0","1","0","0","0","1"
"Braunston","GB","52.28979","-1.20266","1","0","0","0","0","0","0","1","0","0","1","0","1","0","0","1","0","1","0","0","1","0","0","1"
"Braunton","GB","51.10847","-4.16131","1","0","0","0","0","0","0","1","0","1","0","0","1","0","0","1","0","1","0","0","1","0","0","1"
"Brechin","GB","56.72993","-2.65729","3","0","0","0","0","0","0","3","1","2","0","0","3","1","0","2","0","3","0","0","2","0","1","3"
"Brecon","GB","51.94612","-3.38887","6","0","0","0","2","0","0","8","1","2","4","0","7","2","1","5","0","8","1","4","3","0","0","8"
"Bredon","GB","52.03008","-2.11671","1","0","0","0","0","0","0","1","0","1","0","0","1","1","0","0","0","1","1","0","0","0","0","1"
"Brent","GB","35.36787","-94.79356","1","0","0","0","0","0","0","1","0","1","0","0","1","0","0","1","0","1","0","0","0","1","0","1"
"Brent","GB","30.46881","-87.23608","1","0","0","0","0","0","0","1","0","1","0","0","1","0","0","1","0","1","0","0","0","1","0","1"
"Brent","GB","32.93735","-87.16472","1","0","0","0","0","0","0","1","0","1","0","0","1","0","0","1","0","1","0","0","0","1","0","1"
"Brent","GB","51.55306","-0.3023","1","0","0","0","0","0","0","1","0","1","0","0","1","0","0","1","0","1","0","0","0","1","0","1"
"Brent Knoll","GB","51.25219","-2.95744","1","0","0","0","0","0","0","1","0","0","1","0","1","1","0","0","0","1","0","0","1","0","0","1"
"Brentwood","GB","37.93187","-121.69579","12","3","0","2","0","0","2","19","4","3","11","0","18","10","1","8","0","19","1","3","13","2","0","19"
"Brentwood","GB","38.61755","-90.34928","12","3","0","2","0","0","2","19","4","3","11","0","18","10","1","8","0","19","1","3","13","2","0","19"
"Brentwood","GB","36.03312","-86.78278","12","3","0","2","0","0","2","19","4","3","11","0","18","10","1","8","0","19","1","3","13","2","0","19"
"Brentwood","GB","40.37063","-79.97477","12","3","0","2","0","0","2","19","4","3","11","0","18","10","1","8","0","19","1","3","13","2","0","19"
"Brentwood","GB","38.94317","-76.95664","12","3","0","2","0","0","2","19","4","3","11","0","18","10","1","8","0","19","1","3","13","2","0","19"
"Brentwood","GB","40.78121","-73.24623","12","3","0","2","0","0","2","19","4","3","11","0","18","10","1","8","0","19","1","3","13","2","0","19"
"Brentwood","GB","42.9787","-71.07284","12","3","0","2","0","0","2","19","4","3","11","0","18","10","1","8","0","19","1","3","13","2","0","19"
"Brentwood","GB","51.62127","0.30556","12","3","0","2","0","0","2","19","4","3","11","0","18","10","1","8","0","19","1","3","13","2","0","19"
"Brentwood","GB","-32.04347","115.85246","12","3","0","2","0","0","2","19","4","3","11","0","18","10","1","8","0","19","1","3","13","2","0","19"
"Bridgend","GB","51.50583","-3.57722","30","0","0","1","4","0","1","36","6","14","14","0","34","15","5","16","0","36","7","12","16","0","1","36"
"Bridgend","GB","55.96366","-3.53592","30","0","0","1","4","0","1","36","6","14","14","0","34","15","5","16","0","36","7","12","16","0","1","36"
"Bridgend","GB","57.4","-2.81667","30","0","0","1","4","0","1","36","6","14","14","0","34","15","5","16","0","36","7","12","16","0","1","36"
"Bridgnorth","GB","52.53661","-2.42033","1","0","0","0","0","0","0","1","0","0","1","0","1","1","0","0","0","1","0","1","0","0","0","1"
"Bridgwater","GB","51.12837","-3.00356","7","0","0","0","0","0","0","7","0","3","3","0","6","2","0","5","0","7","1","1","4","0","1","7"
"Bridlington","GB","54.08306","-0.19192","6","3","0","0","0","0","0","9","0","4","5","0","9","3","1","5","0","9","1","6","2","0","0","9"
"Bridport","GB","43.98506","-73.31262","6","0","0","0","0","0","0","6","0","0","2","0","2","2","1","3","0","6","1","2","3","0","0","6"
"Bridport","GB","50.7338","-2.75831","6","0","0","0","0","0","0","6","0","0","2","0","2","2","1","3","0","6","1","2","3","0","0","6"
"Bridport","GB","-41.00046","147.39175","6","0","0","0","0","0","0","6","0","0","2","0","2","2","1","3","0","6","1","2","3","0","0","6"
"Brierfield","GB","53.82468","-2.23415","1","0","0","0","0","0","1","2","1","0","1","0","2","1","0","1","0","2","0","1","1","0","0","2"
"Brierley Hill","GB","52.48173","-2.12139","6","0","0","1","0","0","0","7","2","1","4","0","7","1","1","5","0","7","2","1","4","0","0","7"
"Brigg","GB","53.55201","-0.49214","1","0","0","0","0","0","0","1","0","1","0","0","1","0","1","0","0","1","0","0","1","0","0","1"
"Brighouse","GB","53.70322","-1.78428","4","1","0","0","1","0","0","6","3","1","1","0","5","2","1","3","0","6","1","0","5","0","0","6"
"Brightlingsea","GB","51.81164","1.02336","2","0","0","0","0","0","0","2","0","0","1","0","1","1","0","1","0","2","0","1","1","0","0","2"
"Brighton","GB","39.98526","-104.82053","55","1","0","2","1","0","5","64","7","18","13","2","40","24","8","32","0","64","12","9","31","2","9","63"
"Brighton","GB","41.17474","-91.81961","55","1","0","2","1","0","5","64","7","18","13","2","40","24","8","32","0","64","12","9","31","2","9","63"
"Brighton","GB","39.03977","-90.14066","55","1","0","2","1","0","5","64","7","18","13","2","40","24","8","32","0","64","12","9","31","2","9","63"
"Brighton","GB","35.48397","-89.72508","55","1","0","2","1","0","5","64","7","18","13","2","40","24","8","32","0","64","12","9","31","2","9","63"
"Brighton","GB","33.43428","-86.94721","55","1","0","2","1","0","5","64","7","18","13","2","40","24","8","32","0","64","12","9","31","2","9","63"
"Brighton","GB","35.08009","-86.43916","55","1","0","2","1","0","5","64","7","18","13","2","40","24","8","32","0","64","12","9","31","2","9","63"
"Brighton","GB","42.52948","-83.78022","55","1","0","2","1","0","5","64","7","18","13","2","40","24","8","32","0","64","12","9","31","2","9","63"
"Brighton","GB","43.14756","-77.55055","55","1","0","2","1","0","5","64","7","18","13","2","40","24","8","32","0","64","12","9","31","2","9","63"
"Brighton","GB","50.82838","-0.13947","55","1","0","2","1","0","5","64","7","18","13","2","40","24","8","32","0","64","12","9","31","2","9","63"
"Brighton","GB","-35.0182","138.52351","55","1","0","2","1","0","5","64","7","18","13","2","40","24","8","32","0","64","12","9","31","2","9","63"
"Brighton","GB","-37.90561","145.00279","55","1","0","2","1","0","5","64","7","18","13","2","40","24","8","32","0","64","12","9","31","2","9","63"
"Brighton","GB","-42.69814","147.24489","55","1","0","2","1","0","5","64","7","18","13","2","40","24","8","32","0","64","12","9","31","2","9","63"
"Brighton","GB","-27.29582","153.05721","55","1","0","2","1","0","5","64","7","18","13","2","40","24","8","32","0","64","12","9","31","2","9","63"
"Bristol","GB","32.46153","-96.56999","164","7","0","9","20","0","18","218","39","55","86","3","183","76","27","113","1","217","26","34","145","3","9","217"
"Bristol","GB","42.55891","-88.04925","164","7","0","9","20","0","18","218","39","55","86","3","183","76","27","113","1","217","26","34","145","3","9","217"
"Bristol","GB","41.72144","-85.81749","164","7","0","9","20","0","18","218","39","55","86","3","183","76","27","113","1","217","26","34","145","3","9","217"
"Bristol","GB","30.43247","-84.97702","164","7","0","9","20","0","18","218","39","55","86","3","183","76","27","113","1","217","26","34","145","3","9","217"
"Bristol","GB","36.59511","-82.18874","164","7","0","9","20","0","18","218","39","55","86","3","183","76","27","113","1","217","26","34","145","3","9","217"
"Bristol","GB","36.59649","-82.18847","164","7","0","9","20","0","18","218","39","55","86","3","183","76","27","113","1","217","26","34","145","3","9","217"
"Bristol","GB","40.10067","-74.85183","164","7","0","9","20","0","18","218","39","55","86","3","183","76","27","113","1","217","26","34","145","3","9","217"
"Bristol","GB","44.13339","-73.07901","164","7","0","9","20","0","18","218","39","55","86","3","183","76","27","113","1","217","26","34","145","3","9","217"
"Bristol","GB","41.67176","-72.94927","164","7","0","9","20","0","18","218","39","55","86","3","183","76","27","113","1","217","26","34","145","3","9","217"
"Bristol","GB","43.59119","-71.73675","164","7","0","9","20","0","18","218","39","55","86","3","183","76","27","113","1","217","26","34","145","3","9","217"
"Bristol","GB","41.67705","-71.26616","164","7","0","9","20","0","18","218","39","55","86","3","183","76","27","113","1","217","26","34","145","3","9","217"
"Bristol","GB","43.95758","-69.50921","164","7","0","9","20","0","18","218","39","55","86","3","183","76","27","113","1","217","26","34","145","3","9","217"
"Bristol","GB","51.45523","-2.59665","164","7","0","9","20","0","18","218","39","55","86","3","183","76","27","113","1","217","26","34","145","3","9","217"
"Briston","GB","52.85369","1.05899","1","0","0","0","0","0","0","1","1","0","0","0","1","1","0","0","0","1","0","1","0","0","0","1"
"Brixham","GB","50.39431","-3.51585","3","0","0","0","0","0","0","3","0","0","2","0","2","0","0","3","0","3","0","0","3","0","0","3"
"Broad Haven","GB","51.78025","-5.10258","1","0","0","0","0","0","0","1","0","0","0","0","0","0","1","0","0","1","0","0","1","0","0","1"
"Broadstairs","GB","51.35908","1.43938","4","0","0","0","1","0","0","5","0","2","3","0","5","2","0","3","0","5","0","2","3","0","0","5"
"Broadstone","GB","50.75717","-1.99406","1","0","0","0","0","0","0","1","0","0","1","0","1","0","0","1","0","1","0","1","0","0","0","1"
"Broadway","GB","35.45793","-79.05308","1","0","0","0","0","0","1","2","1","1","0","0","2","1","0","1","0","2","0","1","1","0","0","2"
"Broadway","GB","38.61317","-78.79891","1","0","0","0","0","0","1","2","1","1","0","0","2","1","0","1","0","2","0","1","1","0","0","2"
"Broadway","GB","52.03825","-1.86079","1","0","0","0","0","0","1","2","1","1","0","0","2","1","0","1","0","2","0","1","1","0","0","2"
"Bromborough","GB","53.3485","-2.97935","3","0","0","0","0","0","0","3","0","1","1","0","2","1","0","1","0","2","2","0","1","0","0","3"
"Bromley","GB","38.64062","-84.84828","22","0","0","0","2","0","4","28","5","9","9","0","23","10","3","15","0","28","3","8","16","1","0","28"
"Bromley","GB","39.082","-84.56022","22","0","0","0","2","0","4","28","5","9","9","0","23","10","3","15","0","28","3","8","16","1","0","28"
"Bromley","GB","51.40606","0.01519","22","0","0","0","2","0","4","28","5","9","9","0","23","10","3","15","0","28","3","8","16","1","0","28"
"Bromsgrove","GB","52.33574","-2.05983","8","3","0","0","1","0","1","13","4","3","3","0","10","9","1","3","0","13","2","6","5","0","0","13"
"Brough","GB","53.72861","-0.57215","4","1","0","0","0","0","0","5","1","1","3","0","5","2","0","3","0","5","0","0","5","0","0","5"
"Broughton","GB","53.16303","-2.99309","1","0","0","0","0","0","0","1","0","1","0","0","1","1","0","0","0","1","0","0","1","0","0","1"
"Broughton","GB","52.37331","-0.77493","1","0","0","0","0","0","0","1","0","1","0","0","1","1","0","0","0","1","0","0","1","0","0","1"
"Broughton","GB","52.05038","-0.69351","1","0","0","0","0","0","0","1","0","1","0","0","1","1","0","0","0","1","0","0","1","0","0","1"
"Broughton","GB","53.56667","-0.55","1","0","0","0","0","0","0","1","0","1","0","0","1","1","0","0","0","1","0","0","1","0","0","1"
"Broughton","GB","-20.11667","146.43333","1","0","0","0","0","0","0","1","0","1","0","0","1","1","0","0","0","1","0","0","1","0","0","1"
"Broughton Astley","GB","52.52787","-1.21768","1","0","0","0","0","0","0","1","0","1","0","0","1","1","0","0","0","1","1","0","0","0","0","1"
"Broxbourne","GB","51.74712","-0.01923","2","0","0","0","0","0","0","2","0","0","1","0","1","1","0","1","0","2","1","0","1","0","0","2"
"Broxburn","GB","55.93415","-3.47133","0","0","0","0","0","0","1","1","1","0","0","0","1","0","0","1","0","1","0","1","0","0","0","1"
"Bruton","GB","51.1125","-2.45278","1","0","0","0","0","0","0","1","0","1","0","0","1","0","0","1","0","1","0","0","1","0","0","1"
"Brynmawr","GB","51.8","-3.18333","1","0","0","0","0","0","0","1","0","0","1","0","1","0","0","1","0","1","0","0","1","0","0","1"
"Buckhurst Hill","GB","51.62409","0.03262","3","0","0","0","0","0","1","4","1","1","2","0","4","1","0","3","0","4","0","0","4","0","0","4"
"Buckingham","GB","26.67507","-81.73203","10","1","0","2","0","0","1","14","5","4","3","1","13","6","2","6","0","14","2","2","8","0","2","14"
"Buckingham","GB","37.55015","-78.55556","10","1","0","2","0","0","1","14","5","4","3","1","13","6","2","6","0","14","2","2","8","0","2","14"
"Buckingham","GB","45.58563","-75.4208","10","1","0","2","0","0","1","14","5","4","3","1","13","6","2","6","0","14","2","2","8","0","2","14"
"Buckingham","GB","51.99968","-0.98779","10","1","0","2","0","0","1","14","5","4","3","1","13","6","2","6","0","14","2","2","8","0","2","14"
"Buckley","GB","47.16316","-122.02678","2","0","0","0","2","0","0","4","1","1","1","0","3","1","0","3","0","4","1","3","0","0","0","4"
"Buckley","GB","40.59698","-88.0381","2","0","0","0","2","0","0","4","1","1","1","0","3","1","0","3","0","4","1","3","0","0","0","4"
"Buckley","GB","44.50445","-85.67701","2","0","0","0","2","0","0","4","1","1","1","0","3","1","0","3","0","4","1","3","0","0","0","4"
"Buckley","GB","53.16667","-3.08333","2","0","0","0","2","0","0","4","1","1","1","0","3","1","0","3","0","4","1","3","0","0","0","4"
"Bude","GB","31.46295","-90.8501","1","0","0","1","1","0","0","3","2","1","0","0","3","0","1","2","0","3","0","1","2","0","0","3"
"Bude","GB","50.82435","-4.5413","1","0","0","1","1","0","0","3","2","1","0","0","3","0","1","2","0","3","0","1","2","0","0","3"
"Budleigh Salterton","GB","50.62983","-3.32181","1","0","0","0","0","0","0","1","0","0","0","0","0","1","0","0","0","1","1","0","0","0","0","1"
"Builth Wells","GB","52.1494","-3.40469","2","0","0","0","2","0","0","4","0","0","4","0","4","0","0","4","0","4","0","1","3","0","0","4"
"Bulkington","GB","51.32361","-2.08361","1","0","0","0","0","0","0","1","0","0","1","0","1","0","0","1","0","1","0","0","1","0","0","1"
"Bungay","GB","52.45434","1.43818","2","0","0","0","0","0","0","2","0","0","1","0","1","1","0","1","0","2","0","0","2","0","0","2"
"Buntingford","GB","51.94612","-0.01841","1","0","0","0","0","0","0","1","0","0","0","0","0","0","1","0","0","1","0","1","0","0","0","1"
"Bures Saint Mary","GB","51.9724","0.77488","2","0","0","1","0","0","0","3","0","0","1","0","1","1","0","2","0","3","0","1","2","0","0","3"
"Burford","GB","43.10292","-80.42869","1","0","0","0","0","0","0","1","0","0","1","0","1","0","0","1","0","1","0","0","1","0","0","1"
"Burford","GB","51.80915","-1.63628","1","0","0","0","0","0","0","1","0","0","1","0","1","0","0","1","0","1","0","0","1","0","0","1"
"Burgess Hill","GB","50.95843","-0.13287","8","0","0","0","2","0","2","12","2","2","6","0","10","5","3","4","0","12","0","4","7","0","1","12"
"Burghead","GB","57.70113","-3.48992","1","0","0","0","0","0","0","1","0","1","0","0","1","0","0","1","0","1","0","1","0","0","0","1"
"Buriton","GB","50.97505","-0.94851","1","0","0","0","0","0","0","1","1","0","0","0","1","0","1","0","0","1","0","0","1","0","0","1"
"Burley in Wharfedale","GB","53.9102","-1.75798","1","0","0","0","0","0","0","1","0","0","0","0","0","0","0","1","0","1","0","1","0","0","0","1"
"Burnham-on-Crouch","GB","51.63272","0.81488","1","0","0","0","1","0","0","2","0","1","1","0","2","1","0","1","0","2","0","0","2","0","0","2"
"Burnham-on-Sea","GB","51.23862","-2.9978","1","0","0","0","0","0","0","1","0","0","1","0","1","0","0","1","0","1","0","0","1","0","0","1"
"Burnley","GB","53.8","-2.23333","21","0","0","0","4","0","2","27","3","11","11","0","25","9","5","13","0","27","6","10","10","0","1","27"
"Burnley","GB","-37.82959","145.01732","21","0","0","0","4","0","2","27","3","11","11","0","25","9","5","13","0","27","6","10","10","0","1","27"
"Burntisland","GB","56.05865","-3.23664","4","0","0","0","0","0","0","4","1","0","3","0","4","2","0","2","0","4","0","3","1","0","0","4"
"Burntwood","GB","52.68075","-1.92759","6","1","0","0","0","0","0","7","1","3","2","0","6","4","2","1","0","7","5","0","2","0","0","7"
"Burry Port","GB","51.68435","-4.24687","3","0","0","1","1","0","0","5","2","2","1","0","5","1","2","2","0","5","2","1","2","0","0","5"
"Burscough","GB","53.5964","-2.83972","0","1","0","0","1","0","0","2","0","0","1","0","1","1","1","0","0","2","0","1","1","0","0","2"
"Bursledon","GB","50.88658","-1.31596","1","0","0","0","0","0","0","1","0","0","1","0","1","1","0","0","0","1","0","0","1","0","0","1"
"Burton","GB","42.99947","-83.61634","7","0","0","1","2","0","1","11","4","2","3","0","9","4","1","6","0","11","2","4","5","0","0","11"
"Burton","GB","41.47061","-81.1451","7","0","0","1","2","0","1","11","4","2","3","0","9","4","1","6","0","11","2","4","5","0","0","11"
"Burton","GB","32.43575","-80.724","7","0","0","1","2","0","1","11","4","2","3","0","9","4","1","6","0","11","2","4","5","0","0","11"
"Burton","GB","51.71556","-4.92222","7","0","0","1","2","0","1","11","4","2","3","0","9","4","1","6","0","11","2","4","5","0","0","11"
"Burton","GB","53.25954","-3.02549","7","0","0","1","2","0","1","11","4","2","3","0","9","4","1","6","0","11","2","4","5","0","0","11"
"Burton","GB","53.26667","-0.56667","7","0","0","1","2","0","1","11","4","2","3","0","9","4","1","6","0","11","2","4","5","0","0","11"
"Burton","GB","-34.73339","138.60247","7","0","0","1","2","0","1","11","4","2","3","0","9","4","1","6","0","11","2","4","5","0","0","11"
"Burton Latimer","GB","52.36368","-0.67853","1","0","0","0","0","0","0","1","0","0","1","0","1","0","1","0","0","1","0","0","1","0","0","1"
"Burton Leonard","GB","54.0691","-1.50116","0","0","0","0","1","0","0","1","0","0","1","0","1","0","0","1","0","1","0","1","0","0","0","1"
"Burton upon Trent","GB","52.80728","-1.64263","8","1","0","2","1","0","0","12","3","1","4","0","8","2","3","7","0","12","3","2","7","0","0","12"
"Burwell","GB","41.78167","-99.13315","2","0","0","0","0","0","0","2","0","1","1","0","2","0","1","1","0","2","0","1","1","0","0","2"
"Burwell","GB","53.29305","0.03463","2","0","0","0","0","0","0","2","0","1","1","0","2","0","1","1","0","2","0","1","1","0","0","2"
"Burwell","GB","52.27632","0.32732","2","0","0","0","0","0","0","2","0","1","1","0","2","0","1","1","0","2","0","1","1","0","0","2"
"Bury","GB","53.6","-2.3","12","0","0","0","2","0","1","15","1","3","5","0","9","7","0","8","0","15","5","1","9","0","0","15"
"Bury","GB","49.31307","2.34401","12","0","0","0","2","0","1","15","1","3","5","0","9","7","0","8","0","15","5","1","9","0","0","15"
"Bury St Edmunds","GB","52.2463","0.71111","16","0","0","0","1","0","0","17","1","5","9","0","15","4","3","10","0","17","3","4","10","0","0","17"
"Bushey","GB","51.64316","-0.36053","8","0","0","0","0","0","1","9","3","0","1","0","4","4","1","4","0","9","1","2","6","0","0","9"
"Buxton","GB","35.26768","-75.54237","7","0","0","1","1","0","1","10","1","1","6","0","8","3","0","6","1","10","0","2","7","0","1","10"
"Buxton","GB","43.63786","-70.51894","7","0","0","1","1","0","1","10","1","1","6","0","8","3","0","6","1","10","0","2","7","0","1","10"
"Buxton","GB","53.25741","-1.90982","7","0","0","1","1","0","1","10","1","1","6","0","8","3","0","6","1","10","0","2","7","0","1","10"
"Buxton","GB","52.75255","1.29982","7","0","0","1","1","0","1","10","1","1","6","0","8","3","0","6","1","10","0","2","7","0","1","10"
"Buxton","GB","-34.26017","150.53288","7","0","0","1","1","0","1","10","1","1","6","0","8","3","0","6","1","10","0","2","7","0","1","10"
"Byfleet","GB","51.34018","-0.47254","2","0","0","0","1","0","0","3","0","1","2","0","3","0","1","1","1","3","1","1","1","0","0","3"
"Caddington","GB","51.86621","-0.45679","2","0","0","0","0","0","0","2","0","0","2","0","2","0","0","2","0","2","0","1","1","0","0","2"
"Caerleon","GB","51.60952","-2.95378","0","0","0","1","0","0","0","1","1","0","0","0","1","0","0","1","0","1","0","1","0","0","0","1"
"Caernarfon","GB","53.14126","-4.27016","6","1","0","0","2","0","0","9","1","4","2","1","8","2","4","3","0","9","2","3","3","0","1","9"
"Caerphilly","GB","51.57452","-3.218","30","0","0","0","2","0","1","33","5","18","9","0","32","17","3","13","0","33","13","3","17","0","0","33"
"Caersws","GB","52.51634","-3.42948","1","0","0","0","0","0","0","1","0","0","1","0","1","0","0","1","0","1","0","1","0","0","0","1"
"Caldercruix","GB","55.88886","-3.88664","2","0","0","0","0","0","0","2","0","1","1","0","2","1","0","1","0","2","0","0","2","0","0","2"
"Caldicot","GB","51.58661","-2.75736","5","0","0","0","0","0","1","6","0","3","3","0","6","0","1","5","0","6","1","3","2","0","0","6"
"Callington","GB","50.50147","-4.31314","0","1","0","0","0","0","0","1","0","1","0","0","1","1","0","0","0","1","0","1","0","0","0","1"
"Callington","GB","-35.11977","139.0414","0","1","0","0","0","0","0","1","0","1","0","0","1","1","0","0","0","1","0","1","0","0","0","1"
"Calne","GB","51.43879","-2.00571","4","0","0","0","0","0","0","4","0","3","0","0","3","2","0","2","0","4","1","0","3","0","0","4"
"Camberley","GB","51.33705","-0.74261","18","0","0","1","3","0","0","22","7","5","9","0","21","5","3","14","0","22","4","8","9","0","1","22"
"Camborne","GB","50.21306","-5.29731","2","0","0","0","0","0","0","2","0","0","1","0","1","0","0","2","0","2","1","1","0","0","0","2"
"Cambourne","GB","52.22115","-0.07025","1","0","0","0","0","0","0","1","0","1","0","0","1","1","0","0","0","1","1","0","0","0","0","1"
"Cambridge","GB","40.28195","-100.16569","66","2","0","4","4","0","8","84","15","17","33","2","67","27","15","42","1","85","6","13","60","1","4","84"
"Cambridge","GB","41.89832","-93.5291","66","2","0","4","4","0","8","84","15","17","33","2","67","27","15","42","1","85","6","13","60","1","4","84"
"Cambridge","GB","45.57274","-93.22439","66","2","0","4","4","0","8","84","15","17","33","2","67","27","15","42","1","85","6","13","60","1","4","84"
"Cambridge","GB","41.30365","-90.1929","66","2","0","4","4","0","8","84","15","17","33","2","67","27","15","42","1","85","6","13","60","1","4","84"
"Cambridge","GB","43.00361","-89.0165","66","2","0","4","4","0","8","84","15","17","33","2","67","27","15","42","1","85","6","13","60","1","4","84"
"Cambridge","GB","40.03118","-81.58846","66","2","0","4","4","0","8","84","15","17","33","2","67","27","15","42","1","85","6","13","60","1","4","84"
"Cambridge","GB","43.3601","-80.31269","66","2","0","4","4","0","8","84","15","17","33","2","67","27","15","42","1","85","6","13","60","1","4","84"
"Cambridge","GB","18.31326","-77.90252","66","2","0","4","4","0","8","84","15","17","33","2","67","27","15","42","1","85","6","13","60","1","4","84"
"Cambridge","GB","38.56317","-76.07883","66","2","0","4","4","0","8","84","15","17","33","2","67","27","15","42","1","85","6","13","60","1","4","84"
"Cambridge","GB","43.02813","-73.38122","66","2","0","4","4","0","8","84","15","17","33","2","67","27","15","42","1","85","6","13","60","1","4","84"
"Cambridge","GB","42.3751","-71.10561","66","2","0","4","4","0","8","84","15","17","33","2","67","27","15","42","1","85","6","13","60","1","4","84"
"Cambridge","GB","45.02422","-69.47394","66","2","0","4","4","0","8","84","15","17","33","2","67","27","15","42","1","85","6","13","60","1","4","84"
"Cambridge","GB","52.2","0.11667","66","2","0","4","4","0","8","84","15","17","33","2","67","27","15","42","1","85","6","13","60","1","4","84"
"Cambridge","GB","-42.83333","147.45","66","2","0","4","4","0","8","84","15","17","33","2","67","27","15","42","1","85","6","13","60","1","4","84"
"Cambridge","GB","-37.87822","175.4402","66","2","0","4","4","0","8","84","15","17","33","2","67","27","15","42","1","85","6","13","60","1","4","84"
"Cambuslang","GB","55.80966","-4.16096","2","0","0","0","0","0","0","2","1","1","0","0","2","0","1","1","0","2","1","1","0","0","0","2"
"Camden Town","GB","51.54057","-0.14334","3","0","0","0","0","0","0","3","1","0","0","0","1","1","0","2","0","3","0","1","2","0","0","3"
"Camelford","GB","50.62185","-4.67963","2","0","0","0","0","0","0","2","0","1","1","0","2","1","0","1","0","2","0","2","0","0","0","2"
"Canewdon","GB","51.61759","0.74458","1","0","0","0","0","0","0","1","0","1","0","0","1","1","0","0","0","1","0","0","1","0","0","1"
"Cannock","GB","52.69045","-2.03085","10","4","0","0","0","0","2","16","6","5","3","1","15","4","3","9","0","16","4","5","7","0","0","16"
"Canterbury","GB","43.33702","-71.56535","13","2","1","0","2","0","2","20","4","3","10","0","17","3","4","12","1","20","2","4","14","0","0","20"
"Canterbury","GB","51.27904","1.07992","13","2","1","0","2","0","2","20","4","3","10","0","17","3","4","12","1","20","2","4","14","0","0","20"
"Canterbury","GB","-37.8247","145.08476","13","2","1","0","2","0","2","20","4","3","10","0","17","3","4","12","1","20","2","4","14","0","0","20"
"Canterbury","GB","-33.91192","151.11862","13","2","1","0","2","0","2","20","4","3","10","0","17","3","4","12","1","20","2","4","14","0","0","20"
"Canvey Island","GB","51.52199","0.5809","1","0","0","2","0","0","0","3","2","0","0","0","2","1","0","2","0","3","1","0","2","0","0","3"
"Cardenden","GB","56.1431","-3.25687","1","0","0","0","0","0","0","1","0","0","1","0","1","0","0","1","0","1","0","0","1","0","0","1"
"Cardiff","GB","51.48","-3.18","197","6","1","8","14","0","17","243","49","79","101","2","231","76","28","137","1","242","53","55","127","0","6","241"
"Cardiff","GB","-32.94201","151.6544","197","6","1","8","14","0","17","243","49","79","101","2","231","76","28","137","1","242","53","55","127","0","6","241"
"Cardigan","GB","52.08373","-4.66228","4","0","0","0","1","0","0","5","1","2","2","0","5","1","1","3","0","5","2","2","1","0","0","5"
"Cardigan","GB","-37.53333","143.75","4","0","0","0","1","0","0","5","1","2","2","0","5","1","1","3","0","5","2","2","1","0","0","5"
"Carlisle","GB","35.50065","-95.02634","24","0","0","0","4","0","1","29","5","18","4","0","27","12","5","12","0","29","13","3","12","1","0","29"
"Carlisle","GB","41.50082","-93.49105","24","0","0","0","4","0","1","29","5","18","4","0","27","12","5","12","0","29","13","3","12","1","0","29"
"Carlisle","GB","34.78315","-91.74652","24","0","0","0","4","0","1","29","5","18","4","0","27","12","5","12","0","29","13","3","12","1","0","29"
"Carlisle","GB","38.96838","-87.40557","24","0","0","0","4","0","1","29","5","18","4","0","27","12","5","12","0","29","13","3","12","1","0","29"
"Carlisle","GB","39.582","-84.32022","24","0","0","0","4","0","1","29","5","18","4","0","27","12","5","12","0","29","13","3","12","1","0","29"
"Carlisle","GB","38.31202","-84.02743","24","0","0","0","4","0","1","29","5","18","4","0","27","12","5","12","0","29","13","3","12","1","0","29"
"Carlisle","GB","40.20148","-77.18887","24","0","0","0","4","0","1","29","5","18","4","0","27","12","5","12","0","29","13","3","12","1","0","29"
"Carlisle","GB","42.52926","-71.3495","24","0","0","0","4","0","1","29","5","18","4","0","27","12","5","12","0","29","13","3","12","1","0","29"
"Carlisle","GB","17.13226","-61.80356","24","0","0","0","4","0","1","29","5","18","4","0","27","12","5","12","0","29","13","3","12","1","0","29"
"Carlisle","GB","54.8951","-2.9382","24","0","0","0","4","0","1","29","5","18","4","0","27","12","5","12","0","29","13","3","12","1","0","29"
"Carlisle","GB","-31.97945","115.91808","24","0","0","0","4","0","1","29","5","18","4","0","27","12","5","12","0","29","13","3","12","1","0","29"
"Carmarthen","GB","51.85552","-4.30535","18","1","0","2","1","0","0","22","4","5","8","0","17","8","5","9","0","22","7","10","5","0","0","22"
"Carnforth","GB","54.13163","-2.76914","2","0","0","0","0","0","0","2","0","0","2","0","2","2","0","0","0","2","1","1","0","0","0","2"
"Carnoustie","GB","56.50263","-2.7053","0","0","0","0","1","0","0","1","0","0","1","0","1","0","0","1","0","1","0","1","0","0","0","1"
"Carnwath","GB","55.70036","-3.62579","1","0","0","0","0","0","0","1","0","0","0","0","0","1","0","0","0","1","0","0","1","0","0","1"
"Carshalton","GB","51.36829","-0.16755","8","0","0","0","0","0","0","8","1","3","4","0","8","3","2","3","0","8","1","2","5","0","0","8"
"Cartagena","GB","10.39972","-75.51444","1","0","0","0","0","0","0","1","0","0","1","0","1","0","0","1","0","1","0","0","1","0","0","1"
"Cartagena","GB","-33.55384","-71.60761","1","0","0","0","0","0","0","1","0","0","1","0","1","0","0","1","0","1","0","0","1","0","0","1"
"Cartagena","GB","37.60512","-0.98623","1","0","0","0","0","0","0","1","0","0","1","0","1","0","0","1","0","1","0","0","1","0","0","1"
"Cartagena","GB","9.8203","122.4004","1","0","0","0","0","0","0","1","0","0","1","0","1","0","0","1","0","1","0","0","1","0","0","1"
"Carterton","GB","51.75905","-1.59435","3","0","0","0","0","0","2","5","1","3","1","0","5","1","1","3","0","5","2","0","2","0","1","5"
"Castle Cary","GB","51.09","-2.51417","1","0","0","0","0","0","1","2","0","0","2","0","2","0","0","2","0","2","0","1","1","0","0","2"
"Castlederg","GB","54.70699","-7.59336","1","0","0","0","0","0","0","1","0","1","0","0","1","0","1","0","0","1","1","0","0","0","0","1"
"Castle Donington","GB","52.84291","-1.34188","1","0","0","0","0","0","0","1","0","1","0","0","1","0","0","1","0","1","1","0","0","0","0","1"
"Castle Douglas","GB","54.94095","-3.92784","1","0","0","0","0","0","0","1","0","1","0","0","1","1","0","0","0","1","0","1","0","0","0","1"
"Castleford","GB","53.72587","-1.36256","5","0","0","0","0","0","0","5","1","2","3","0","6","3","0","3","0","6","2","1","3","0","0","6"
"Caterham","GB","51.2823","-0.07889","7","1","0","1","2","0","0","11","2","4","4","0","10","3","1","6","1","11","2","3","6","0","0","11"
"Catford","GB","51.44491","-0.02043","1","0","0","0","0","0","0","1","0","0","0","0","0","0","1","0","0","1","0","0","0","0","1","1"
"Catterick","GB","54.37542","-1.63328","2","0","0","0","1","0","0","3","0","3","0","0","3","2","0","1","0","3","2","0","0","0","1","3"
"Cawood","GB","36.78398","-83.22823","1","0","0","0","0","0","0","1","0","1","0","0","1","0","0","1","0","1","0","0","1","0","0","1"
"Cawood","GB","53.83303","-1.12962","1","0","0","0","0","0","0","1","0","1","0","0","1","0","0","1","0","1","0","0","1","0","0","1"
"Chafford Hundred","GB","51.4892","0.2944","1","0","0","0","0","0","0","1","0","1","0","0","1","0","1","0","0","1","0","0","1","0","0","1"
"Chalfont Saint Peter","GB","51.60885","-0.55618","4","0","0","0","1","0","0","5","0","2","1","1","4","1","0","4","0","5","1","2","2","0","0","5"
"Chalfont St Giles","GB","51.63184","-0.57026","4","0","0","0","2","0","0","6","2","0","1","0","3","2","0","4","0","6","0","2","4","0","0","6"
"Chalgrove","GB","51.66476","-1.0764","0","0","0","0","1","0","0","1","0","1","0","0","1","0","0","1","0","1","1","0","0","0","0","1"
"Chapel en le Frith","GB","53.32407","-1.91291","3","0","0","0","0","0","0","3","2","0","1","0","3","1","0","2","0","3","0","2","1","0","0","3"
"Chapmanslade","GB","51.22917","-2.24889","1","0","0","0","0","0","0","1","0","1","0","0","1","0","0","1","0","1","1","0","0","0","0","1"
"Chard","GB","50.8727","-2.96597","5","0","0","1","0","0","0","6","2","1","1","0","4","3","1","2","0","6","0","3","2","0","1","6"
"Charfield","GB","51.62722","-2.40667","1","0","0","0","0","0","0","1","0","0","1","0","1","0","0","1","0","1","0","1","0","0","0","1"
"Charing","GB","51.21073","0.79466","1","0","0","0","0","0","0","1","0","0","0","0","0","0","0","1","0","1","0","1","0","0","0","1"
"Charlton","GB","42.13565","-71.97007","1","0","0","0","1","0","0","2","1","1","0","0","2","1","0","1","0","2","0","0","2","0","0","2"
"Charlton","GB","51.59917","-2.05639","1","0","0","0","1","0","0","2","1","1","0","0","2","1","0","1","0","2","0","0","2","0","0","2"
"Charlton","GB","-36.26437","143.34901","1","0","0","0","1","0","0","2","1","1","0","0","2","1","0","1","0","2","0","0","2","0","0","2"
"Charlwood","GB","51.15644","-0.22586","1","0","0","0","0","0","0","1","0","0","1","0","1","0","0","1","0","1","0","0","1","0","0","1"
"Chatham","GB","32.30626","-92.45042","8","0","0","0","1","0","5","14","6","1","4","0","11","6","0","8","0","14","3","9","2","0","0","14"
"Chatham","GB","39.67616","-89.70454","8","0","0","0","1","0","5","14","6","1","4","0","11","6","0","8","0","14","3","9","2","0","0","14"
"Chatham","GB","41.74115","-87.61255","8","0","0","0","1","0","5","14","6","1","4","0","11","6","0","8","0","14","3","9","2","0","0","14"
"Chatham","GB","42.41224","-82.18494","8","0","0","0","1","0","5","14","6","1","4","0","11","6","0","8","0","14","3","9","2","0","0","14"
"Chatham","GB","36.82569","-79.39808","8","0","0","0","1","0","5","14","6","1","4","0","11","6","0","8","0","14","3","9","2","0","0","14"
"Chatham","GB","40.74093","-74.38376","8","0","0","0","1","0","5","14","6","1","4","0","11","6","0","8","0","14","3","9","2","0","0","14"
"Chatham","GB","42.36425","-73.59484","8","0","0","0","1","0","5","14","6","1","4","0","11","6","0","8","0","14","3","9","2","0","0","14"
"Chatham","GB","41.68206","-69.95974","8","0","0","0","1","0","5","14","6","1","4","0","11","6","0","8","0","14","3","9","2","0","0","14"
"Chatham","GB","51.37891","0.52786","8","0","0","0","1","0","5","14","6","1","4","0","11","6","0","8","0","14","3","9","2","0","0","14"
"Chatteris","GB","52.45624","0.05236","2","0","0","0","0","0","0","2","0","1","1","0","2","0","0","2","0","2","0","0","2","0","0","2"
"Cheadle","GB","52.98333","-1.98333","4","0","0","0","1","0","0","5","1","2","2","0","5","3","0","2","0","5","1","1","3","0","0","5"
"Cheam","GB","51.36179","-0.21977","1","0","0","1","0","0","1","3","1","0","0","0","1","1","0","2","0","3","1","0","2","0","0","3"
"Cheddar","GB","51.27537","-2.77662","1","0","0","0","0","0","0","1","0","0","1","0","1","0","0","1","0","1","0","1","0","0","0","1"
"Chelmsford","GB","42.59981","-71.36728","40","3","0","1","11","0","4","59","9","23","19","2","53","21","10","29","0","60","16","10","31","3","0","60"
"Chelmsford","GB","51.73575","0.46958","40","3","0","1","11","0","4","59","9","23","19","2","53","21","10","29","0","60","16","10","31","3","0","60"
"Cheltenham","GB","51.90006","-2.07972","24","4","0","1","1","0","0","30","7","10","9","0","26","14","2","14","0","30","4","7","17","0","2","30"
"Cheltenham","GB","-34.86788","138.52336","24","4","0","1","1","0","0","30","7","10","9","0","26","14","2","14","0","30","4","7","17","0","2","30"
"Cheltenham","GB","-37.96944","145.04806","24","4","0","1","1","0","0","30","7","10","9","0","26","14","2","14","0","30","4","7","17","0","2","30"
"Chepstow","GB","51.64087","-2.67683","4","2","0","0","0","0","1","7","2","2","2","0","6","3","0","4","0","7","0","2","5","0","0","7"
"Chertsey","GB","46.07109","-73.89095","1","1","0","0","0","0","0","2","1","0","1","0","2","0","1","1","0","2","0","0","2","0","0","2"
"Chertsey","GB","51.38812","-0.50782","1","1","0","0","0","0","0","2","1","0","1","0","2","0","1","1","0","2","0","0","2","0","0","2"
"Chesham","GB","51.7","-0.6","5","0","0","0","1","0","2","8","1","4","2","0","7","2","2","4","0","8","4","1","3","0","0","8"
"Cheshunt","GB","51.7002","-0.03026","6","0","0","0","0","0","0","6","0","4","1","0","5","3","1","2","0","6","1","1","2","2","0","6"
"Chessington","GB","51.3624","-0.30427","3","0","0","0","0","0","0","3","0","1","1","0","2","0","2","1","0","3","0","1","1","1","0","3"
"Chester","GB","40.30627","-121.23191","39","0","0","0","2","0","1","42","2","17","21","1","41","15","7","20","0","42","7","13","19","0","3","42"
"Chester","GB","48.51054","-110.96747","39","0","0","0","2","0","1","42","2","17","21","1","41","15","7","20","0","42","7","13","19","0","3","42"
"Chester","GB","37.91366","-89.82205","39","0","0","0","2","0","1","42","2","17","21","1","41","15","7","20","0","42","7","13","19","0","3","42"
"Chester","GB","32.39378","-83.15293","39","0","0","0","2","0","1","42","2","17","21","1","41","15","7","20","0","42","7","13","19","0","3","42"
"Chester","GB","34.70486","-81.21426","39","0","0","0","2","0","1","42","2","17","21","1","41","15","7","20","0","42","7","13","19","0","3","42"
"Chester","GB","40.61312","-80.56285","39","0","0","0","2","0","1","42","2","17","21","1","41","15","7","20","0","42","7","13","19","0","3","42"
"Chester","GB","37.35682","-77.44165","39","0","0","0","2","0","1","42","2","17","21","1","41","15","7","20","0","42","7","13","19","0","3","42"
"Chester","GB","38.97539","-76.2894","39","0","0","0","2","0","1","42","2","17","21","1","41","15","7","20","0","42","7","13","19","0","3","42"
"Chester","GB","39.84967","-75.35707","39","0","0","0","2","0","1","42","2","17","21","1","41","15","7","20","0","42","7","13","19","0","3","42"
"Chester","GB","40.78427","-74.69683","39","0","0","0","2","0","1","42","2","17","21","1","41","15","7","20","0","42","7","13","19","0","3","42"
"Chester","GB","41.36259","-74.27126","39","0","0","0","2","0","1","42","2","17","21","1","41","15","7","20","0","42","7","13","19","0","3","42"
"Chester","GB","42.27926","-72.97871","39","0","0","0","2","0","1","42","2","17","21","1","41","15","7","20","0","42","7","13","19","0","3","42"
"Chester","GB","43.26285","-72.59509","39","0","0","0","2","0","1","42","2","17","21","1","41","15","7","20","0","42","7","13","19","0","3","42"
"Chester","GB","42.95675","-71.25728","39","0","0","0","2","0","1","42","2","17","21","1","41","15","7","20","0","42","7","13","19","0","3","42"
"Chester","GB","45.40867","-68.49975","39","0","0","0","2","0","1","42","2","17","21","1","41","15","7","20","0","42","7","13","19","0","3","42"
"Chester","GB","44.54225","-64.23891","39","0","0","0","2","0","1","42","2","17","21","1","41","15","7","20","0","42","7","13","19","0","3","42"
"Chester","GB","53.1905","-2.89189","39","0","0","0","2","0","1","42","2","17","21","1","41","15","7","20","0","42","7","13","19","0","3","42"
"Chesterfield","GB","38.66311","-90.57707","19","0","0","0","3","0","0","22","3","8","7","0","18","5","4","13","0","22","5","4","13","0","0","22"
"Chesterfield","GB","40.11254","-85.59692","19","0","0","0","3","0","0","22","3","8","7","0","18","5","4","13","0","22","5","4","13","0","0","22"
"Chesterfield","GB","34.73599","-80.08812","19","0","0","0","3","0","0","22","3","8","7","0","18","5","4","13","0","22","5","4","13","0","0","22"
"Chesterfield","GB","37.37709","-77.50582","19","0","0","0","3","0","0","22","3","8","7","0","18","5","4","13","0","22","5","4","13","0","0","22"
"Chesterfield","GB","42.39175","-72.83982","19","0","0","0","3","0","0","22","3","8","7","0","18","5","4","13","0","22","5","4","13","0","0","22"
"Chesterfield","GB","42.8873","-72.47037","19","0","0","0","3","0","0","22","3","8","7","0","18","5","4","13","0","22","5","4","13","0","0","22"
"Chesterfield","GB","53.25","-1.41667","19","0","0","0","3","0","0","22","3","8","7","0","18","5","4","13","0","22","5","4","13","0","0","22"
"Chester-le-Street","GB","54.85862","-1.57408","4","0","0","0","2","0","0","6","2","0","2","0","4","2","0","4","0","6","0","2","4","0","0","6"
"Chichester","GB","43.24925","-71.39979","33","2","0","1","4","0","2","42","6","14","13","1","34","19","7","16","0","42","7","11","23","1","0","42"
"Chichester","GB","50.83673","-0.78003","33","2","0","1","4","0","2","42","6","14","13","1","34","19","7","16","0","42","7","11","23","1","0","42"
"Chiddingfold","GB","51.11866","-0.62262","7","0","0","0","0","0","0","7","1","0","0","0","1","1","1","5","0","7","0","2","5","0","0","7"
"Chigwell","GB","51.61999","0.07596","2","0","0","0","0","0","0","2","0","0","1","0","1","0","0","2","0","2","0","0","1","1","0","2"
"Chigwell","GB","-42.80912","147.2448","2","0","0","0","0","0","0","2","0","0","1","0","1","0","0","2","0","2","0","0","1","1","0","2"
"Chinley","GB","53.34025","-1.939","1","0","0","0","0","0","0","1","0","1","0","0","1","0","0","1","0","1","0","0","1","0","0","1"
"Chinnor","GB","51.70177","-0.91161","1","0","0","0","0","0","0","1","0","1","0","0","1","1","0","0","0","1","1","0","0","0","0","1"
"Chippenham","GB","51.46","-2.12472","15","1","0","1","0","0","1","18","3","6","7","0","16","3","2","13","0","18","1","7","9","0","1","18"
"Chippenham","GB","52.30184","0.43636","15","1","0","1","0","0","1","18","3","6","7","0","16","3","2","13","0","18","1","7","9","0","1","18"
"Chipping Norton","GB","51.94109","-1.5453","2","0","0","0","0","0","2","4","0","0","2","0","2","0","1","3","0","4","1","0","3","0","0","4"
"Chipping Norton","GB","-33.91801","150.95927","2","0","0","0","0","0","2","4","0","0","2","0","2","0","1","3","0","4","1","0","3","0","0","4"
"Chislehurst","GB","51.41709","0.06858","1","0","0","0","0","0","0","1","0","0","1","0","1","0","0","1","0","1","0","0","1","0","0","1"
"Chobham","GB","51.34836","-0.60639","1","0","0","0","0","0","0","1","0","0","1","0","1","0","0","0","1","1","0","1","0","0","0","1"
"Cholsey","GB","51.5728","-1.15356","1","0","0","0","0","0","0","1","0","1","0","0","1","1","0","0","0","1","0","0","1","0","0","1"
"Choppington","GB","55.15004","-1.60332","1","0","0","0","0","0","0","1","0","0","0","0","0","1","0","0","0","1","1","0","0","0","0","1"
"Chorley","GB","53.65","-2.61667","20","0","0","0","3","0","0","23","4","9","7","0","20","16","3","4","0","23","3","5","15","0","0","23"
"Chorleywood","GB","51.65472","-0.51404","1","0","0","0","0","0","0","1","0","0","0","0","0","0","0","1","0","1","0","0","1","0","0","1"
"Christchurch","GB","50.73583","-1.78129","11","0","0","0","1","0","1","13","3","4","6","0","13","4","2","7","0","13","2","3","6","1","1","13"
"Christchurch","GB","-43.53333","172.63333","11","0","0","0","1","0","1","13","3","4","6","0","13","4","2","7","0","13","2","3","6","1","1","13"
"Chudleigh","GB","50.60496","-3.60031","1","0","0","0","0","0","0","1","0","0","1","0","1","0","0","1","0","1","0","0","1","0","0","1"
"Church Stretton","GB","52.53778","-2.80149","1","0","0","0","0","0","0","1","0","0","1","0","1","0","1","0","0","1","0","0","1","0","0","1"
"Cirencester","GB","51.71927","-1.97145","8","0","0","0","0","0","0","8","1","5","0","0","6","5","1","2","0","8","2","3","3","0","0","8"
"Clackmannan","GB","56.10743","-3.75098","1","0","0","0","0","0","0","1","0","0","1","0","1","0","0","1","0","1","0","1","0","0","0","1"
"Clacton-on-Sea","GB","51.78967","1.15597","2","0","0","0","0","0","0","2","0","1","0","0","1","0","0","2","0","2","1","0","1","0","0","2"
"Clanfield","GB","51.71623","-1.58888","1","1","0","0","0","0","0","2","1","0","1","0","2","0","0","2","0","2","0","0","2","0","0","2"
"Clapham","GB","52.16085","-0.49529","2","0","0","0","0","0","0","2","0","0","2","0","2","2","0","0","0","2","0","0","2","0","0","2"
"Clapham","GB","-34.98989","138.60158","2","0","0","0","0","0","0","2","0","0","2","0","2","2","0","0","0","2","0","0","2","0","0","2"
"Claverdon","GB","52.27919","-1.71267","1","0","0","0","0","0","0","1","0","0","0","0","0","0","0","1","0","1","0","0","1","0","0","1"
"Cleator Moor","GB","54.52143","-3.5159","0","0","0","0","0","0","1","1","0","0","0","0","0","0","0","1","0","1","0","0","1","0","0","1"
"Cleckheaton","GB","53.72405","-1.71294","4","1","0","0","0","0","0","5","1","0","4","0","5","3","0","2","0","5","1","1","3","0","0","5"
"Cleethorpes","GB","53.56047","-0.03225","2","0","0","0","0","0","1","3","0","2","1","0","3","0","0","3","0","3","0","2","1","0","0","3"
"Clevedon","GB","51.44227","-2.85786","1","1","0","0","2","0","0","4","1","1","2","0","4","2","0","2","0","4","1","1","1","0","1","4"
"Cleveleys","GB","53.8775","-3.03987","1","0","0","0","0","0","0","1","0","1","0","0","1","1","0","0","0","1","1","0","0","0","0","1"
"Clitheroe","GB","53.86667","-2.4","7","0","0","0","1","0","1","9","1","3","4","1","9","3","1","3","1","8","2","3","3","0","0","8"
"Clunderwen","GB","51.84056","-4.73167","2","0","0","0","0","0","0","2","1","0","0","0","1","0","0","2","0","2","0","1","1","0","0","2"
"Clutton","GB","51.32944","-2.54306","1","0","0","0","0","0","0","1","1","0","0","0","1","0","0","1","0","1","1","0","0","0","0","1"
"Clydebank","GB","55.90137","-4.4057","1","0","0","0","0","0","0","1","0","0","1","0","1","0","0","1","0","1","0","0","1","0","0","1"
"Coalville","GB","40.91773","-111.39936","3","0","0","0","0","0","0","3","0","0","3","0","3","1","0","2","0","3","0","0","3","0","0","3"
"Coalville","GB","42.44525","-94.12579","3","0","0","0","0","0","0","3","0","0","3","0","3","1","0","2","0","3","0","0","3","0","0","3"
"Coalville","GB","52.72247","-1.3702","3","0","0","0","0","0","0","3","0","0","3","0","3","1","0","2","0","3","0","0","3","0","0","3"
"Coatbridge","GB","55.86216","-4.02469","2","1","0","0","1","0","0","4","0","1","2","0","3","1","1","2","0","4","1","2","1","0","0","4"
"Cobham","GB","51.32997","-0.4113","4","0","0","0","0","0","1","5","2","0","2","0","4","2","0","3","0","5","0","3","2","0","0","5"
"Cockermouth","GB","54.66209","-3.36086","3","0","0","0","0","0","0","3","0","1","2","0","3","1","0","2","0","3","1","1","1","0","0","3"
"Coedpoeth","GB","53.05391","-3.06234","1","0","0","0","0","0","0","1","0","0","1","0","1","0","0","1","0","1","0","1","0","0","0","1"
"Coelbren","GB","51.79181","-3.67014","1","0","0","0","0","0","0","1","0","0","1","0","1","0","0","1","0","1","0","0","1","0","0","1"
"Coggeshall","GB","51.87077","0.68536","3","0","0","0","0","0","0","3","0","1","1","0","2","2","0","1","0","3","1","0","2","0","0","3"
"Colchester","GB","40.42643","-90.79263","37","1","0","2","2","0","0","42","9","16","8","1","34","16","7","19","0","42","15","10","14","1","2","42"
"Colchester","GB","44.54394","-73.14791","37","1","0","2","2","0","0","42","9","16","8","1","34","16","7","19","0","42","15","10","14","1","2","42"
"Colchester","GB","41.57565","-72.33203","37","1","0","2","2","0","0","42","9","16","8","1","34","16","7","19","0","42","15","10","14","1","2","42"
"Colchester","GB","51.88921","0.90421","37","1","0","2","2","0","0","42","9","16","8","1","34","16","7","19","0","42","15","10","14","1","2","42"
"Cold Norton","GB","51.67209","0.66997","1","0","0","0","0","0","1","2","0","1","1","0","2","1","0","1","0","2","0","0","2","0","0","2"
"Coleford","GB","51.79535","-2.61354","3","0","0","0","0","0","0","3","0","1","1","0","2","2","0","1","0","3","1","1","1","0","0","3"
"Coleraine","GB","47.28883","-93.42771","4","0","0","0","0","0","0","4","0","4","0","0","4","1","1","2","0","4","2","1","0","0","1","4"
"Coleraine","GB","55.13333","-6.66667","4","0","0","0","0","0","0","4","0","4","0","0","4","1","1","2","0","4","2","1","0","0","1","4"
"Coleraine","GB","-37.59827","141.69124","4","0","0","0","0","0","0","4","0","4","0","0","4","1","1","2","0","4","2","1","0","0","1","4"
"Colne","GB","53.85713","-2.16851","3","0","0","0","0","0","0","3","1","1","1","0","3","1","1","1","0","3","1","1","1","0","0","3"
"Colwyn Bay","GB","53.29483","-3.72674","6","0","0","0","1","0","0","7","1","3","2","0","6","0","2","5","0","7","4","1","2","0","0","7"
"Colyton","GB","50.74006","-3.07021","1","0","0","0","0","0","0","1","0","0","1","0","1","0","0","1","0","1","0","1","0","0","0","1"
"Colyton","GB","-33.78283","150.79679","1","0","0","0","0","0","0","1","0","0","1","0","1","0","0","1","0","1","0","1","0","0","0","1"
"Comber","GB","54.54937","-5.74379","3","0","0","0","0","0","0","3","0","1","2","0","3","0","0","3","0","3","0","2","1","0","0","3"
"Comberton","GB","52.18709","0.01905","0","1","0","0","0","0","0","1","0","0","1","0","1","0","0","1","0","1","0","0","1","0","0","1"
"Congleton","GB","53.16314","-2.21253","3","0","0","0","0","0","0","3","0","1","2","0","3","2","0","1","0","3","0","0","3","0","0","3"
"Congresbury","GB","51.37135","-2.81018","1","0","0","0","0","0","0","1","1","0","0","0","1","0","0","1","0","1","0","0","1","0","0","1"
"Coningsby","GB","53.10598","-0.17595","1","0","0","0","0","0","0","1","0","0","1","0","1","0","0","1","0","1","0","1","0","0","0","1"
"Consett","GB","54.85404","-1.8316","3","0","0","0","1","0","0","4","0","1","2","0","3","1","0","3","0","4","1","1","2","0","0","4"
"Conwy","GB","53.28077","-3.83039","4","0","0","0","1","0","0","5","2","1","2","0","5","4","0","1","0","5","0","3","2","0","0","5"
"Cookham","GB","51.55936","-0.7081","1","0","0","0","0","0","0","1","1","0","0","0","1","0","0","1","0","1","0","0","1","0","0","1"
"Cookstown","GB","44.18341","-79.69964","6","0","0","0","0","0","1","7","3","2","1","0","6","2","2","3","0","7","1","1","5","0","0","7"
"Cookstown","GB","54.64305","-6.74595","6","0","0","0","0","0","1","7","3","2","1","0","6","2","2","3","0","7","1","1","5","0","0","7"
"Copthorne","GB","51.13929","-0.11742","1","0","0","0","0","0","0","1","0","0","0","0","0","1","0","0","0","1","1","0","0","0","0","1"
"Corby","GB","52.49637","-0.68939","4","0","0","0","0","0","1","5","1","3","1","0","5","3","0","2","0","5","1","1","3","0","0","5"
"Corfe Castle","GB","50.63947","-2.05672","1","0","0","0","0","0","0","1","0","1","0","0","1","0","0","1","0","1","0","1","0","0","0","1"
"Corsham","GB","51.43433","-2.18437","7","0","0","0","1","0","2","10","0","4","6","0","10","4","1","5","0","10","0","2","8","0","0","10"
"Cosgrove","GB","52.07518","-0.84801","1","0","0","0","0","0","0","1","0","1","0","0","1","1","0","0","0","1","0","0","0","0","1","1"
"Cosheston","GB","51.69653","-4.88882","1","0","0","0","0","0","0","1","0","0","0","0","0","1","0","0","0","1","0","0","1","0","0","1"
"Cottingham","GB","52.50243","-0.7554","1","0","0","0","0","0","2","3","0","1","1","0","2","1","0","2","0","3","1","1","1","0","0","3"
"Cottingham","GB","53.78057","-0.41542","1","0","0","0","0","0","2","3","0","1","1","0","2","1","0","2","0","3","1","1","1","0","0","3"
"Coulsdon","GB","51.32002","-0.14088","8","0","0","0","2","0","0","10","1","5","3","0","9","5","1","4","0","10","2","2","5","1","0","10"
"Cove","GB","45.29653","-117.80799","0","0","0","0","0","0","1","1","0","0","0","0","0","1","0","0","0","1","0","1","0","0","0","1"
"Cove","GB","29.82744","-94.80242","0","0","0","0","0","0","1","1","0","0","0","0","0","1","0","0","0","1","0","1","0","0","0","1"
"Cove","GB","57.1","-2.08333","0","0","0","0","0","0","1","1","0","0","0","0","0","1","0","0","0","1","0","1","0","0","0","1"
"Coven","GB","52.65587","-2.1353","1","0","0","0","0","0","0","1","0","0","0","0","0","1","0","0","0","1","1","0","0","0","0","1"
"Coventry","GB","41.7001","-71.68284","62","3","0","1","9","0","5","80","17","19","30","1","67","20","12","47","1","80","17","28","34","0","1","80"
"Coventry","GB","52.40656","-1.51217","62","3","0","1","9","0","5","80","17","19","30","1","67","20","12","47","1","80","17","28","34","0","1","80"
"Cowbridge","GB","51.46028","-3.44167","2","0","0","0","1","0","0","3","1","1","1","0","3","3","0","0","0","3","0","1","2","0","0","3"
"Cowdenbeath","GB","56.11194","-3.34426","2","0","0","0","0","0","0","2","0","1","1","0","2","1","0","1","0","2","0","0","2","0","0","2"
"Cowes","GB","50.76306","-1.29772","1","0","0","0","0","0","0","1","0","1","0","0","1","1","0","0","0","1","0","0","1","0","0","1"
"Cowes","GB","-38.45231","145.23865","1","0","0","0","0","0","0","1","0","1","0","0","1","1","0","0","0","1","0","0","1","0","0","1"
"Cowfold","GB","50.98945","-0.27243","1","0","0","0","0","0","0","1","0","0","0","0","0","0","0","1","0","1","0","0","1","0","0","1"
"Cradley Heath","GB","52.47214","-2.08212","2","0","0","0","0","0","1","3","1","1","1","0","3","0","1","2","0","3","1","0","2","0","0","3"
"Craigavon","GB","54.44709","-6.387","5","0","0","0","1","0","1","7","1","2","2","0","5","1","1","5","0","7","2","1","3","0","1","7"
"Cramlington","GB","55.08652","-1.58598","23","1","0","0","0","0","1","25","0","7","10","0","17","10","6","9","0","25","4","11","9","0","1","25"
"Cranbrook","GB","49.49991","-115.76879","5","0","0","0","1","0","0","6","1","3","2","0","6","3","0","3","0","6","1","0","4","0","1","6"
"Cranbrook","GB","51.09662","0.53567","5","0","0","0","1","0","0","6","1","3","2","0","6","3","0","3","0","6","1","0","4","0","1","6"
"Cranbrook","GB","-19.30553","146.75286","5","0","0","0","1","0","0","6","1","3","2","0","6","3","0","3","0","6","1","0","4","0","1","6"
"Cranleigh","GB","51.14209","-0.48374","3","1","0","0","0","0","0","4","0","0","3","0","3","1","2","1","0","4","0","1","3","0","0","4"
"Craven Arms","GB","52.44308","-2.83562","0","0","0","0","1","0","0","1","0","1","0","0","1","0","1","0","0","1","0","0","1","0","0","1"
"Crawley","GB","51.11303","-0.18312","19","0","0","1","0","0","1","21","2","7","8","0","17","8","4","9","0","21","4","7","10","0","0","21"
"Crawley","GB","-31.98418","115.81603","19","0","0","1","0","0","1","21","2","7","8","0","17","8","4","9","0","21","4","7","10","0","0","21"
"Crawley Down","GB","51.12061","-0.0773","0","0","0","0","2","0","0","2","1","0","0","0","1","1","0","1","0","2","0","1","1","0","0","2"
"Crediton","GB","50.78333","-3.65","2","0","0","0","0","0","0","2","0","1","0","0","1","1","0","1","0","2","0","1","1","0","0","2"
"Crewe","GB","37.17321","-78.12333","15","2","0","0","0","0","1","18","2","5","4","0","11","8","2","8","0","18","8","4","5","0","1","18"
"Crewe","GB","53.09787","-2.44161","15","2","0","0","0","0","1","18","2","5","4","0","11","8","2","8","0","18","8","4","5","0","1","18"
"Crewkerne","GB","50.88298","-2.79588","5","1","0","0","0","0","0","6","1","1","2","0","4","2","0","4","0","6","1","1","3","0","1","6"
"Crick","GB","52.34808","-1.13708","1","0","0","0","0","0","0","1","0","0","1","0","1","0","0","1","0","1","0","0","1","0","0","1"
"Crickhowell","GB","51.85992","-3.13771","1","0","0","0","0","0","0","1","0","0","0","0","0","0","1","0","0","1","0","0","1","0","0","1"
"Crieff","GB","56.37268","-3.83891","1","0","0","0","0","0","0","1","1","0","0","0","1","1","0","0","0","1","0","1","0","0","0","1"
"Crofton","GB","42.72889","-97.49562","1","0","0","0","0","0","0","1","0","0","1","0","1","1","0","0","0","1","0","1","0","0","0","1"
"Crofton","GB","37.04782","-87.485","1","0","0","0","0","0","0","1","0","0","1","0","1","1","0","0","0","1","0","1","0","0","0","1"
"Crofton","GB","39.00178","-76.68747","1","0","0","0","0","0","0","1","0","0","1","0","1","1","0","0","0","1","0","1","0","0","0","1"
"Crofton","GB","53.65639","-1.42968","1","0","0","0","0","0","0","1","0","0","1","0","1","1","0","0","0","1","0","1","0","0","0","1"
"Cromarty","GB","57.68095","-4.0341","1","0","0","0","0","0","0","1","0","0","0","0","0","1","0","0","0","1","0","0","1","0","0","1"
"Cromer","GB","52.93123","1.29892","1","0","0","0","0","0","0","1","0","1","0","0","1","0","0","1","0","1","1","0","0","0","0","1"
"Cromer","GB","-33.7312","151.26788","1","0","0","0","0","0","0","1","0","1","0","0","1","0","0","1","0","1","1","0","0","0","0","1"
"Cromford","GB","53.10848","-1.56014","1","0","0","0","0","0","0","1","0","0","0","0","0","1","0","0","0","1","0","0","1","0","0","1"
"Crondall","GB","51.23285","-0.86329","1","0","0","0","0","0","0","1","0","0","0","0","0","0","0","1","0","1","0","0","1","0","0","1"
"Crook","GB","54.71252","-1.7497","2","0","0","0","0","0","0","2","0","2","0","0","2","0","1","1","0","2","1","1","0","0","0","2"
"Crosby","GB","48.9142","-103.29491","2","0","0","0","0","0","0","2","0","0","1","0","1","0","2","0","0","2","0","0","2","0","0","2"
"Crosby","GB","29.91189","-95.06215","2","0","0","0","0","0","0","2","0","0","1","0","1","0","2","0","0","2","0","0","2","0","0","2"
"Crosby","GB","46.48218","-93.95776","2","0","0","0","0","0","0","2","0","0","1","0","1","0","2","0","0","2","0","0","2","0","0","2"
"Crosby","GB","54.18333","-4.56667","2","0","0","0","0","0","0","2","0","0","1","0","1","0","2","0","0","2","0","0","2","0","0","2"
"Crosby","GB","53.47778","-3.03333","2","0","0","0","0","0","0","2","0","0","1","0","1","0","2","0","0","2","0","0","2","0","0","2"
"Crossgates","GB","56.08366","-3.37712","1","0","0","0","0","0","0","1","0","0","1","0","1","0","0","1","0","1","0","1","0","0","0","1"
"Cross Hands","GB","51.79306","-4.0875","1","0","0","0","0","0","0","1","0","1","0","0","1","0","0","1","0","1","1","0","0","0","0","1"
"Crosskeys","GB","51.61917","-3.12361","1","0","0","0","0","0","0","1","0","0","1","0","1","0","0","1","0","1","0","0","1","0","0","1"
"Crowborough","GB","51.06098","0.16342","6","0","0","0","0","0","0","6","0","4","2","0","6","1","3","2","0","6","1","2","2","0","1","6"
"Crowthorne","GB","51.37027","-0.79219","5","0","0","0","0","0","1","6","0","1","1","0","2","2","1","3","0","6","2","1","3","0","0","6"
"Croydon","GB","40.08733","-74.9035","101","10","0","4","11","0","7","133","28","30","49","4","111","39","19","72","3","133","23","33","69","4","4","133"
"Croydon","GB","43.45063","-72.16314","101","10","0","4","11","0","7","133","28","30","49","4","111","39","19","72","3","133","23","33","69","4","4","133"
"Croydon","GB","51.38333","-0.1","101","10","0","4","11","0","7","133","28","30","49","4","111","39","19","72","3","133","23","33","69","4","4","133"
"Croydon","GB","-37.8","145.28333","101","10","0","4","11","0","7","133","28","30","49","4","111","39","19","72","3","133","23","33","69","4","4","133"
"Croydon","GB","-33.88333","151.11667","101","10","0","4","11","0","7","133","28","30","49","4","111","39","19","72","3","133","23","33","69","4","4","133"
"Crymych","GB","51.97361","-4.64722","2","0","0","0","1","0","0","3","0","1","1","0","2","1","0","2","0","3","1","1","1","0","0","3"
"Cudworth","GB","53.57131","-1.41595","0","0","0","0","1","0","0","1","0","0","1","0","1","0","0","1","0","1","0","1","0","0","0","1"
"Cullompton","GB","50.8553","-3.39268","5","0","0","0","0","0","0","5","0","3","1","0","4","0","0","4","1","5","1","0","4","0","0","5"
"Cumbernauld","GB","55.94685","-3.99051","6","0","0","0","0","0","0","6","1","1","3","0","5","1","2","3","0","6","2","0","4","0","0","6"
"Cumnock","GB","55.45445","-4.26644","2","0","0","0","0","0","0","2","0","2","0","0","2","0","1","1","0","2","2","0","0","0","0","2"
"Cupar","GB","56.31876","-3.01204","5","0","0","2","0","0","2","9","4","3","2","0","9","1","1","7","0","9","2","0","6","0","0","8"
"Currie","GB","55.8964","-3.30845","1","0","0","0","0","0","0","1","0","0","1","0","1","0","0","1","0","1","0","0","1","0","0","1"
"Currie","GB","-39.92976","143.85385","1","0","0","0","0","0","0","1","0","0","1","0","1","0","0","1","0","1","0","0","1","0","0","1"
"Cwmbran","GB","51.65446","-3.02281","9","0","0","0","0","0","0","9","2","2","4","0","8","2","3","4","0","9","2","4","3","0","0","9"
"Dagenham","GB","51.55","0.16667","4","0","0","1","0","0","0","5","1","2","0","0","3","2","0","3","0","5","1","2","2","0","0","5"
"Dalgety Bay","GB","56.03496","-3.35049","2","0","0","0","0","0","0","2","0","1","1","0","2","1","0","1","0","2","0","1","1","0","0","2"
"Dalkeith","GB","55.89317","-3.06806","5","0","0","0","0","0","0","5","0","1","4","0","5","2","2","1","0","5","1","1","3","0","0","5"
"Dalkeith","GB","-31.99517","115.7998","5","0","0","0","0","0","0","5","0","1","4","0","5","2","2","1","0","5","1","1","3","0","0","5"
"Dalry","GB","55.70956","-4.72167","1","0","0","0","0","0","0","1","0","0","0","0","0","0","0","1","0","1","0","1","0","0","0","1"
"Darley","GB","54.03333","-1.7","1","0","0","0","0","0","0","1","0","0","0","0","0","0","1","0","0","1","0","1","0","0","0","1"
"Darley","GB","-37.65807","144.44344","1","0","0","0","0","0","0","1","0","0","0","0","0","0","1","0","0","1","0","1","0","0","0","1"
"Darlington","GB","42.68306","-90.11763","12","0","0","0","4","0","0","16","5","3","4","0","12","4","3","9","0","16","1","3","12","0","0","16"
"Darlington","GB","40.11004","-86.77195","12","0","0","0","4","0","0","16","5","3","4","0","12","4","3","9","0","16","1","3","12","0","0","16"
"Darlington","GB","34.29988","-79.87617","12","0","0","0","4","0","0","16","5","3","4","0","12","4","3","9","0","16","1","3","12","0","0","16"
"Darlington","GB","54.52429","-1.55039","12","0","0","0","4","0","0","16","5","3","4","0","12","4","3","9","0","16","1","3","12","0","0","16"
"Darlington","GB","-31.91906","116.0812","12","0","0","0","4","0","0","16","5","3","4","0","12","4","3","9","0","16","1","3","12","0","0","16"
"Darlington","GB","-35.03151","138.55527","12","0","0","0","4","0","0","16","5","3","4","0","12","4","3","9","0","16","1","3","12","0","0","16"
"Darlington","GB","-33.89103","151.19548","12","0","0","0","4","0","0","16","5","3","4","0","12","4","3","9","0","16","1","3","12","0","0","16"
"Dartford","GB","51.44657","0.21423","13","0","0","0","0","0","0","13","1","4","5","0","10","4","0","9","0","13","4","2","6","0","1","13"
"Dartington","GB","50.44409","-3.70958","1","0","0","0","0","0","0","1","0","0","1","0","1","1","0","0","0","1","0","1","0","0","0","1"
"Dartmouth","GB","44.67134","-63.57719","1","0","0","0","0","0","0","1","0","0","1","0","1","1","0","0","0","1","0","1","0","0","0","1"
"Dartmouth","GB","50.3522","-3.5794","1","0","0","0","0","0","0","1","0","0","1","0","1","1","0","0","0","1","0","1","0","0","0","1"
"Darwen","GB","53.69803","-2.46494","4","0","0","0","0","0","0","4","1","2","1","0","4","2","1","1","0","4","2","0","2","0","0","4"
"Daventry","GB","52.25688","-1.16066","11","0","0","0","3","0","1","15","3","4","7","0","14","2","4","9","0","15","1","6","7","0","1","15"
"Deal","GB","40.24317","-74.00069","7","0","0","0","1","0","0","8","1","1","3","0","5","2","0","6","0","8","1","1","6","0","0","8"
"Deal","GB","51.22322","1.40432","7","0","0","0","1","0","0","8","1","1","3","0","5","2","0","6","0","8","1","1","6","0","0","8"
"Deal","GB","45.8591","23.62747","7","0","0","0","1","0","0","8","1","1","3","0","5","2","0","6","0","8","1","1","6","0","0","8"
"Deanshanger","GB","52.04996","-0.88663","1","0","0","0","0","0","0","1","0","0","1","0","1","1","0","0","0","1","0","0","1","0","0","1"
"Dearham","GB","54.71175","-3.44364","1","0","0","0","0","0","0","1","1","0","0","0","1","0","0","1","0","1","1","0","0","0","0","1"
"Deeside","GB","53.20053","-3.03841","2","0","0","0","0","0","0","2","0","0","1","0","1","1","0","1","0","2","0","0","2","0","0","2"
"Deganwy","GB","53.30446","-3.82735","1","0","0","0","0","0","0","1","0","1","0","0","1","0","0","1","0","1","0","0","1","0","0","1"
"Delabole","GB","50.62347","-4.7319","1","0","0","0","0","0","0","1","0","1","0","0","1","1","0","0","0","1","0","0","1","0","0","1"
"Denbigh","GB","53.18333","-3.41667","5","0","0","0","0","0","0","5","0","3","1","0","4","0","3","2","0","5","3","1","1","0","0","5"
"Denham","GB","51.56667","-0.5","2","0","0","0","0","0","0","2","1","1","0","0","2","0","1","1","0","2","0","0","2","0","0","2"
"Denham","GB","-25.92679","113.53327","2","0","0","0","0","0","0","2","1","1","0","0","2","0","1","1","0","2","0","0","2","0","0","2"
"Denmead","GB","50.90395","-1.06744","3","0","0","0","0","0","0","3","1","1","1","0","3","2","1","0","0","3","0","0","3","0","0","3"
"Denny","GB","56.0235","-3.90812","2","0","0","0","0","0","0","2","0","0","2","0","2","0","0","2","0","2","0","1","1","0","0","2"
"Denton","GB","33.21484","-97.13307","1","1","0","0","0","0","0","2","0","2","0","0","2","0","1","1","0","2","0","0","2","0","0","2"
"Denton","GB","35.63347","-80.11588","1","1","0","0","0","0","0","2","0","2","0","0","2","0","1","1","0","2","0","0","2","0","0","2"
"Denton","GB","38.88456","-75.82716","1","1","0","0","0","0","0","2","0","2","0","0","2","0","1","1","0","2","0","0","2","0","0","2"
"Denton","GB","13.5","-14.93333","1","1","0","0","0","0","0","2","0","2","0","0","2","0","1","1","0","2","0","0","2","0","0","2"
"Denton","GB","53.45678","-2.11822","1","1","0","0","0","0","0","2","0","2","0","0","2","0","1","1","0","2","0","0","2","0","0","2"
"Denton","GB","54.56667","-1.66667","1","1","0","0","0","0","0","2","0","2","0","0","2","0","1","1","0","2","0","0","2","0","0","2"
"Derby","GB","39.83943","-104.91859","80","2","0","3","7","0","1","93","16","24","19","0","59","34","14","45","0","93","23","22","47","0","1","93"
"Derby","GB","37.54557","-97.26893","80","2","0","3","7","0","1","93","16","24","19","0","59","34","14","45","0","93","23","22","47","0","1","93"
"Derby","GB","41.32065","-73.089","80","2","0","3","7","0","1","93","16","24","19","0","59","34","14","45","0","93","23","22","47","0","1","93"
"Derby","GB","52.92277","-1.47663","80","2","0","3","7","0","1","93","16","24","19","0","59","34","14","45","0","93","23","22","47","0","1","93"
"Derby","GB","-17.30295","123.62864","80","2","0","3","7","0","1","93","16","24","19","0","59","34","14","45","0","93","23","22","47","0","1","93"
"Deri","GB","51.70812","-3.26312","1","0","0","0","0","0","0","1","0","1","0","0","1","1","0","0","0","1","1","0","0","0","0","1"
"Derry","GB","40.33396","-79.29976","9","3","2","0","0","0","0","14","6","7","1","0","14","4","1","7","2","14","6","2","6","0","0","14"
"Derry","GB","42.88064","-71.32729","9","3","2","0","0","0","0","14","6","7","1","0","14","4","1","7","2","14","6","2","6","0","0","14"
"Derry","GB","51.58666","-9.05026","9","3","2","0","0","0","0","14","6","7","1","0","14","4","1","7","2","14","6","2","6","0","0","14"
"Derry","GB","54.9981","-7.30934","9","3","2","0","0","0","0","14","6","7","1","0","14","4","1","7","2","14","6","2","6","0","0","14"
"Desborough","GB","52.44183","-0.82126","3","0","0","0","0","0","1","4","0","3","1","0","4","1","1","1","0","3","1","1","1","0","0","3"
"Devizes","GB","51.35084","-1.99421","4","0","0","0","0","0","0","4","1","3","0","0","4","3","0","1","0","4","1","1","2","0","0","4"
"Dewsbury","GB","53.69076","-1.62907","13","0","0","1","2","0","1","17","6","1","4","0","11","7","1","9","0","17","2","6","8","0","1","17"
"Didcot","GB","51.60928","-1.24214","7","1","0","0","1","0","0","9","3","4","1","0","8","5","1","3","0","9","3","0","5","0","1","9"
"Dinas Powys","GB","51.43486","-3.21398","4","0","0","0","0","0","1","5","2","1","2","0","5","3","0","2","0","5","0","1","4","0","0","5"
"Dinnington","GB","55.05428","-1.67542","1","0","0","0","0","0","0","1","1","0","0","0","1","0","0","1","0","1","0","1","0","0","0","1"
"Dinnington","GB","53.36667","-1.2","1","0","0","0","0","0","0","1","1","0","0","0","1","0","0","1","0","1","0","1","0","0","0","1"
"Diss","GB","52.37675","1.1091","2","0","0","0","2","0","0","4","1","1","2","0","4","1","0","3","0","4","1","1","2","0","0","4"
"Dolgellau","GB","52.74222","-3.88611","1","0","0","0","0","0","0","1","0","1","0","0","1","0","0","1","0","1","0","0","1","0","0","1"
"Dollar","GB","56.16245","-3.67135","0","0","0","1","1","0","0","2","1","1","0","0","2","1","0","1","0","2","1","0","1","0","0","2"
"Doncaster","GB","53.52285","-1.13116","40","2","0","0","1","0","2","45","10","14","16","1","41","14","7","24","0","45","11","8","25","0","1","45"
"Doncaster","GB","-37.78828","145.12373","40","2","0","0","1","0","2","45","10","14","16","1","41","14","7","24","0","45","11","8","25","0","1","45"
"Dorchester","GB","40.64723","-97.11337","15","1","0","0","1","0","0","17","1","6","4","0","11","10","0","7","0","17","3","6","7","0","1","17"
"Dorchester","GB","45.00302","-90.33569","15","1","0","0","1","0","0","17","1","6","4","0","11","10","0","7","0","17","3","6","7","0","1","17"
"Dorchester","GB","42.98339","-81.06643","15","1","0","0","1","0","0","17","1","6","4","0","11","10","0","7","0","17","3","6","7","0","1","17"
"Dorchester","GB","50.71667","-2.43333","15","1","0","0","1","0","0","17","1","6","4","0","11","10","0","7","0","17","3","6","7","0","1","17"
"Dorking","GB","51.23228","-0.3338","15","0","0","0","2","0","0","17","5","1","9","0","15","3","1","13","0","17","1","3","13","0","0","17"
"Dornoch","GB","57.8805","-4.02879","1","0","0","0","0","0","0","1","0","1","0","0","1","0","0","1","0","1","0","0","1","0","0","1"
"Dover","GB","48.25159","-116.61103","13","0","0","0","3","0","1","17","3","7","6","1","17","12","2","3","0","17","6","6","5","0","0","17"
"Dover","GB","35.40147","-93.11434","13","0","0","0","3","0","1","17","3","7","6","1","17","12","2","3","0","17","6","6","5","0","0","17"
"Dover","GB","43.97357","-92.13905","13","0","0","0","3","0","1","17","3","7","6","1","17","12","2","3","0","17","6","6","5","0","0","17"
"Dover","GB","36.48783","-87.83836","13","0","0","0","3","0","1","17","3","7","6","1","17","12","2","3","0","17","6","6","5","0","0","17"
"Dover","GB","27.99419","-82.21953","13","0","0","0","3","0","1","17","3","7","6","1","17","12","2","3","0","17","6","6","5","0","0","17"
"Dover","GB","40.52062","-81.47401","13","0","0","0","3","0","1","17","3","7","6","1","17","12","2","3","0","17","6","6","5","0","0","17"
"Dover","GB","40.00176","-76.85025","13","0","0","0","3","0","1","17","3","7","6","1","17","12","2","3","0","17","6","6","5","0","0","17"
"Dover","GB","39.15817","-75.52437","13","0","0","0","3","0","1","17","3","7","6","1","17","12","2","3","0","17","6","6","5","0","0","17"
"Dover","GB","40.88399","-74.5621","13","0","0","0","3","0","1","17","3","7","6","1","17","12","2","3","0","17","6","6","5","0","0","17"
"Dover","GB","42.94369","-72.80399","13","0","0","0","3","0","1","17","3","7","6","1","17","12","2","3","0","17","6","6","5","0","0","17"
"Dover","GB","42.24593","-71.28283","13","0","0","0","3","0","1","17","3","7","6","1","17","12","2","3","0","17","6","6","5","0","0","17"
"Dover","GB","43.19786","-70.87367","13","0","0","0","3","0","1","17","3","7","6","1","17","12","2","3","0","17","6","6","5","0","0","17"
"Dover","GB","51.12598","1.31257","13","0","0","0","3","0","1","17","3","7","6","1","17","12","2","3","0","17","6","6","5","0","0","17"
"Dover","GB","-43.31423","147.01488","13","0","0","0","3","0","1","17","3","7","6","1","17","12","2","3","0","17","6","6","5","0","0","17"
"Downham Market","GB","52.60714","0.38375","2","0","0","0","0","0","0","2","1","0","1","0","2","0","0","2","0","2","0","1","1","0","0","2"
"Driffield","GB","54.00613","-0.44495","4","0","0","0","0","0","0","4","0","0","4","0","4","0","0","4","0","4","1","0","3","0","0","4"
"Droitwich","GB","52.26667","-2.15","4","0","0","0","1","0","0","5","0","2","3","0","5","3","0","2","0","5","1","1","3","0","0","5"
"Dromore","GB","54.51331","-7.45886","1","1","0","0","0","0","0","2","1","1","0","0","2","0","2","0","0","2","0","0","2","0","0","2"
"Dubai","GB","25.07725","55.30927","1","0","0","0","0","0","0","1","0","1","0","0","1","1","0","0","0","1","0","1","0","0","0","1"
"Dudley","GB","32.54239","-83.07043","29","1","0","3","3","0","3","39","11","9","2","0","22","17","8","14","0","39","14","7","16","0","2","39"
"Dudley","GB","42.0451","-71.93007","29","1","0","3","3","0","3","39","11","9","2","0","22","17","8","14","0","39","14","7","16","0","2","39"
"Dudley","GB","52.5","-2.08333","29","1","0","3","3","0","3","39","11","9","2","0","22","17","8","14","0","39","14","7","16","0","2","39"
"Dudley","GB","-32.99373","151.72197","29","1","0","3","3","0","3","39","11","9","2","0","22","17","8","14","0","39","14","7","16","0","2","39"
"Dufftown","GB","57.44571","-3.12708","1","0","0","0","0","0","0","1","1","0","0","0","1","0","0","1","0","1","0","1","0","0","0","1"
"Dukinfield","GB","53.47497","-2.08809","2","0","0","0","0","0","0","2","0","1","1","0","2","0","1","1","0","2","2","0","0","0","0","2"
"Dumbarton","GB","37.60376","-77.49137","2","2","0","0","0","0","0","4","0","2","2","0","4","2","1","1","0","4","3","1","0","0","0","4"
"Dumbarton","GB","55.94433","-4.57061","2","2","0","0","0","0","0","4","0","2","2","0","4","2","1","1","0","4","3","1","0","0","0","4"
"Dumfries","GB","38.56762","-77.32804","7","0","0","0","0","0","2","9","2","6","1","0","9","2","4","3","0","9","3","3","3","0","0","9"
"Dumfries","GB","55.06959","-3.61139","7","0","0","0","0","0","2","9","2","6","1","0","9","2","4","3","0","9","3","3","3","0","0","9"
"Dunblane","GB","56.18843","-3.96417","1","0","0","0","0","0","0","1","0","0","1","0","1","1","0","0","0","1","0","1","0","0","0","1"
"Dundee","GB","45.27817","-123.01094","24","0","0","0","5","0","1","30","7","14","3","2","26","6","5","17","2","30","13","5","10","0","2","30"
"Dundee","GB","41.95727","-83.65966","24","0","0","0","5","0","1","30","7","14","3","2","26","6","5","17","2","30","13","5","10","0","2","30"
"Dundee","GB","28.02252","-81.61924","24","0","0","0","5","0","1","30","7","14","3","2","26","6","5","17","2","30","13","5","10","0","2","30"
"Dundee","GB","42.5234","-76.97663","24","0","0","0","5","0","1","30","7","14","3","2","26","6","5","17","2","30","13","5","10","0","2","30"
"Dundee","GB","56.46913","-2.97489","24","0","0","0","5","0","1","30","7","14","3","2","26","6","5","17","2","30","13","5","10","0","2","30"
"Dundee","GB","-28.16678","30.23371","24","0","0","0","5","0","1","30","7","14","3","2","26","6","5","17","2","30","13","5","10","0","2","30"
"Dunfermline","GB","56.07156","-3.45887","9","0","0","0","3","0","2","14","1","5","5","0","11","7","1","6","0","14","2","0","9","1","2","14"
"Dungannon","GB","54.50344","-6.76723","2","0","0","0","0","0","0","2","0","0","1","0","1","0","1","1","0","2","0","1","1","0","0","2"
"Dunoon","GB","55.95031","-4.92734","1","0","0","0","0","0","0","1","0","0","1","0","1","1","0","0","0","1","0","1","0","0","0","1"
"Dunoon","GB","-28.6846","153.31766","1","0","0","0","0","0","0","1","0","0","1","0","1","1","0","0","0","1","0","1","0","0","0","1"
"Duns","GB","55.77704","-2.34575","1","0","0","0","1","0","0","2","1","3","0","0","4","4","0","1","0","5","0","0","2","0","3","5"
"Dunstable","GB","42.67509","-71.48284","13","0","0","0","3","0","0","16","3","4","6","1","14","5","4","7","0","16","2","3","10","0","1","16"
"Dunstable","GB","51.88571","-0.52288","13","0","0","0","3","0","0","16","3","4","6","1","14","5","4","7","0","16","2","3","10","0","1","16"
"Durham","GB","45.40206","-122.75287","86","6","0","3","7","0","6","108","24","29","41","1","95","36","10","60","2","108","26","28","52","0","2","108"
"Durham","GB","39.64627","-121.79998","86","6","0","3","7","0","6","108","24","29","41","1","95","36","10","60","2","108","26","28","52","0","2","108"
"Durham","GB","35.99403","-78.89862","86","6","0","3","7","0","6","108","24","29","41","1","95","36","10","60","2","108","26","28","52","0","2","108"
"Durham","GB","42.39953","-74.17236","86","6","0","3","7","0","6","108","24","29","41","1","95","36","10","60","2","108","26","28","52","0","2","108"
"Durham","GB","41.48176","-72.68121","86","6","0","3","7","0","6","108","24","29","41","1","95","36","10","60","2","108","26","28","52","0","2","108"
"Durham","GB","43.13397","-70.92645","86","6","0","3","7","0","6","108","24","29","41","1","95","36","10","60","2","108","26","28","52","0","2","108"
"Durham","GB","54.77676","-1.57566","86","6","0","3","7","0","6","108","24","29","41","1","95","36","10","60","2","108","26","28","52","0","2","108"
"Dursley","GB","51.68139","-2.35333","1","0","0","0","0","0","0","1","0","0","0","0","0","0","0","1","0","1","0","0","1","0","0","1"
"Dymchurch","GB","51.02544","0.99392","1","0","0","0","0","0","0","1","0","0","0","0","0","0","0","1","0","1","0","0","1","0","0","1"
"Dyserth","GB","53.30032","-3.41262","0","0","0","0","0","0","1","1","0","1","0","0","1","1","0","0","0","1","0","0","1","0","0","1"
"Eaglesham","GB","55.74119","-4.27459","1","0","0","0","0","0","0","1","0","0","1","0","1","0","0","1","0","1","0","0","1","0","0","1"
"Ealing","GB","51.51216","-0.30204","6","0","0","1","2","0","0","9","2","1","4","0","7","3","1","5","0","9","2","1","6","0","0","9"
"Ealing Broadway","GB","51.51566","-0.30079","1","0","0","0","0","0","0","1","0","0","1","0","1","0","1","0","0","1","0","1","0","0","0","1"
"Eardisley","GB","52.14045","-3.00843","1","0","0","0","0","0","0","1","0","0","1","0","1","0","0","1","0","1","0","1","0","0","0","1"
"Earl Shilton","GB","52.57682","-1.31536","1","0","0","0","0","0","0","1","0","1","0","0","1","0","0","1","0","1","0","1","0","0","0","1"
"Easington","GB","17.92397","-76.58824","2","0","0","0","0","0","0","2","0","1","1","0","2","1","0","1","0","2","0","1","1","0","0","2"
"Easington","GB","54.78528","-1.35917","2","0","0","0","0","0","0","2","0","1","1","0","2","1","0","1","0","2","0","1","1","0","0","2"
"Easington","GB","54.55345","-0.85058","2","0","0","0","0","0","0","2","0","1","1","0","2","1","0","1","0","2","0","1","1","0","0","2"
"Easington","GB","53.65359","0.11501","2","0","0","0","0","0","0","2","0","1","1","0","2","1","0","1","0","2","0","1","1","0","0","2"
"Easingwold","GB","54.1201","-1.1939","1","0","0","0","0","0","0","1","0","0","0","0","0","1","0","0","0","1","0","0","1","0","0","1"
"East Boldon","GB","54.94452","-1.42815","5","0","0","0","0","0","0","5","0","1","3","0","4","2","2","1","0","5","2","2","1","0","0","5"
"Eastbourne","GB","50.76871","0.28453","17","0","0","2","2","0","0","21","3","8","8","1","20","7","4","9","1","21","3","5","9","2","1","20"
"East Bridgford","GB","52.97954","-0.96563","1","0","0","0","0","0","0","1","0","1","0","0","1","0","0","1","0","1","1","0","0","0","0","1"
"East Cowes","GB","50.75774","-1.28815","1","0","0","0","0","0","0","1","0","0","1","0","1","0","0","1","0","1","0","1","0","0","0","1"
"East Dereham","GB","52.68333","0.93333","2","0","0","0","0","0","0","2","0","2","0","0","2","0","1","1","0","2","1","0","0","0","1","2"
"East Grinstead","GB","51.12382","-0.0061","7","0","0","0","1","0","0","8","1","2","4","0","7","2","2","4","0","8","1","3","4","0","0","8"
"East Horsley","GB","51.27358","-0.43207","1","0","0","0","0","0","0","1","0","1","0","0","1","0","1","0","0","1","0","0","1","0","0","1"
"East Kilbride","GB","55.76412","-4.17669","6","1","0","0","0","0","0","7","0","2","4","0","6","4","2","1","0","7","1","2","4","0","0","7"
"East Leake","GB","52.83015","-1.18103","1","0","0","0","0","0","0","1","0","0","0","0","0","0","0","1","0","1","0","0","1","0","0","1"
"Eastleigh","GB","50.96667","-1.35","12","2","0","0","1","0","2","17","5","6","4","0","15","6","1","10","0","17","5","4","7","0","1","17"
"Eastleigh","GB","-26.12965","28.15541","12","2","0","0","1","0","2","17","5","6","4","0","15","6","1","10","0","17","5","4","7","0","1","17"
"East Molesey","GB","51.39872","-0.34916","2","1","0","0","0","0","0","3","0","1","2","0","3","2","0","1","0","3","0","0","3","0","0","3"
"East Rudham","GB","52.8207","0.7111","1","0","0","0","0","0","0","1","0","0","0","0","0","0","1","0","0","1","0","0","1","0","0","1"
"East Tilbury","GB","51.48053","0.41714","0","0","0","1","0","0","0","1","1","0","0","0","1","0","1","0","0","1","0","0","1","0","0","1"
"Ebbw Vale","GB","51.77714","-3.20792","9","0","0","0","1","0","0","10","2","5","2","0","9","1","3","6","0","10","6","1","3","0","0","10"
"Eccles","GB","53.48333","-2.33333","3","0","0","0","0","0","0","3","0","3","0","0","3","1","0","2","0","3","0","0","3","0","0","3"
"Eccleshall","GB","52.85789","-2.24971","0","0","0","0","0","0","1","1","0","0","1","0","1","0","0","1","0","1","0","1","0","0","0","1"
"Eckington","GB","52.06667","-2.11667","2","0","0","0","0","0","0","2","0","1","1","0","2","0","1","1","0","2","0","0","1","1","0","2"
"Edenbridge","GB","51.19172","0.06729","4","0","0","0","1","0","1","6","2","0","1","0","3","2","1","3","0","6","0","1","5","0","0","6"
"Edgware","GB","51.6128","-0.27539","4","0","0","1","1","0","0","6","2","0","3","0","5","2","1","3","0","6","0","3","3","0","0","6"
"Edinburgh","GB","39.35422","-85.96666","128","4","0","8","14","0","9","163","23","47","69","1","140","58","24","80","1","163","20","36","98","2","7","163"
"Edinburgh","GB","55.95206","-3.19648","128","4","0","8","14","0","9","163","23","47","69","1","140","58","24","80","1","163","20","36","98","2","7","163"
"Egham","GB","51.43158","-0.55239","6","0","0","0","0","0","2","8","1","2","4","0","7","3","0","5","0","8","1","1","6","0","0","8"
"Egremont","GB","54.47941","-3.52756","3","0","0","0","0","0","0","3","1","1","1","0","3","1","0","2","0","3","1","0","2","0","0","3"
"Elford","GB","52.69103","-1.72103","1","0","0","0","0","0","0","1","0","1","0","0","1","0","0","1","0","1","0","0","1","0","0","1"
"Elgin","GB","45.56486","-117.91743","2","0","0","0","2","0","0","4","0","1","2","0","3","2","0","2","0","4","0","0","3","0","1","4"
"Elgin","GB","46.4039","-101.84598","2","0","0","0","2","0","0","4","0","1","2","0","3","2","0","2","0","4","0","0","3","0","1","4"
"Elgin","GB","34.78035","-98.29227","2","0","0","0","2","0","0","4","0","1","2","0","3","2","0","2","0","4","0","0","3","0","1","4"
"Elgin","GB","41.98334","-98.08368","2","0","0","0","2","0","0","4","0","1","2","0","3","2","0","2","0","4","0","0","3","0","1","4"
"Elgin","GB","30.34965","-97.37027","2","0","0","0","2","0","0","4","0","1","2","0","3","2","0","2","0","4","0","0","3","0","1","4"
"Elgin","GB","44.13024","-92.25156","2","0","0","0","2","0","0","4","0","1","2","0","3","2","0","2","0","4","0","0","3","0","1","4"
"Elgin","GB","42.95748","-91.63071","2","0","0","0","2","0","0","4","0","1","2","0","3","2","0","2","0","4","0","0","3","0","1","4"
"Elgin","GB","42.03725","-88.28119","2","0","0","0","2","0","0","4","0","1","2","0","3","2","0","2","0","4","0","0","3","0","1","4"
"Elgin","GB","34.17098","-80.79425","2","0","0","0","2","0","0","4","0","1","2","0","3","2","0","2","0","4","0","0","3","0","1","4"
"Elgin","GB","34.67293","-80.71896","2","0","0","0","2","0","0","4","0","1","2","0","3","2","0","2","0","4","0","0","3","0","1","4"
"Elgin","GB","57.64947","-3.31843","2","0","0","0","2","0","0","4","0","1","2","0","3","2","0","2","0","4","0","0","3","0","1","4"
"Ellesmere","GB","52.90838","-2.89806","1","0","0","0","0","0","0","1","1","0","0","0","1","0","0","1","0","1","0","0","1","0","0","1"
"Ellesmere Port","GB","53.27875","-2.90134","9","0","0","1","0","0","0","10","2","3","3","0","8","2","2","6","0","10","3","3","3","0","1","10"
"Ellon","GB","57.36405","-2.07313","4","0","0","0","0","0","0","4","1","0","2","0","3","0","0","4","0","4","0","3","1","0","0","4"
"Elstree","GB","51.6403","-0.29693","3","1","0","1","0","0","0","5","3","1","1","0","5","2","0","3","0","5","0","4","0","0","1","5"
"Ely","GB","39.24744","-114.88863","15","0","0","0","0","0","0","15","2","2","7","2","13","3","3","9","0","15","1","5","9","0","0","15"
"Ely","GB","47.90324","-91.86709","15","0","0","0","0","0","0","15","2","2","7","2","13","3","3","9","0","15","1","5","9","0","0","15"
"Ely","GB","41.87362","-91.58518","15","0","0","0","0","0","0","15","2","2","7","2","13","3","3","9","0","15","1","5","9","0","0","15"
"Ely","GB","52.39964","0.26196","15","0","0","0","0","0","0","15","2","2","7","2","13","3","3","9","0","15","1","5","9","0","0","15"
"Emsworth","GB","40.51007","-80.0945","4","0","0","0","1","0","2","7","2","1","3","0","6","7","0","0","0","7","0","2","5","0","0","7"
"Emsworth","GB","50.84779","-0.93697","4","0","0","0","1","0","2","7","2","1","3","0","6","7","0","0","0","7","0","2","5","0","0","7"
"Enfield Town","GB","51.65147","-0.08497","15","0","0","0","0","0","0","15","3","2","3","0","8","5","2","8","0","15","4","6","5","0","0","15"
"Enniskillen","GB","54.34615","-7.64133","7","0","0","0","1","0","0","8","0","1","2","0","3","2","1","5","0","8","3","1","4","0","0","8"
"Enstone","GB","51.91537","-1.45371","0","0","0","0","1","0","0","1","0","0","0","0","0","1","0","0","0","1","0","0","1","0","0","1"
"Epping","GB","43.03342","-71.07423","4","0","0","0","1","0","0","5","2","3","0","0","5","2","1","2","0","5","2","0","3","0","0","5"
"Epping","GB","51.69815","0.11055","4","0","0","0","1","0","0","5","2","3","0","0","5","2","1","2","0","5","2","0","3","0","0","5"
"Epping","GB","49.11178","7.31706","4","0","0","0","1","0","0","5","2","3","0","0","5","2","1","2","0","5","2","0","3","0","0","5"
"Epping","GB","-37.65","145.03333","4","0","0","0","1","0","0","5","2","3","0","0","5","2","1","2","0","5","2","0","3","0","0","5"
"Epping","GB","-33.77271","151.08184","4","0","0","0","1","0","0","5","2","3","0","0","5","2","1","2","0","5","2","0","3","0","0","5"
"Epsom","GB","43.22286","-71.33201","17","1","0","0","4","0","2","24","4","4","9","0","17","11","3","10","0","24","2","7","14","0","1","24"
"Epsom","GB","51.3305","-0.27011","17","1","0","0","4","0","2","24","4","4","9","0","17","11","3","10","0","24","2","7","14","0","1","24"
"Epsom","GB","-36.71667","144.31667","17","1","0","0","4","0","2","24","4","4","9","0","17","11","3","10","0","24","2","7","14","0","1","24"
"Erith","GB","51.48315","0.17484","2","0","0","0","0","0","0","2","0","1","1","0","2","1","0","1","0","2","1","0","1","0","0","2"
"Esher","GB","51.36969","-0.36693","8","0","0","1","1","0","1","11","3","2","4","0","9","4","0","6","1","11","0","1","10","0","0","11"
"Eton","GB","34.82508","-84.76327","2","0","0","0","0","0","0","2","0","0","0","0","0","2","0","0","0","2","0","0","2","0","0","2"
"Eton","GB","51.48833","-0.60905","2","0","0","0","0","0","0","2","0","0","0","0","0","2","0","0","0","2","0","0","2","0","0","2"
"Eton","GB","-21.26471","148.97237","2","0","0","0","0","0","0","2","0","0","0","0","0","2","0","0","0","2","0","0","2","0","0","2"
"Etwall","GB","52.88353","-1.60023","0","0","0","0","1","0","0","1","0","0","1","0","1","0","1","0","0","1","0","0","1","0","0","1"
"Evesham","GB","52.09237","-1.94887","4","0","0","1","1","0","1","7","1","3","2","0","6","4","0","3","0","7","2","1","4","0","0","7"
"Ewenny","GB","51.48183","-3.57367","1","0","0","0","0","0","0","1","0","0","1","0","1","0","0","1","0","1","0","0","1","0","0","1"
"Exeter","GB","36.29606","-119.14205","51","1","0","3","5","0","3","63","10","15","26","2","53","18","6","37","2","63","6","11","42","0","4","63"
"Exeter","GB","40.64417","-97.45033","51","1","0","3","5","0","3","63","10","15","26","2","53","18","6","37","2","63","6","11","42","0","4","63"
"Exeter","GB","36.67229","-93.94104","51","1","0","3","5","0","3","63","10","15","26","2","53","18","6","37","2","63","6","11","42","0","4","63"
"Exeter","GB","41.32064","-75.81908","51","1","0","3","5","0","3","63","10","15","26","2","53","18","6","37","2","63","6","11","42","0","4","63"
"Exeter","GB","41.5776","-71.53756","51","1","0","3","5","0","3","63","10","15","26","2","53","18","6","37","2","63","6","11","42","0","4","63"
"Exeter","GB","42.98148","-70.94783","51","1","0","3","5","0","3","63","10","15","26","2","53","18","6","37","2","63","6","11","42","0","4","63"
"Exeter","GB","50.7236","-3.52751","51","1","0","3","5","0","3","63","10","15","26","2","53","18","6","37","2","63","6","11","42","0","4","63"
"Exeter","GB","-34.83994","138.48902","51","1","0","3","5","0","3","63","10","15","26","2","53","18","6","37","2","63","6","11","42","0","4","63"
"Exeter","GB","-41.29749","146.95055","51","1","0","3","5","0","3","63","10","15","26","2","53","18","6","37","2","63","6","11","42","0","4","63"
"Exeter","GB","-34.61283","150.32083","51","1","0","3","5","0","3","63","10","15","26","2","53","18","6","37","2","63","6","11","42","0","4","63"
"Exmouth","GB","50.61723","-3.40233","2","0","0","1","0","0","2","5","3","1","0","0","4","4","0","1","0","5","0","1","4","0","0","5"
"Exmouth","GB","-21.93063","114.12091","2","0","0","1","0","0","2","5","3","1","0","0","4","4","0","1","0","5","0","1","4","0","0","5"
"Eye","GB","52.608","-0.19209","0","0","0","1","0","0","0","1","1","0","0","0","1","0","0","1","0","1","0","1","0","0","0","1"
"Eyemouth","GB","55.8713","-2.0901","1","0","0","0","1","0","0","2","1","1","0","0","2","1","0","1","0","2","1","0","1","0","0","2"
"Eynsham","GB","51.78077","-1.37454","1","0","0","0","0","0","0","1","0","0","1","0","1","0","1","0","0","1","0","1","0","0","0","1"
"Failsworth","GB","53.50484","-2.16568","1","0","0","0","1","0","0","2","0","2","0","0","2","2","0","0","0","2","0","0","1","0","0","1"
"Fakenham","GB","52.82996","0.8477","3","0","0","0","0","0","0","3","0","3","0","0","3","2","0","1","0","3","2","0","1","0","0","3"
"Falkirk","GB","56.0021","-3.78535","19","0","0","2","1","0","0","22","3","8","9","0","20","10","0","12","0","22","2","5","14","0","1","22"
"Falmouth","GB","38.67674","-84.33021","1","0","0","0","1","0","1","3","1","2","0","0","3","0","0","3","0","3","1","1","1","0","0","3"
"Falmouth","GB","18.49358","-77.65587","1","0","0","0","1","0","1","3","1","2","0","0","3","0","0","3","0","3","1","1","1","0","0","3"
"Falmouth","GB","38.32402","-77.46832","1","0","0","0","1","0","1","3","1","2","0","0","3","0","0","3","0","3","1","1","1","0","0","3"
"Falmouth","GB","41.5515","-70.61475","1","0","0","0","1","0","1","3","1","2","0","0","3","0","0","3","0","3","1","1","1","0","0","3"
"Falmouth","GB","43.72953","-70.24199","1","0","0","0","1","0","1","3","1","2","0","0","3","0","0","3","0","3","1","1","1","0","0","3"
"Falmouth","GB","17.02741","-61.78136","1","0","0","0","1","0","1","3","1","2","0","0","3","0","0","3","0","3","1","1","1","0","0","3"
"Falmouth","GB","50.15441","-5.07113","1","0","0","0","1","0","1","3","1","2","0","0","3","0","0","3","0","3","1","1","1","0","0","3"
"Fareham","GB","50.85162","-1.17929","13","2","0","1","2","0","1","19","4","6","8","0","18","5","3","10","0","18","2","4","12","0","0","18"
"Faringdon","GB","51.65644","-1.58676","1","0","0","0","1","0","0","2","1","0","1","0","2","1","0","1","0","2","0","0","2","0","0","2"
"Farnborough","GB","52.14289","-1.36926","18","0","0","0","0","0","0","18","0","4","11","1","16","3","4","11","0","18","4","5","8","0","1","18"
"Farnborough","GB","51.53333","-1.36667","18","0","0","0","0","0","0","18","0","4","11","1","16","3","4","11","0","18","4","5","8","0","1","18"
"Farnborough","GB","51.29424","-0.75565","18","0","0","0","0","0","0","18","0","4","11","1","16","3","4","11","0","18","4","5","8","0","1","18"
"Farnborough","GB","51.35948","0.06905","18","0","0","0","0","0","0","18","0","4","11","1","16","3","4","11","0","18","4","5","8","0","1","18"
"Farnborough","GB","-23.09122","150.74148","18","0","0","0","0","0","0","18","0","4","11","1","16","3","4","11","0","18","4","5","8","0","1","18"
"Farnham","GB","45.28338","-72.98244","12","0","0","1","4","0","0","17","6","4","3","0","13","8","1","8","0","17","2","4","11","0","0","17"
"Farnham","GB","51.21444","-0.80054","12","0","0","1","4","0","0","17","6","4","3","0","13","8","1","8","0","17","2","4","11","0","0","17"
"Farnham Royal","GB","51.54208","-0.61584","1","0","0","0","0","0","0","1","1","0","0","0","1","0","0","1","0","1","1","0","0","0","0","1"
"Farnsfield","GB","53.10223","-1.0332","2","0","0","0","0","0","0","2","0","1","1","0","2","0","0","2","0","2","0","2","0","0","0","2"
"Faversham","GB","51.3148","0.88856","0","0","0","0","1","0","0","1","0","1","0","0","1","1","0","0","0","1","0","0","1","0","0","1"
"Felixstowe","GB","51.96375","1.3511","3","0","0","0","0","0","0","3","0","3","0","0","3","1","0","2","0","3","1","0","2","0","0","3"
"Felling","GB","54.95297","-1.57152","1","0","0","0","0","0","0","1","1","0","0","0","1","0","0","1","0","1","0","1","0","0","0","1"
"Feltham","GB","51.4462","-0.41388","3","1","0","1","0","0","0","5","3","0","1","0","4","1","0","4","0","5","0","2","3","0","0","5"
"Fenstanton","GB","52.29903","-0.06712","2","0","0","0","0","0","0","2","0","2","0","0","2","1","0","1","0","2","0","2","0","0","0","2"
"Ferndale","GB","40.57624","-124.26394","6","0","0","0","0","0","1","7","1","3","3","0","7","1","1","5","0","7","2","2","3","0","0","7"
"Ferndale","GB","48.8465","-122.59101","6","0","0","0","0","0","1","7","1","3","3","0","7","1","1","5","0","7","2","2","3","0","0","7"
"Ferndale","GB","42.46059","-83.13465","6","0","0","0","0","0","1","7","1","3","3","0","7","1","1","5","0","7","2","2","3","0","0","7"
"Ferndale","GB","40.28896","-78.91475","6","0","0","0","0","0","1","7","1","3","3","0","7","1","1","5","0","7","2","2","3","0","0","7"
"Ferndale","GB","39.18316","-76.64024","6","0","0","0","0","0","1","7","1","3","3","0","7","1","1","5","0","7","2","2","3","0","0","7"
"Ferndale","GB","51.66056","-3.4475","6","0","0","0","0","0","1","7","1","3","3","0","7","1","1","5","0","7","2","2","3","0","0","7"
"Ferndale","GB","-32.03494","115.92233","6","0","0","0","0","0","1","7","1","3","3","0","7","1","1","5","0","7","2","2","3","0","0","7"
"Ferndown","GB","50.80743","-1.89975","1","0","0","0","0","0","0","1","0","1","0","0","1","0","0","1","0","1","0","1","0","0","0","1"
"Filey","GB","54.21","-0.28917","3","0","0","0","0","0","0","3","0","1","2","0","3","1","0","2","0","3","1","0","2","0","0","3"
"Findon","GB","50.86816","-0.40735","1","0","0","0","0","0","0","1","0","0","0","0","0","1","0","0","0","1","0","0","1","0","0","1"
"Findon","GB","-34.9","138.53333","1","0","0","0","0","0","0","1","0","0","0","0","0","1","0","0","0","1","0","0","1","0","0","1"
"Finedon","GB","52.33917","-0.65008","1","0","0","0","0","0","0","1","0","1","0","0","1","0","0","1","0","1","0","0","1","0","0","1"
"Fishguard","GB","51.99376","-4.97631","2","0","0","0","0","0","0","2","1","0","1","0","2","0","1","1","0","2","0","1","1","0","0","2"
"Fittleworth","GB","50.9644","-0.56185","1","0","0","0","0","0","0","1","0","0","0","0","0","1","0","0","0","1","0","0","1","0","0","1"
"Fivemiletown","GB","54.38333","-7.3","1","0","0","0","0","0","0","1","0","0","1","0","1","0","0","1","0","1","1","0","0","0","0","1"
"Fleckney","GB","52.53497","-1.04598","1","0","0","0","0","0","0","1","0","1","0","0","1","0","0","1","0","1","1","0","0","0","0","1"
"Fleet","GB","51.28333","-0.83333","18","0","0","0","2","0","1","21","3","6","7","0","16","9","1","11","0","21","1","7","13","0","0","21"
"Fleet","GB","52.79321","0.05854","18","0","0","0","2","0","1","21","3","6","7","0","16","9","1","11","0","21","1","7","13","0","0","21"
"Fleetwood","GB","40.45398","-75.81798","3","1","0","1","1","0","0","6","0","1","3","0","4","1","1","4","0","6","0","2","4","0","0","6"
"Fleetwood","GB","53.92527","-3.01085","3","1","0","1","1","0","0","6","0","1","3","0","4","1","1","4","0","6","0","2","4","0","0","6"
"Flint","GB","43.01253","-83.68746","2","0","0","0","0","0","0","2","2","0","0","0","2","1","0","1","0","2","0","1","1","0","0","2"
"Flint","GB","53.24488","-3.13231","2","0","0","0","0","0","0","2","2","0","0","0","2","1","0","1","0","2","0","1","1","0","0","2"
"Flitwick","GB","52.00338","-0.49472","3","0","0","0","1","0","0","4","0","0","3","0","3","2","0","2","0","4","0","2","2","0","0","4"
"Folkestone","GB","51.08169","1.16734","9","0","0","0","1","0","0","10","1","3","3","0","7","2","2","6","0","10","3","2","5","0","0","10"
"Fordingbridge","GB","50.92747","-1.79029","1","0","0","0","0","0","0","1","0","0","0","0","0","0","0","1","0","1","0","0","1","0","0","1"
"Forest Row","GB","51.09641","0.03262","1","0","0","0","0","0","0","1","0","1","0","0","1","0","0","1","0","1","1","0","0","0","0","1"
"Forfar","GB","56.64382","-2.89001","3","0","0","1","0","0","0","4","2","1","1","0","4","2","1","1","0","4","1","1","2","0","0","4"
"Formby","GB","53.55838","-3.06999","1","0","0","0","1","0","0","2","0","1","1","0","2","1","0","1","0","2","0","0","2","0","0","2"
"Fort William","GB","56.81648","-5.11208","2","0","0","0","0","0","0","2","0","1","1","0","2","2","0","0","0","2","0","0","1","0","1","2"
"Foulridge","GB","53.87579","-2.16864","1","0","0","0","0","0","0","1","0","0","0","1","1","1","0","0","0","1","1","0","0","0","0","1"
"Fowlmere","GB","52.09343","0.07433","1","0","0","0","0","0","0","1","0","1","0","0","1","0","0","1","0","1","0","0","1","0","0","1"
"Frimley","GB","51.31667","-0.74544","0","1","0","0","0","0","0","1","0","0","1","0","1","0","0","1","0","1","0","0","1","0","0","1"
"Frinton-on-Sea","GB","51.83061","1.24424","3","0","0","0","1","0","0","4","0","2","1","0","3","3","0","1","0","4","3","0","1","0","0","4"
"Frizington","GB","54.54185","-3.4946","2","6","0","0","1","0","0","9","5","2","1","0","8","7","1","1","0","9","6","2","1","0","0","9"
"Frodsham","GB","53.29485","-2.72745","1","0","0","0","0","0","0","1","0","0","0","0","0","1","0","0","0","1","0","0","1","0","0","1"
"Frome","GB","18.29407","-78.15469","4","0","0","0","0","0","1","5","1","1","2","0","4","2","0","3","0","5","1","2","2","0","0","5"
"Frome","GB","51.22834","-2.32211","4","0","0","0","0","0","1","5","1","1","2","0","4","2","0","3","0","5","1","2","2","0","0","5"
"Fyfield","GB","51.41667","-1.78333","0","0","0","0","1","0","0","1","0","1","0","0","1","1","0","0","0","1","0","0","1","0","0","1"
"Fyfield","GB","51.74065","0.26976","0","0","0","0","1","0","0","1","0","1","0","0","1","1","0","0","0","1","0","0","1","0","0","1"
"Fylde","GB","53.83333","-2.91667","1","0","0","0","0","0","0","1","1","0","0","0","1","0","1","0","0","1","0","0","1","0","0","1"
"Gaerwen","GB","53.22112","-4.27362","0","0","0","0","0","0","1","1","1","0","0","0","1","1","0","0","0","1","0","0","1","0","0","1"
"Gainford","GB","54.54718","-1.73601","1","0","0","0","0","0","0","1","0","0","1","0","1","0","0","1","0","1","0","0","1","0","0","1"
"Gainsborough","GB","53.38333","-0.76667","4","0","0","0","0","0","0","4","1","1","0","0","2","2","1","1","0","4","1","1","1","0","1","4"
"Galashiels","GB","55.61458","-2.80695","2","1","0","0","0","0","0","3","0","2","1","0","3","1","1","1","0","3","1","2","0","0","0","3"
"Galgate","GB","53.99362","-2.79201","1","0","0","0","0","0","0","1","0","1","0","0","1","0","1","0","0","1","0","1","0","0","0","1"
"Garstang","GB","53.90081","-2.77417","1","0","0","0","0","0","0","1","1","0","0","0","1","0","0","1","0","1","0","0","1","0","0","1"
"Gateshead","GB","54.96209","-1.60168","28","0","0","1","1","0","1","31","6","7","11","0","24","11","5","15","0","31","8","10","12","1","0","31"
"Gateshead","GB","-32.98208","151.69188","28","0","0","1","1","0","1","31","6","7","11","0","24","11","5","15","0","31","8","10","12","1","0","31"
"Gawsworth","GB","53.23178","-2.17014","2","0","0","0","0","0","0","2","0","0","2","0","2","0","0","2","0","2","0","1","1","0","0","2"
"Gerrards Cross","GB","51.5861","-0.55543","14","1","0","2","0","0","3","20","7","3","5","0","15","11","0","9","0","20","3","5","12","0","0","20"
"Gillingham","GB","51.03833","-2.27611","11","0","0","0","1","0","2","14","5","4","2","0","11","6","0","8","0","14","2","3","8","0","1","14"
"Gillingham","GB","51.38914","0.54863","11","0","0","0","1","0","2","14","5","4","2","0","11","6","0","8","0","14","2","3","8","0","1","14"
"Girvan","GB","55.24255","-4.85551","1","0","0","0","0","0","0","1","0","0","1","0","1","1","0","0","0","1","0","0","1","0","0","1"
"Glanamman","GB","51.8","-3.93333","1","0","0","0","0","0","0","1","0","0","0","0","0","1","0","0","0","1","0","0","1","0","0","1"
"Glasgow","GB","43.43456","-124.21122","135","4","0","9","11","0","6","165","30","59","47","2","138","65","20","79","1","165","38","30","91","4","2","165"
"Glasgow","GB","48.19696","-106.63671","135","4","0","9","11","0","6","165","30","59","47","2","138","65","20","79","1","165","38","30","91","4","2","165"
"Glasgow","GB","39.22725","-92.84658","135","4","0","9","11","0","6","165","30","59","47","2","138","65","20","79","1","165","38","30","91","4","2","165"
"Glasgow","GB","36.99588","-85.91192","135","4","0","9","11","0","6","165","30","59","47","2","138","65","20","79","1","165","38","30","91","4","2","165"
"Glasgow","GB","38.21538","-81.42456","135","4","0","9","11","0","6","165","30","59","47","2","138","65","20","79","1","165","38","30","91","4","2","165"
"Glasgow","GB","37.63402","-79.45031","135","4","0","9","11","0","6","165","30","59","47","2","138","65","20","79","1","165","38","30","91","4","2","165"
"Glasgow","GB","39.60483","-75.74521","135","4","0","9","11","0","6","165","30","59","47","2","138","65","20","79","1","165","38","30","91","4","2","165"
"Glasgow","GB","55.86515","-4.25763","135","4","0","9","11","0","6","165","30","59","47","2","138","65","20","79","1","165","38","30","91","4","2","165"
"Glastonbury","GB","41.71232","-72.60815","1","0","0","0","0","0","0","1","0","0","1","0","1","0","0","1","0","1","0","0","1","0","0","1"
"Glastonbury","GB","51.14745","-2.72075","1","0","0","0","0","0","0","1","0","0","1","0","1","0","0","1","0","1","0","0","1","0","0","1"
"Glenrothes","GB","56.19514","-3.17316","4","0","0","0","0","0","1","5","1","1","3","0","5","1","0","4","0","5","0","1","4","0","0","5"
"Glossop","GB","53.44325","-1.949","9","0","0","0","0","0","0","9","2","4","1","0","7","3","0","6","0","9","0","4","5","0","0","9"
"Glossop","GB","-34.27688","140.541","9","0","0","0","0","0","0","9","2","4","1","0","7","3","0","6","0","9","0","4","5","0","0","9"
"Gloucester","GB","34.72627","-76.54104","40","1","0","1","6","0","3","51","8","26","17","1","52","20","7","24","1","52","11","6","32","2","1","52"
"Gloucester","GB","42.61405","-70.66313","40","1","0","1","6","0","3","51","8","26","17","1","52","20","7","24","1","52","11","6","32","2","1","52"
"Gloucester","GB","51.86568","-2.2431","40","1","0","1","6","0","3","51","8","26","17","1","52","20","7","24","1","52","11","6","32","2","1","52"
"Gloucester","GB","-32.0077","151.9633","40","1","0","1","6","0","3","51","8","26","17","1","52","20","7","24","1","52","11","6","32","2","1","52"
"Glyn-neath","GB","51.7475","-3.61833","1","0","0","0","0","0","0","1","0","0","1","0","1","0","0","1","0","1","0","1","0","0","0","1"
"Gnosall","GB","52.78558","-2.25483","1","0","0","0","0","0","0","1","0","1","0","0","1","1","0","0","0","1","1","0","0","0","0","1"
"Godalming","GB","51.1858","-0.61489","34","0","0","1","4","0","3","42","6","8","18","1","33","16","1","24","1","42","7","12","22","1","0","42"
"Godmanchester","GB","52.31939","-0.17509","1","1","0","0","0","0","0","2","2","0","0","0","2","0","0","2","0","2","0","0","2","0","0","2"
"Godshill","GB","50.63308","-1.25476","1","0","0","0","0","0","0","1","0","0","1","0","1","0","0","1","0","1","0","0","1","0","0","1"
"Golborne","GB","53.47693","-2.59651","2","0","0","0","1","0","0","3","0","0","1","0","1","0","0","3","0","3","0","3","0","0","0","3"
"Goodwick","GB","52.00491","-4.99511","2","0","0","0","1","0","0","3","2","0","0","0","2","1","0","2","0","3","2","1","0","0","0","3"
"Goole","GB","53.70324","-0.87732","3","0","0","0","0","0","0","3","0","3","0","0","3","1","2","0","0","3","1","0","2","0","0","3"
"Goostrey","GB","53.22731","-2.33919","1","0","0","0","0","0","0","1","0","0","1","0","1","0","0","1","0","1","0","1","0","0","0","1"
"Gosfield","GB","51.93657","0.59197","1","0","0","0","0","0","0","1","0","1","0","0","1","0","0","1","0","1","0","0","1","0","0","1"
"Gosport","GB","39.35088","-86.66695","6","1","0","0","2","0","1","10","2","0","4","1","7","2","0","6","2","10","1","5","2","1","1","10"
"Gosport","GB","50.79509","-1.12902","6","1","0","0","2","0","1","10","2","0","4","1","7","2","0","6","2","10","1","5","2","1","1","10"
"Gourdon","GB","56.82979","-2.28641","1","0","0","0","0","0","0","1","0","1","0","0","1","1","0","0","0","1","0","0","1","0","0","1"
"Gourdon","GB","44.73742","1.38297","1","0","0","0","0","0","0","1","0","1","0","0","1","1","0","0","0","1","0","0","1","0","0","1"
"Gourdon","GB","46.64154","4.44619","1","0","0","0","0","0","0","1","0","1","0","0","1","1","0","0","0","1","0","0","1","0","0","1"
"Gourock","GB","55.96157","-4.81789","3","0","0","0","0","0","1","4","0","2","2","0","4","3","0","1","0","4","1","3","0","0","0","4"
"Grange-over-Sands","GB","54.18508","-2.92488","1","0","0","0","0","0","0","1","0","0","0","0","0","0","0","1","0","1","0","1","0","0","0","1"
"Grantham","GB","43.48952","-72.13759","9","1","0","0","3","0","0","13","2","7","2","0","11","2","2","8","0","12","5","3","5","0","0","13"
"Grantham","GB","52.91149","-0.64184","9","1","0","0","3","0","0","13","2","7","2","0","11","2","2","8","0","12","5","3","5","0","0","13"
"Grantham","GB","-27.57918","152.20167","9","1","0","0","3","0","0","13","2","7","2","0","11","2","2","8","0","12","5","3","5","0","0","13"
"Grantown on Spey","GB","57.33051","-3.60867","1","0","0","0","0","0","0","1","0","0","1","0","1","0","0","1","0","1","0","1","0","0","0","1"
"Grassington","GB","54.0714","-1.99822","1","0","0","0","0","0","0","1","0","1","0","0","1","0","0","1","0","1","0","1","0","0","0","1"
"Gravesend","GB","40.5976","-73.96514","14","0","0","2","1","0","2","19","5","8","4","1","18","5","4","10","0","19","2","5","12","0","0","19"
"Gravesend","GB","51.44206","0.37106","14","0","0","2","1","0","2","19","5","8","4","1","18","5","4","10","0","19","2","5","12","0","0","19"
"Grays","GB","51.47566","0.32521","6","0","0","0","1","0","0","7","3","2","2","0","7","3","0","4","0","7","0","4","3","0","0","7"
"Greasby","GB","53.373","-3.1233","3","0","0","0","0","0","0","3","0","1","2","0","3","1","0","2","0","3","1","1","1","0","0","3"
"Great Bookham","GB","51.27916","-0.37423","1","0","0","0","0","0","0","1","0","0","1","0","1","0","1","0","0","1","0","0","1","0","0","1"
"Great Dunmow","GB","51.8723","0.36255","0","0","0","0","1","0","0","1","0","0","1","0","1","0","0","1","0","1","0","0","1","0","0","1"
"Great Glen","GB","52.57548","-1.0349","1","0","0","0","0","0","0","1","0","0","1","0","1","1","0","0","0","1","0","1","0","0","0","1"
"Great Harwood","GB","53.78512","-2.40865","2","0","0","0","0","0","0","2","0","1","0","0","1","1","1","0","0","2","0","0","2","0","0","2"
"Great Horkesley","GB","51.93821","0.87551","1","0","0","0","0","0","0","1","0","0","1","0","1","0","1","0","0","1","0","0","1","0","0","1"
"Great Malvern","GB","52.11161","-2.32515","1","0","0","0","1","0","0","2","0","2","0","0","2","0","0","2","0","2","1","0","1","0","0","2"
"Great Missenden","GB","51.70419","-0.70797","3","0","0","0","0","0","0","3","0","1","2","0","3","0","0","3","0","3","1","0","2","0","0","3"
"Great Rollright","GB","51.97595","-1.52864","1","0","0","0","0","0","0","1","1","0","0","0","1","1","0","0","0","1","0","0","1","0","0","1"
"Great Shefford","GB","51.4747","-1.44959","1","0","0","0","0","0","0","1","0","0","0","0","0","0","0","1","0","1","0","1","0","0","0","1"
"Great Wyrley","GB","52.66277","-2.01111","1","0","0","0","0","0","0","1","1","0","0","0","1","0","0","1","0","1","0","1","0","0","0","1"
"Great Yarmouth","GB","52.60831","1.73052","3","0","0","0","0","0","0","3","0","1","2","0","3","0","2","1","0","3","1","1","1","0","0","3"
"Greenford","GB","51.52866","-0.35508","0","1","0","0","0","0","0","1","0","1","0","0","1","0","0","1","0","1","0","0","1","0","0","1"
"Greenhithe","GB","51.45026","0.28539","2","0","0","0","0","0","1","3","1","1","1","0","3","3","0","0","0","3","0","0","3","0","0","3"
"Greenock","GB","40.31229","-79.80671","5","1","0","1","1","0","0","8","1","5","2","0","8","5","1","2","0","8","3","3","1","0","1","8"
"Greenock","GB","55.94838","-4.76121","5","1","0","1","1","0","0","8","1","5","2","0","8","5","1","2","0","8","3","3","1","0","1","8"
"Greenock","GB","-34.457","138.92719","5","1","0","1","1","0","0","8","1","5","2","0","8","5","1","2","0","8","3","3","1","0","1","8"
"Gretna","GB","41.14083","-96.23974","0","0","0","0","1","0","0","1","1","0","0","0","1","0","0","1","0","1","0","0","1","0","0","1"
"Gretna","GB","29.91465","-90.05396","0","0","0","0","1","0","0","1","1","0","0","0","1","0","0","1","0","1","0","0","1","0","0","1"
"Gretna","GB","30.61714","-84.65991","0","0","0","0","1","0","0","1","1","0","0","0","1","0","0","1","0","1","0","0","1","0","0","1"
"Gretna","GB","36.95375","-79.35891","0","0","0","0","1","0","0","1","1","0","0","0","1","0","0","1","0","1","0","0","1","0","0","1"
"Gretna","GB","54.9938","-3.06594","0","0","0","0","1","0","0","1","1","0","0","0","1","0","0","1","0","1","0","0","1","0","0","1"
"Grimbsy","GB","53.55989","-0.09888","6","1","0","1","0","0","0","8","2","1","5","0","8","3","1","4","0","8","1","3","3","0","1","8"
"Grimsby","GB","53.56539","-0.07553","5","0","0","0","0","0","0","5","1","3","1","0","5","2","1","2","0","5","2","2","1","0","0","5"
"Grove","GB","36.59369","-94.76912","0","0","0","1","0","0","0","1","1","0","0","0","1","0","0","1","0","1","1","0","0","0","0","1"
"Grove","GB","51.60954","-1.42187","0","0","0","1","0","0","0","1","1","0","0","0","1","0","0","1","0","1","1","0","0","0","0","1"
"Grove","GB","53.53333","10.48333","0","0","0","1","0","0","0","1","1","0","0","0","1","0","0","1","0","1","1","0","0","0","0","1"
"Guildford","GB","51.23536","-0.57427","59","3","0","1","3","0","3","69","8","11","22","0","41","30","6","32","0","68","4","17","42","4","2","69"
"Guildford","GB","-31.9","115.96667","59","3","0","1","3","0","3","69","8","11","22","0","41","30","6","32","0","68","4","17","42","4","2","69"
"Guisborough","GB","54.53478","-1.05606","1","0","0","0","0","0","0","1","0","0","0","0","0","0","0","1","0","1","1","0","0","0","0","1"
"Gullane","GB","56.03652","-2.82829","2","0","0","0","0","0","0","2","0","1","1","0","2","1","0","1","0","2","0","0","2","0","0","2"
"Gunnislake","GB","50.52441","-4.21333","1","0","0","0","0","0","0","1","0","0","0","0","0","1","0","0","0","1","1","0","0","0","0","1"
"Hackney","GB","51.55","-0.05","2","0","0","1","0","0","1","4","1","0","1","0","2","2","0","2","0","4","0","1","3","0","0","4"
"Hackney","GB","-34.9139","138.6164","2","0","0","1","0","0","1","4","1","0","1","0","2","2","0","2","0","4","0","1","3","0","0","4"
"Haddington","GB","55.95612","-2.78332","3","0","0","0","0","0","0","3","1","0","2","0","3","1","1","1","0","3","0","1","2","0","0","3"
"Hagley","GB","52.4262","-2.12819","2","0","0","0","0","0","0","2","1","1","0","0","2","0","1","1","0","2","1","0","1","0","0","2"
"Hailsham","GB","50.8622","0.25775","4","0","0","0","1","0","2","7","0","2","1","2","5","1","1","4","1","7","4","0","3","0","0","7"
"Hale","GB","53.33333","-2.8","2","0","0","0","0","0","0","2","0","0","1","0","1","1","0","1","0","2","0","0","2","0","0","2"
"Hale","GB","53.37831","-2.33271","2","0","0","0","0","0","0","2","0","0","1","0","1","1","0","1","0","2","0","0","2","0","0","2"
"Hale","GB","51.22946","-0.78908","2","0","0","0","0","0","0","2","0","0","1","0","1","1","0","1","0","2","0","0","2","0","0","2"
"Hale","GB","41.21861","111.6755","2","0","0","0","0","0","0","2","0","0","1","0","1","1","0","1","0","2","0","0","2","0","0","2"
"Halesowen","GB","52.44859","-2.04938","12","0","0","1","1","0","2","16","3","3","9","0","15","3","2","12","0","17","3","7","7","0","0","17"
"Halesworth","GB","52.3464","1.5029","1","0","0","0","1","0","0","2","0","2","0","0","2","1","0","1","0","2","1","1","0","0","0","2"
"Halifax","GB","36.76597","-78.92834","23","0","0","0","3","0","0","26","3","9","11","0","23","9","3","14","0","26","6","7","12","1","0","26"
"Halifax","GB","36.32849","-77.58942","23","0","0","0","3","0","0","26","3","9","11","0","23","9","3","14","0","26","6","7","12","1","0","26"
"Halifax","GB","40.46814","-76.93192","23","0","0","0","3","0","0","26","3","9","11","0","23","9","3","14","0","26","6","7","12","1","0","26"
"Halifax","GB","41.99121","-70.86199","23","0","0","0","3","0","0","26","3","9","11","0","23","9","3","14","0","26","6","7","12","1","0","26"
"Halifax","GB","44.6464","-63.57291","23","0","0","0","3","0","0","26","3","9","11","0","23","9","3","14","0","26","6","7","12","1","0","26"
"Halifax","GB","53.71667","-1.85","23","0","0","0","3","0","0","26","3","9","11","0","23","9","3","14","0","26","6","7","12","1","0","26"
"Halkyn","GB","53.22556","-3.19016","0","0","0","0","0","0","1","1","1","0","0","0","1","1","0","0","0","1","0","1","0","0","0","1"
"Halstead","GB","38.0014","-97.50865","1","0","0","0","0","0","0","1","0","0","1","0","1","1","0","0","0","1","0","1","0","0","0","1"
"Halstead","GB","51.94506","0.63927","1","0","0","0","0","0","0","1","0","0","1","0","1","1","0","0","0","1","0","1","0","0","0","1"
"Hamble-le-Rice","GB","50.85966","-1.32432","2","0","0","0","0","0","0","2","0","1","0","0","1","1","1","0","0","2","0","1","0","0","1","2"
"Hamilton","GB","46.24687","-114.16037","7","0","0","0","0","0","0","7","1","4","2","0","7","4","0","2","0","6","3","2","2","0","0","7"
"Hamilton","GB","31.70377","-98.12392","7","0","0","0","0","0","0","7","1","4","2","0","7","4","0","2","0","6","3","2","2","0","0","7"
"Hamilton","GB","39.74362","-93.99827","7","0","0","0","0","0","0","7","1","4","2","0","7","4","0","2","0","6","3","2","2","0","0","7"
"Hamilton","GB","40.39643","-91.33904","7","0","0","0","0","0","0","7","1","4","2","0","7","4","0","2","0","6","3","2","2","0","0","7"
"Hamilton","GB","34.14232","-87.98864","7","0","0","0","0","0","0","7","1","4","2","0","7","4","0","2","0","6","3","2","2","0","0","7"
"Hamilton","GB","41.53366","-84.91274","7","0","0","0","0","0","0","7","1","4","2","0","7","4","0","2","0","6","3","2","2","0","0","7"
"Hamilton","GB","32.75791","-84.87493","7","0","0","0","0","0","0","7","1","4","2","0","7","4","0","2","0","6","3","2","2","0","0","7"
"Hamilton","GB","39.3995","-84.56134","7","0","0","0","0","0","0","7","1","4","2","0","7","4","0","2","0","6","3","2","2","0","0","7"
"Hamilton","GB","43.25011","-79.84963","7","0","0","0","0","0","0","7","1","4","2","0","7","4","0","2","0","6","3","2","2","0","0","7"
"Hamilton","GB","39.13427","-77.66249","7","0","0","0","0","0","0","7","1","4","2","0","7","4","0","2","0","6","3","2","2","0","0","7"
"Hamilton","GB","42.82701","-75.54462","7","0","0","0","0","0","0","7","1","4","2","0","7","4","0","2","0","6","3","2","2","0","0","7"
"Hamilton","GB","32.2949","-64.78303","7","0","0","0","0","0","0","7","1","4","2","0","7","4","0","2","0","6","3","2","2","0","0","7"
"Hamilton","GB","55.76667","-4.03333","7","0","0","0","0","0","0","7","1","4","2","0","7","4","0","2","0","6","3","2","2","0","0","7"
"Hamilton","GB","-37.74425","142.02202","7","0","0","0","0","0","0","7","1","4","2","0","7","4","0","2","0","6","3","2","2","0","0","7"
"Hamilton","GB","-32.92207","151.74711","7","0","0","0","0","0","0","7","1","4","2","0","7","4","0","2","0","6","3","2","2","0","0","7"
"Hamilton","GB","-27.43896","153.06287","7","0","0","0","0","0","0","7","1","4","2","0","7","4","0","2","0","6","3","2","2","0","0","7"
"Hamilton","GB","-37.78333","175.28333","7","0","0","0","0","0","0","7","1","4","2","0","7","4","0","2","0","6","3","2","2","0","0","7"
"Hammersmith","GB","51.49384","-0.22882","0","0","0","1","0","0","0","1","1","0","0","0","1","0","0","1","0","1","0","0","1","0","0","1"
"Hampton","GB","42.74192","-93.20242","6","0","0","0","0","0","0","6","0","2","3","0","5","1","0","5","0","6","0","1","4","0","1","6"
"Hampton","GB","44.61024","-93.00216","6","0","0","0","0","0","0","6","0","2","3","0","5","1","0","5","0","6","0","1","4","0","1","6"
"Hampton","GB","33.53789","-92.46988","6","0","0","0","0","0","0","6","0","2","3","0","5","1","0","5","0","6","0","1","4","0","1","6"
"Hampton","GB","41.55587","-90.4093","6","0","0","0","0","0","0","6","0","2","3","0","5","1","0","5","0","6","0","1","4","0","1","6"
"Hampton","GB","33.38706","-84.28298","6","0","0","0","0","0","0","6","0","2","3","0","5","1","0","5","0","6","0","1","4","0","1","6"
"Hampton","GB","32.87794","-81.12761","6","0","0","0","0","0","0","6","0","2","3","0","5","1","0","5","0","6","0","1","4","0","1","6"
"Hampton","GB","39.92954","-77.05831","6","0","0","0","0","0","0","6","0","2","3","0","5","1","0","5","0","6","0","1","4","0","1","6"
"Hampton","GB","39.42288","-76.58469","6","0","0","0","0","0","0","6","0","2","3","0","5","1","0","5","0","6","0","1","4","0","1","6"
"Hampton","GB","37.02987","-76.34522","6","0","0","0","0","0","0","6","0","2","3","0","5","1","0","5","0","6","0","1","4","0","1","6"
"Hampton","GB","40.70704","-74.956","6","0","0","0","0","0","0","6","0","2","3","0","5","1","0","5","0","6","0","1","4","0","1","6"
"Hampton","GB","43.52479","-73.25178","6","0","0","0","0","0","0","6","0","2","3","0","5","1","0","5","0","6","0","1","4","0","1","6"
"Hampton","GB","42.93759","-70.83894","6","0","0","0","0","0","0","6","0","2","3","0","5","1","0","5","0","6","0","1","4","0","1","6"
"Hampton","GB","45.52876","-65.85354","6","0","0","0","0","0","0","6","0","2","3","0","5","1","0","5","0","6","0","1","4","0","1","6"
"Hampton","GB","52.46667","-2.38333","6","0","0","0","0","0","0","6","0","2","3","0","5","1","0","5","0","6","0","1","4","0","1","6"
"Hampton","GB","51.41334","-0.36701","6","0","0","0","0","0","0","6","0","2","3","0","5","1","0","5","0","6","0","1","4","0","1","6"
"Hampton","GB","-37.95","145","6","0","0","0","0","0","0","6","0","2","3","0","5","1","0","5","0","6","0","1","4","0","1","6"
"Hanley Swan","GB","52.08373","-2.27383","1","0","0","0","0","0","0","1","0","0","1","0","1","0","1","0","0","1","0","0","1","0","0","1"
"Hanwell","GB","52.09124","-1.36763","1","0","0","0","0","0","0","1","0","0","1","0","1","0","0","1","0","1","0","0","1","0","0","1"
"Harbury","GB","52.23537","-1.45706","0","0","0","0","1","0","0","1","0","1","0","0","1","0","0","1","0","1","1","0","0","0","0","1"
"Harleston","GB","52.40302","1.29664","2","0","0","0","0","0","0","2","1","0","1","0","2","1","0","1","0","2","0","2","0","0","0","2"
"Harlow","GB","51.77655","0.11158","8","2","0","0","1","0","0","11","2","4","3","1","10","3","0","7","1","11","2","2","7","0","0","11"
"Harold Wood","GB","51.59462","0.23294","1","0","0","0","0","0","1","2","0","1","0","1","2","1","0","1","0","2","0","0","2","0","0","2"
"Harpenden","GB","51.81684","-0.35706","14","0","0","0","1","0","0","15","2","2","5","0","9","8","0","7","0","15","3","4","8","0","0","15"
"Harrietsham","GB","51.24252","0.6706","1","0","0","0","0","0","0","1","0","0","1","0","1","0","0","1","0","1","0","0","1","0","0","1"
"Harrogate","GB","36.5823","-83.65686","43","1","0","1","0","0","4","49","7","13","25","0","45","19","8","21","0","48","6","14","27","0","2","49"
"Harrogate","GB","53.99078","-1.5373","43","1","0","1","0","0","4","49","7","13","25","0","45","19","8","21","0","48","6","14","27","0","2","49"
"Harrold","GB","52.20127","-0.61038","1","0","0","0","0","0","0","1","0","0","1","0","1","0","1","0","0","1","0","0","1","0","0","1"
"Harrow","GB","51.57835","-0.33208","19","0","0","1","1","0","0","21","6","3","5","1","15","4","5","11","1","21","3","5","11","2","0","21"
"Harrow on the Hill","GB","51.57142","-0.33371","1","0","0","0","1","0","0","2","1","0","0","0","1","1","0","0","1","2","0","0","2","0","0","2"
"Hartlepool","GB","54.68554","-1.21028","15","0","0","0","1","0","0","16","1","10","3","1","15","4","6","6","0","16","9","2","5","0","0","16"
"Hartley Wintney","GB","51.30379","-0.90019","3","0","0","0","0","0","0","3","0","0","3","0","3","0","0","3","0","3","0","0","3","0","0","3"
"Harwell","GB","51.59947","-1.29175","1","0","0","0","0","0","0","1","0","0","0","0","0","0","0","1","0","1","1","0","0","0","0","1"
"Harwich","GB","41.68622","-70.07585","1","0","0","0","0","0","1","2","0","2","0","0","2","0","0","2","0","2","1","0","1","0","0","2"
"Harwich","GB","51.94194","1.28437","1","0","0","0","0","0","1","2","0","2","0","0","2","0","0","2","0","2","1","0","1","0","0","2"
"Haslemere","GB","51.09015","-0.70785","21","1","0","1","2","0","2","27","6","2","3","0","11","10","4","13","0","27","2","10","15","0","0","27"
"Haslingden","GB","53.70326","-2.32382","0","0","0","0","0","0","1","1","1","0","0","0","1","1","0","0","0","1","0","0","1","0","0","1"
"Hassocks","GB","50.92814","-0.16617","5","0","0","2","0","0","0","7","2","0","1","0","3","2","0","5","0","7","0","2","5","0","0","7"
"Hastings","GB","40.58612","-98.38839","33","2","0","2","8","0","3","48","12","16","16","0","44","16","10","22","0","48","13","21","14","0","0","48"
"Hastings","GB","44.7433","-92.85243","33","2","0","2","8","0","3","48","12","16","16","0","44","16","10","22","0","48","13","21","14","0","0","48"
"Hastings","GB","42.64587","-85.29084","33","2","0","2","8","0","3","48","12","16","16","0","44","16","10","22","0","48","13","21","14","0","0","48"
"Hastings","GB","29.71802","-81.50813","33","2","0","2","8","0","3","48","12","16","16","0","44","16","10","22","0","48","13","21","14","0","0","48"
"Hastings","GB","40.66507","-78.71225","33","2","0","2","8","0","3","48","12","16","16","0","44","16","10","22","0","48","13","21","14","0","0","48"
"Hastings","GB","8.37994","-13.13693","33","2","0","2","8","0","3","48","12","16","16","0","44","16","10","22","0","48","13","21","14","0","0","48"
"Hastings","GB","50.85519","0.57292","33","2","0","2","8","0","3","48","12","16","16","0","44","16","10","22","0","48","13","21","14","0","0","48"
"Hastings","GB","-38.3","145.18333","33","2","0","2","8","0","3","48","12","16","16","0","44","16","10","22","0","48","13","21","14","0","0","48"
"Hastings","GB","-39.6381","176.84918","33","2","0","2","8","0","3","48","12","16","16","0","44","16","10","22","0","48","13","21","14","0","0","48"
"Hatfield","GB","37.90255","-87.22417","13","0","0","1","0","0","1","15","2","3","5","0","10","5","5","5","0","15","2","0","13","0","0","15"
"Hatfield","GB","40.27983","-75.29934","13","0","0","1","0","0","1","15","2","3","5","0","10","5","5","5","0","15","2","0","13","0","0","15"
"Hatfield","GB","42.37092","-72.59814","13","0","0","1","0","0","1","15","2","3","5","0","10","5","5","5","0","15","2","0","13","0","0","15"
"Hatfield","GB","53.57788","-0.99924","13","0","0","1","0","0","1","15","2","3","5","0","10","5","5","5","0","15","2","0","13","0","0","15"
"Hatfield","GB","51.76338","-0.22419","13","0","0","1","0","0","1","15","2","3","5","0","10","5","5","5","0","15","2","0","13","0","0","15"
"Hatfield Heath","GB","51.81233","0.21243","1","0","0","0","0","0","0","1","0","0","0","0","0","1","0","0","0","1","1","0","0","0","0","1"
"Havant","GB","50.8567","-0.98559","6","0","0","0","0","0","0","6","1","2","3","0","6","3","2","1","0","6","2","1","3","0","0","6"
"Haverfordwest","GB","51.80169","-4.96914","83","0","0","1","8","0","2","94","19","20","14","1","54","27","9","58","0","94","24","42","24","0","4","94"
"Haverhill","GB","26.69118","-80.12004","4","0","0","1","1","0","0","6","1","2","3","0","6","2","2","2","0","6","2","2","2","0","0","6"
"Haverhill","GB","44.03451","-72.06398","4","0","0","1","1","0","0","6","1","2","3","0","6","2","2","2","0","6","2","2","2","0","0","6"
"Haverhill","GB","42.7762","-71.07728","4","0","0","1","1","0","0","6","1","2","3","0","6","2","2","2","0","6","2","2","2","0","0","6"
"Haverhill","GB","52.08226","0.43891","4","0","0","1","1","0","0","6","1","2","3","0","6","2","2","2","0","6","2","2","2","0","0","6"
"Hawick","GB","55.42273","-2.78666","1","0","0","0","0","0","0","1","0","0","1","0","1","0","0","1","0","1","0","0","1","0","0","1"
"Hawkhurst","GB","51.0479","0.51095","1","0","0","0","0","0","0","1","1","0","0","0","1","0","0","1","0","1","0","0","1","0","0","1"
"Hawthorn","GB","54.8","-1.35","1","0","0","0","0","0","0","1","0","1","0","0","1","1","0","0","0","1","0","0","1","0","0","1"
"Hawthorn","GB","-34.97384","138.60738","1","0","0","0","0","0","0","1","0","1","0","0","1","1","0","0","0","1","0","0","1","0","0","1"
"Hawthorn","GB","-37.81992","145.0358","1","0","0","0","0","0","0","1","0","1","0","0","1","1","0","0","0","1","0","0","1","0","0","1"
"Haydock","GB","53.46723","-2.68166","1","0","0","0","0","0","0","1","0","1","0","0","1","1","0","0","0","1","1","0","0","0","0","1"
"Hayes","GB","30.10882","-92.92015","2","1","0","0","0","0","0","3","3","0","0","0","3","2","0","1","0","3","0","1","2","0","0","3"
"Hayes","GB","17.87569","-77.23711","2","1","0","0","0","0","0","3","3","0","0","0","3","2","0","1","0","3","0","1","2","0","0","3"
"Hayes","GB","51.51579","-0.4234","2","1","0","0","0","0","0","3","3","0","0","0","3","2","0","1","0","3","0","1","2","0","0","3"
"Hayfield","GB","43.89052","-92.84769","1","0","0","0","0","0","0","1","0","0","1","0","1","1","0","0","0","1","0","0","1","0","0","1"
"Hayfield","GB","38.75178","-77.13581","1","0","0","0","0","0","0","1","0","0","1","0","1","1","0","0","0","1","0","0","1","0","0","1"
"Hayfield","GB","53.37893","-1.94544","1","0","0","0","0","0","0","1","0","0","1","0","1","1","0","0","0","1","0","0","1","0","0","1"
"Hayle","GB","50.18392","-5.42137","1","1","0","0","0","0","0","2","0","0","2","0","2","1","0","1","0","2","0","2","0","0","0","2"
"Hayling Island","GB","50.7838","-0.96869","2","0","0","0","2","0","0","4","2","0","0","0","2","1","0","3","0","4","1","0","3","0","0","4"
"Haywards Heath","GB","50.99769","-0.10313","15","1","0","0","1","0","2","19","6","4","5","0","15","8","2","9","0","19","2","4","13","0","0","19"
"Hazel Grove","GB","53.38333","-2.11667","1","0","0","0","0","0","0","1","0","1","0","0","1","1","0","0","0","1","0","0","1","0","0","1"
"Headcorn","GB","51.16966","0.62433","2","0","0","0","2","0","0","4","0","1","1","0","2","1","0","3","0","4","0","1","3","0","0","4"
"Heathfield","GB","50.96718","0.25612","2","1","0","0","0","0","1","4","0","1","3","0","4","0","1","3","0","4","1","1","2","0","0","4"
"Heathfield","GB","-35.02834","138.71724","2","1","0","0","0","0","1","4","0","1","3","0","4","0","1","3","0","4","1","1","2","0","0","4"
"Heaton Chapel","GB","53.43015","-2.17538","1","0","0","0","0","0","0","1","0","0","0","0","0","0","1","0","0","1","0","0","1","0","0","1"
"Hebburn","GB","54.97302","-1.51546","3","0","0","0","1","0","0","4","0","3","1","0","4","2","0","2","0","4","2","0","2","0","0","4"
"Hebden Bridge","GB","53.74093","-2.01337","3","0","0","0","1","0","0","4","0","2","1","0","3","2","0","2","0","4","0","1","3","0","0","4"
"Helensburgh","GB","56.00614","-4.72648","6","1","0","0","0","0","1","8","3","0","5","0","8","1","2","5","0","8","0","2","6","0","0","8"
"Helensburgh","GB","-34.17836","150.99522","6","1","0","0","0","0","1","8","3","0","5","0","8","1","2","5","0","8","0","2","6","0","0","8"
"Hellifield","GB","54.00486","-2.22302","1","0","0","0","0","0","0","1","0","1","0","0","1","0","1","0","0","1","0","0","1","0","0","1"
"Helsby","GB","53.27396","-2.76905","1","0","0","0","0","0","0","1","0","1","0","0","1","1","0","0","0","1","1","0","0","0","0","1"
"Helston","GB","50.10319","-5.27045","1","0","0","0","0","0","0","1","1","0","0","0","1","0","0","1","0","1","0","0","1","0","0","1"
"Hemel Hempstead","GB","51.75368","-0.44975","21","1","0","1","4","0","1","28","6","6","8","1","21","10","2","16","0","28","3","8","15","2","0","28"
"Hemingford Abbots","GB","52.32275","-0.11939","1","0","0","0","0","0","0","1","0","0","1","0","1","1","0","0","0","1","0","1","0","0","0","1"
"Hemyock","GB","50.91234","-3.22807","1","0","0","0","0","0","0","1","0","0","1","0","1","1","0","0","0","1","0","0","1","0","0","1"
"Henfield","GB","50.92995","-0.27071","4","0","0","0","0","0","0","4","1","1","1","0","3","3","0","1","0","4","1","0","3","0","0","4"
"Hengoed","GB","51.65083","-3.23167","2","0","0","0","1","0","0","3","1","1","1","0","3","0","0","3","0","3","1","0","2","0","0","3"
"Henley","GB","52.11802","1.15026","3","0","0","0","0","0","0","3","1","1","1","0","3","0","0","3","0","3","1","2","0","0","0","3"
"Henley-on-Thames","GB","51.53333","-0.9","4","0","0","0","0","0","0","4","1","1","0","0","2","3","0","1","0","4","0","0","4","0","0","4"
"Henlow","GB","52.03021","-0.28599","6","0","0","0","0","0","0","6","1","3","1","0","5","3","1","2","0","6","1","0","3","0","2","6"
"Herbrandston","GB","51.72639","-5.08667","1","0","0","0","0","0","0","1","0","1","0","0","1","0","0","1","0","1","0","0","1","0","0","1"
"Hereford","GB","34.81521","-102.39932","32","1","0","1","3","0","1","38","6","13","14","1","34","20","4","15","0","39","7","12","16","1","3","39"
"Hereford","GB","40.44926","-75.55213","32","1","0","1","3","0","1","38","6","13","14","1","34","20","4","15","0","39","7","12","16","1","3","39"
"Hereford","GB","52.05684","-2.71482","32","1","0","1","3","0","1","38","6","13","14","1","34","20","4","15","0","39","7","12","16","1","3","39"
"Herne Bay","GB","51.373","1.12857","3","0","0","0","0","0","0","3","0","1","1","0","2","0","2","1","0","3","1","1","1","0","0","3"
"Hertford","GB","36.19016","-76.46605","17","3","0","1","2","0","0","23","5","5","6","0","16","9","4","10","0","23","5","1","17","0","0","23"
"Hertford","GB","51.79588","-0.07854","17","3","0","1","2","0","0","23","5","5","6","0","16","9","4","10","0","23","5","1","17","0","0","23"
"Hessle","GB","53.72454","-0.43842","4","0","0","0","0","0","0","4","0","2","1","0","3","2","0","2","0","4","1","0","1","0","1","3"
"Heswall","GB","53.32733","-3.09648","1","0","0","0","1","0","0","2","0","1","0","1","2","1","0","1","0","2","1","0","1","0","0","2"
"Hetton-Le-Hole","GB","54.81667","-1.45","2","0","0","0","0","0","0","2","0","0","0","0","0","0","2","0","0","2","0","1","1","0","0","2"
"Hexham","GB","54.96986","-2.104","6","0","0","0","1","0","0","7","1","2","3","0","6","3","0","4","0","7","1","1","5","0","0","7"
"Heysham","GB","54.04367","-2.89322","1","0","0","0","0","0","0","1","0","0","1","0","1","0","1","0","0","1","0","0","1","0","0","1"
"Heywood","GB","53.59245","-2.21941","2","0","0","0","0","0","0","2","2","0","0","0","2","0","0","2","0","2","0","2","0","0","0","2"
"Heywood","GB","-38.13294","141.62949","2","0","0","0","0","0","0","2","2","0","0","0","2","0","0","2","0","2","0","2","0","0","0","2"
"High Bentham","GB","54.11823","-2.51199","1","0","0","0","0","0","0","1","0","1","0","0","1","0","1","0","0","1","1","0","0","0","0","1"
"Highbridge","GB","51.21667","-2.98333","1","0","0","0","0","0","0","1","0","0","0","0","0","0","1","0","0","1","1","0","0","0","0","1"
"Highclere","GB","51.3386","-1.37569","1","0","0","0","0","0","0","1","0","0","1","0","1","1","0","0","0","1","0","0","1","0","0","1"
"Highland","GB","46.13152","-119.11418","1","0","0","0","0","0","0","1","0","1","0","0","1","0","0","1","0","1","1","0","0","0","0","1"
"Highland","GB","34.12834","-117.20865","1","0","0","0","0","0","0","1","0","1","0","0","1","0","0","1","0","1","1","0","0","0","0","1"
"Highland","GB","40.42548","-111.79447","1","0","0","0","0","0","0","1","0","1","0","0","1","0","0","1","0","1","1","0","0","0","0","1"
"Highland","GB","39.85972","-95.2697","1","0","0","0","0","0","0","1","0","1","0","0","1","0","0","1","0","1","1","0","0","0","0","1"
"Highland","GB","39.21389","-94.8308","1","0","0","0","0","0","0","1","0","1","0","0","1","0","0","1","0","1","1","0","0","0","0","1"
"Highland","GB","36.2759","-91.52403","1","0","0","0","0","0","0","1","0","1","0","0","1","0","0","1","0","1","1","0","0","0","0","1"
"Highland","GB","43.04666","-90.37985","1","0","0","0","0","0","0","1","0","1","0","0","1","0","0","1","0","1","1","0","0","0","0","1"
"Highland","GB","38.73949","-89.6712","1","0","0","0","0","0","0","1","0","1","0","0","1","0","0","1","0","1","1","0","0","0","0","1"
"Highland","GB","38.03976","-87.57307","1","0","0","0","0","0","0","1","0","1","0","0","1","0","0","1","0","1","1","0","0","0","0","1"
"Highland","GB","41.55365","-87.45198","1","0","0","0","0","0","0","1","0","1","0","0","1","0","0","1","0","1","1","0","0","0","0","1"
"Highland","GB","39.179","-76.95748","1","0","0","0","0","0","0","1","0","1","0","0","1","0","0","1","0","1","1","0","0","0","0","1"
"Highland","GB","41.72093","-73.96014","1","0","0","0","0","0","0","1","0","1","0","0","1","0","0","1","0","1","1","0","0","0","0","1"
"Highland","GB","57.48566","-4.22823","1","0","0","0","0","0","0","1","0","1","0","0","1","0","0","1","0","1","1","0","0","0","0","1"
"High Peak","GB","53.36797","-1.84536","2","0","0","0","0","0","0","2","0","2","0","0","2","0","0","2","0","2","0","0","2","0","0","2"
"High Valleyfield","GB","56.06357","-3.59913","0","1","0","0","0","0","0","1","1","0","0","0","1","0","1","0","0","1","0","1","0","0","0","1"
"High Wycombe","GB","51.62907","-0.74934","31","2","0","2","2","0","3","40","3","9","16","2","30","20","4","16","0","40","4","12","24","0","0","40"
"High Wycombe","GB","-31.94444","116.0034","31","2","0","2","2","0","3","40","3","9","16","2","30","20","4","16","0","40","4","12","24","0","0","40"
"Hildenborough","GB","51.22947","0.24358","1","0","0","0","0","0","0","1","0","0","1","0","1","0","1","0","0","1","0","0","1","0","0","1"
"Hillsborough","GB","37.5741","-122.37942","1","0","0","0","0","0","0","1","0","1","0","0","1","0","0","1","0","1","0","0","1","0","0","1"
"Hillsborough","GB","36.07542","-79.09973","1","0","0","0","0","0","0","1","0","1","0","0","1","0","0","1","0","1","0","0","1","0","0","1"
"Hillsborough","GB","43.1141","-71.8992","1","0","0","0","0","0","0","1","0","1","0","0","1","0","0","1","0","1","0","0","1","0","0","1"
"Hillsborough","GB","12.48292","-61.45597","1","0","0","0","0","0","0","1","0","1","0","0","1","0","0","1","0","1","0","0","1","0","0","1"
"Hillsborough","GB","54.46345","-6.07664","1","0","0","0","0","0","0","1","0","1","0","0","1","0","0","1","0","1","0","0","1","0","0","1"
"Hillsborough","GB","-32.96553","151.67235","1","0","0","0","0","0","0","1","0","1","0","0","1","0","0","1","0","1","0","0","1","0","0","1"
"Hinckley","GB","39.32496","-112.67106","3","0","0","1","0","0","0","4","0","2","2","0","4","1","1","2","0","4","1","2","1","0","0","4"
"Hinckley","GB","46.01134","-92.94437","3","0","0","1","0","0","0","4","0","2","2","0","4","1","1","2","0","4","1","2","1","0","0","4"
"Hinckley","GB","41.76892","-88.64091","3","0","0","1","0","0","0","4","0","2","2","0","4","1","1","2","0","4","1","2","1","0","0","4"
"Hinckley","GB","52.5389","-1.37613","3","0","0","1","0","0","0","4","0","2","2","0","4","1","1","2","0","4","1","2","1","0","0","4"
"Hindhead","GB","51.11381","-0.73351","3","0","0","0","0","0","1","4","1","1","0","0","2","1","1","2","0","4","2","0","2","0","0","4"
"Hinton Charterhouse","GB","51.32377","-2.32841","1","0","0","0","0","0","0","1","1","0","0","0","1","0","1","0","0","1","0","0","1","0","0","1"
"Histon","GB","52.25166","0.10643","1","0","0","0","0","0","0","1","0","0","1","0","1","1","0","0","0","1","0","0","1","0","0","1"
"Hitchin","GB","51.94924","-0.28496","14","1","0","1","2","0","0","18","3","4","6","0","13","4","2","12","0","18","2","3","13","0","0","18"
"Hockley","GB","52.5","-1.91667","5","0","0","0","0","0","0","5","1","4","0","0","5","2","0","3","0","5","1","2","2","0","0","5"
"Hoddesdon","GB","51.76148","-0.01144","2","0","0","0","0","0","0","2","0","1","1","0","2","1","0","1","0","2","0","0","2","0","0","2"
"Holloway","GB","51.55237","-0.12497","0","0","0","0","1","0","0","1","1","0","0","0","1","0","0","1","0","1","0","1","0","0","0","1"
"Holmes Chapel","GB","53.2014","-2.35742","0","1","0","0","0","0","1","2","1","0","1","0","2","0","0","2","0","2","0","1","1","0","0","2"
"Holmfirth","GB","53.56968","-1.78777","3","0","0","0","0","0","0","3","1","0","2","0","3","0","0","3","0","3","0","0","3","0","0","3"
"Holt","GB","33.23401","-87.48445","4","0","0","0","0","0","0","4","3","0","1","0","4","1","0","3","0","4","0","3","1","0","0","4"
"Holt","GB","42.64059","-84.51525","4","0","0","0","0","0","0","4","3","0","1","0","4","1","0","3","0","4","0","3","1","0","0","4"
"Holt","GB","53.06667","-2.88333","4","0","0","0","0","0","0","4","3","0","1","0","4","1","0","3","0","4","0","3","1","0","0","4"
"Holt","GB","51.35556","-2.19722","4","0","0","0","0","0","0","4","3","0","1","0","4","1","0","3","0","4","0","3","1","0","0","4"
"Holt","GB","52.90591","1.08863","4","0","0","0","0","0","0","4","3","0","1","0","4","1","0","3","0","4","0","3","1","0","0","4"
"Holt","GB","54.81667","9.15","4","0","0","0","0","0","0","4","3","0","1","0","4","1","0","3","0","4","0","3","1","0","0","4"
"Holt","GB","46.57856","26.97499","4","0","0","0","0","0","0","4","3","0","1","0","4","1","0","3","0","4","0","3","1","0","0","4"
"Holt","GB","44.43333","119.2","4","0","0","0","0","0","0","4","3","0","1","0","4","1","0","3","0","4","0","3","1","0","0","4"
"Holt","GB","-35.22441","149.01188","4","0","0","0","0","0","0","4","3","0","1","0","4","1","0","3","0","4","0","3","1","0","0","4"
"Holyhead","GB","53.30621","-4.63211","1","0","0","0","0","0","1","2","0","1","1","0","2","1","0","1","0","2","0","1","0","0","1","2"
"Holywell","GB","53.27466","-3.22895","7","0","0","0","0","0","0","7","1","2","3","0","6","1","0","6","0","7","1","3","3","0","0","7"
"Holywell Green","GB","53.67406","-1.86682","1","0","0","0","0","0","0","1","0","1","0","0","1","1","0","0","0","1","0","1","0","0","0","1"
"Honiton","GB","50.7996","-3.18899","5","0","0","0","1","0","0","6","1","1","4","0","6","3","1","2","0","6","1","2","3","0","0","6"
"Hoo","GB","51.4205","0.563","1","0","0","0","0","0","0","1","0","1","0","0","1","0","1","0","0","1","1","0","0","0","0","1"
"Hook","GB","51.765","-4.93167","10","1","0","2","0","0","2","15","3","4","6","0","13","6","1","8","0","15","1","0","13","0","1","15"
"Hook","GB","51.28425","-0.95967","10","1","0","2","0","0","2","15","3","4","6","0","13","6","1","8","0","15","1","0","13","0","1","15"
"Hook","GB","53.72132","-0.84891","10","1","0","2","0","0","2","15","3","4","6","0","13","6","1","8","0","15","1","0","13","0","1","15"
"Hook","GB","51.36803","-0.3065","10","1","0","2","0","0","2","15","3","4","6","0","13","6","1","8","0","15","1","0","13","0","1","15"
"Hope Valley","GB","41.5076","-71.71618","1","0","0","0","0","0","1","2","1","0","1","0","2","0","0","2","0","2","0","1","1","0","0","2"
"Hope Valley","GB","53.34819","-1.74485","1","0","0","0","0","0","1","2","1","0","1","0","2","0","0","2","0","2","0","1","1","0","0","2"
"Hope Valley","GB","-34.83333","138.7","1","0","0","0","0","0","1","2","1","0","1","0","2","0","0","2","0","2","0","1","1","0","0","2"
"Hopton","GB","52.37293","0.92689","1","0","0","0","0","0","0","1","0","0","1","0","1","0","0","1","0","1","0","1","0","0","0","1"
"Horley","GB","51.17423","-0.15919","10","0","0","0","2","0","1","13","1","3","6","0","10","5","1","7","0","13","2","3","8","0","0","13"
"Hornchurch","GB","51.55685","0.21664","20","2","0","0","1","0","0","23","8","6","7","0","21","7","3","13","0","23","3","5","15","0","0","23"
"Hornsea","GB","53.91041","-0.16806","1","0","0","0","0","0","0","1","0","0","1","0","1","0","0","1","0","1","0","0","1","0","0","1"
"Horsham","GB","40.17844","-75.12851","17","1","0","0","2","0","2","22","3","4","10","1","18","8","2","12","0","22","0","11","11","0","0","22"
"Horsham","GB","51.06314","-0.32757","17","1","0","0","2","0","2","22","3","4","10","1","18","8","2","12","0","22","0","11","11","0","0","22"
"Horsham","GB","-36.71131","142.19981","17","1","0","0","2","0","2","22","3","4","10","1","18","8","2","12","0","22","0","11","11","0","0","22"
"Horwich","GB","53.60126","-2.54975","2","0","0","0","0","0","0","2","0","1","0","0","1","0","1","1","0","2","0","0","2","0","0","2"
"Houghton","GB","47.12187","-88.56901","1","0","0","0","0","0","0","1","0","1","0","0","1","0","0","1","0","1","0","1","0","0","0","1"
"Houghton","GB","42.4234","-78.15723","1","0","0","0","0","0","0","1","0","1","0","0","1","0","0","1","0","1","0","1","0","0","0","1"
"Houghton","GB","52.33282","-0.12068","1","0","0","0","0","0","0","1","0","1","0","0","1","0","0","1","0","1","0","1","0","0","0","1"
"Houghton-Le-Spring","GB","54.84034","-1.46427","2","0","0","0","0","0","0","2","0","1","1","0","2","1","0","1","0","2","1","1","0","0","0","2"
"Hounslow","GB","51.46839","-0.36092","7","1","0","1","3","0","0","12","4","1","2","0","7","5","0","7","0","12","2","3","7","0","0","12"
"Hove","GB","50.83088","-0.1672","24","0","0","2","0","0","4","30","2","6","15","1","24","11","2","17","0","30","3","9","17","0","1","30"
"Hove","GB","51.15446","4.4707","24","0","0","2","0","0","4","30","2","6","15","1","24","11","2","17","0","30","3","9","17","0","1","30"
"Hove","GB","-35.00814","138.5212","24","0","0","2","0","0","4","30","2","6","15","1","24","11","2","17","0","30","3","9","17","0","1","30"
"Hucknall","GB","53.03333","-1.2","1","0","0","0","0","0","0","1","0","0","0","0","0","0","0","1","0","1","1","0","0","0","0","1"
"Huddersfield","GB","53.64904","-1.78416","32","4","0","0","2","0","1","39","4","19","11","0","34","16","8","15","0","39","7","12","19","0","1","39"
"Hullavington","GB","51.53778","-2.15163","2","0","0","1","0","0","0","3","0","2","1","0","3","0","2","1","0","3","1","1","1","0","0","3"
"Humber","GB","52.2","-2.66667","4","0","0","0","1","0","0","5","0","4","1","0","5","2","1","2","0","5","2","3","0","0","0","5"
"Hundon","GB","52.10988","0.53644","1","0","0","0","0","0","0","1","1","0","0","0","1","0","0","1","0","1","0","1","0","0","0","1"
"Hungerford","GB","51.41513","-1.51556","2","0","0","0","0","0","0","2","0","0","1","0","1","0","0","2","0","2","0","0","2","0","0","2"
"Huntingdon","GB","36.00062","-88.42811","6","0","0","1","0","0","0","7","1","2","3","0","6","3","0","4","0","7","2","1","4","0","0","7"
"Huntingdon","GB","40.4848","-78.01028","6","0","0","1","0","0","0","7","1","2","3","0","6","3","0","4","0","7","2","1","4","0","0","7"
"Huntingdon","GB","45.08339","-74.16593","6","0","0","1","0","0","0","7","1","2","3","0","6","3","0","4","0","7","2","1","4","0","0","7"
"Huntingdon","GB","52.33049","-0.18651","6","0","0","1","0","0","0","7","1","2","3","0","6","3","0","4","0","7","2","1","4","0","0","7"
"Huntly","GB","57.44741","-2.78608","1","0","0","0","0","0","0","1","0","0","1","0","1","0","0","1","0","1","0","0","1","0","0","1"
"Huntly","GB","-36.66451","144.33382","1","0","0","0","0","0","0","1","0","0","1","0","1","0","0","1","0","1","0","0","1","0","0","1"
"Husbands Bosworth","GB","52.45232","-1.05557","1","0","0","0","0","0","0","1","0","1","0","0","1","0","0","1","0","1","0","0","1","0","0","1"
"Hutton","GB","51.32417","-2.93028","1","0","0","0","0","0","0","1","0","0","0","0","0","0","0","1","0","1","1","0","0","0","0","1"
"Hutton","GB","53.96667","-0.43333","1","0","0","0","0","0","0","1","0","0","0","0","0","0","0","1","0","1","1","0","0","0","0","1"
"Hyde","GB","41.00256","-78.46252","7","0","0","0","1","0","1","9","5","1","3","0","9","1","0","8","0","9","0","5","4","0","0","9"
"Hyde","GB","53.45131","-2.07943","7","0","0","0","1","0","1","9","5","1","3","0","9","1","0","8","0","9","0","5","4","0","0","9"
"Hythe","GB","50.86004","-1.40162","2","0","0","0","0","0","0","2","0","1","1","0","2","1","0","1","0","2","0","1","1","0","0","2"
"Hythe","GB","51.0715","1.08421","2","0","0","0","0","0","0","2","0","1","1","0","2","1","0","1","0","2","0","1","1","0","0","2"
"Ilford","GB","51.55765","0.07278","5","0","0","1","0","0","0","6","2","1","1","0","4","4","0","2","0","6","1","0","5","0","0","6"
"Ilfracombe","GB","51.2093","-4.11344","2","0","0","0","0","0","0","2","0","2","0","0","2","0","1","1","0","2","2","0","0","0","0","2"
"Ilkeston","GB","52.97055","-1.30951","4","0","0","0","0","0","1","5","0","2","3","0","5","0","2","3","0","5","1","2","2","0","0","5"
"Ilkley","GB","53.92449","-1.82326","9","0","0","0","1","0","0","10","2","0","3","0","5","5","1","4","0","10","2","3","5","0","0","10"
"Ilkley","GB","-26.73101","152.99766","9","0","0","0","1","0","0","10","2","0","3","0","5","5","1","4","0","10","2","3","5","0","0","10"
"Ilminster","GB","50.92684","-2.91009","6","0","0","0","0","0","0","6","1","0","3","0","4","4","0","2","0","6","0","5","1","0","0","6"
"Immingham","GB","53.6142","-0.21579","0","0","0","0","0","0","1","1","0","0","0","1","1","1","0","0","0","1","0","0","0","1","0","1"
"Inchture","GB","56.44551","-3.16956","0","0","0","0","1","0","0","1","0","1","0","0","1","0","1","0","0","1","1","0","0","0","0","1"
"Invergordon","GB","57.6886","-4.16745","0","0","0","1","0","0","0","1","1","0","0","0","1","0","0","1","0","1","0","1","0","0","0","1"
"Invergordon","GB","-36.16667","145.58333","0","0","0","1","0","0","0","1","1","0","0","0","1","0","0","1","0","1","0","1","0","0","0","1"
"Inverness","GB","38.10103","-122.85694","6","0","0","1","2","0","1","10","2","4","3","0","9","4","0","6","0","10","2","3","4","0","1","10"
"Inverness","GB","39.57738","-104.86135","6","0","0","1","2","0","1","10","2","4","3","0","9","4","0","6","0","10","2","3","4","0","1","10"
"Inverness","GB","33.35373","-90.59259","6","0","0","1","2","0","1","10","2","4","3","0","9","4","0","6","0","10","2","3","4","0","1","10"
"Inverness","GB","42.11808","-88.09619","6","0","0","1","2","0","1","10","2","4","3","0","9","4","0","6","0","10","2","3","4","0","1","10"
"Inverness","GB","32.01488","-85.74606","6","0","0","1","2","0","1","10","2","4","3","0","9","4","0","6","0","10","2","3","4","0","1","10"
"Inverness","GB","28.83582","-82.33037","6","0","0","1","2","0","1","10","2","4","3","0","9","4","0","6","0","10","2","3","4","0","1","10"
"Inverness","GB","57.47908","-4.22398","6","0","0","1","2","0","1","10","2","4","3","0","9","4","0","6","0","10","2","3","4","0","1","10"
"Inverness","GB","-23.11582","150.72306","6","0","0","1","2","0","1","10","2","4","3","0","9","4","0","6","0","10","2","3","4","0","1","10"
"Inverurie","GB","57.28446","-2.37736","1","0","0","0","0","0","0","1","0","0","0","0","0","1","0","0","0","1","1","0","0","0","0","1"
"Ipswich","GB","45.44442","-99.02928","42","1","0","1","5","0","4","53","10","13","23","1","47","16","7","30","0","53","7","19","22","2","3","53"
"Ipswich","GB","42.67926","-70.84116","42","1","0","1","5","0","4","53","10","13","23","1","47","16","7","30","0","53","7","19","22","2","3","53"
"Ipswich","GB","52.05917","1.15545","42","1","0","1","5","0","4","53","10","13","23","1","47","16","7","30","0","53","7","19","22","2","3","53"
"Ipswich","GB","-27.62343","152.76067","42","1","0","1","5","0","4","53","10","13","23","1","47","16","7","30","0","53","7","19","22","2","3","53"
"Irvine","GB","33.66946","-117.82311","9","0","0","0","0","0","0","9","1","4","2","0","7","3","0","6","0","9","3","4","2","0","0","9"
"Irvine","GB","37.70064","-83.97381","9","0","0","0","0","0","0","9","1","4","2","0","7","3","0","6","0","9","3","4","2","0","0","9"
"Irvine","GB","55.6194","-4.65508","9","0","0","0","0","0","0","9","1","4","2","0","7","3","0","6","0","9","3","4","2","0","0","9"
"Isle of Islay","GB","55.78526","-6.23886","1","0","0","0","0","0","0","1","0","1","0","0","1","0","1","0","0","1","1","0","0","0","0","1"
"Isle Of Mull","GB","56.44703","-5.77404","1","0","0","0","0","0","0","1","0","0","1","0","1","1","0","0","0","1","0","0","1","0","0","1"
"Isles of Scilly","GB","49.92515","-6.29894","1","0","0","0","0","0","0","1","0","1","0","0","1","0","0","1","0","1","1","0","0","0","0","1"
"Isleworth","GB","51.47518","-0.34246","13","1","0","1","0","0","0","15","4","1","9","0","14","2","2","10","1","15","1","4","10","0","0","15"
"Islington","GB","18.30922","-76.85482","1","0","0","0","0","0","0","1","0","0","0","0","0","0","0","1","0","1","0","0","1","0","0","1"
"Islington","GB","51.53622","-0.10304","1","0","0","0","0","0","0","1","0","0","0","0","0","0","0","1","0","1","0","0","1","0","0","1"
"Islington","GB","-32.91388","151.74739","1","0","0","0","0","0","0","1","0","0","0","0","0","0","0","1","0","1","0","0","1","0","0","1"
"Iver Heath","GB","51.53642","-0.5179","0","0","0","0","0","0","1","1","0","1","0","0","1","0","0","1","0","1","0","0","1","0","0","1"
"Ivybridge","GB","50.39039","-3.91914","2","0","0","0","0","0","0","2","0","0","2","0","2","0","1","1","0","2","0","0","2","0","0","2"
"Jameston","GB","51.65642","-4.81304","3","0","0","0","0","0","0","3","3","0","0","0","3","1","0","2","0","3","0","2","1","0","0","3"
"Jarrow","GB","54.98036","-1.48423","3","0","0","0","0","0","0","3","1","0","1","0","2","3","0","0","0","3","0","0","3","0","0","3"
"Johnston","GB","41.67304","-93.69772","2","0","0","0","1","0","0","3","0","0","0","0","0","2","1","0","0","3","3","0","0","0","0","3"
"Johnston","GB","33.83208","-81.80094","2","0","0","0","1","0","0","3","0","0","0","0","0","2","1","0","0","3","3","0","0","0","0","3"
"Johnston","GB","41.82186","-71.50675","2","0","0","0","1","0","0","3","0","0","0","0","0","2","1","0","0","3","3","0","0","0","0","3"
"Johnston","GB","51.75556","-4.99667","2","0","0","0","1","0","0","3","0","0","0","0","0","2","1","0","0","3","3","0","0","0","0","3"
"Johnston","GB","-12.48764","131.01169","2","0","0","0","1","0","0","3","0","0","0","0","0","2","1","0","0","3","3","0","0","0","0","3"
"Johnstone","GB","55.82906","-4.51605","3","0","0","0","0","0","0","3","1","1","0","0","2","1","0","2","0","3","1","1","1","0","0","3"
"Keighley","GB","53.86791","-1.90664","7","0","0","0","0","0","0","7","0","2","4","0","6","2","2","3","0","7","1","3","3","0","0","7"
"Keith","GB","57.53633","-2.94811","1","0","0","0","0","0","0","1","0","1","0","0","1","1","0","0","0","1","0","1","0","0","0","1"
"Keith","GB","-36.0991","140.35315","1","0","0","0","0","0","0","1","0","1","0","0","1","1","0","0","0","1","0","1","0","0","0","1"
"Kelloe","GB","54.71894","-1.47495","1","0","0","0","0","0","0","1","0","0","1","0","1","0","0","1","0","1","0","1","0","0","0","1"
"Kelsall","GB","53.20775","-2.71242","1","0","0","0","0","0","0","1","0","0","1","0","1","0","0","1","0","1","0","0","1","0","0","1"
"Kelso","GB","46.14678","-122.90844","6","0","0","0","2","0","1","9","0","2","6","0","8","2","0","6","1","9","1","5","2","0","1","9"
"Kelso","GB","37.19061","-89.54953","6","0","0","0","2","0","1","9","0","2","6","0","8","2","0","6","1","9","1","5","2","0","1","9"
"Kelso","GB","55.59814","-2.43382","6","0","0","0","2","0","1","9","0","2","6","0","8","2","0","6","1","9","1","5","2","0","1","9"
"Kelso","GB","-19.38932","146.71912","6","0","0","0","2","0","1","9","0","2","6","0","8","2","0","6","1","9","1","5","2","0","1","9"
"Kelso","GB","-33.41667","149.6","6","0","0","0","2","0","1","9","0","2","6","0","8","2","0","6","1","9","1","5","2","0","1","9"
"Kelvedon","GB","51.84007","0.7057","1","0","0","0","0","0","0","1","0","1","0","0","1","0","0","1","0","1","0","1","0","0","0","1"
"Kendal","GB","54.32681","-2.74757","7","0","0","0","2","0","0","9","1","4","3","0","8","3","3","3","0","9","2","4","2","0","1","9"
"Kendal","GB","-6.9213","110.2022","7","0","0","0","2","0","0","9","1","4","3","0","8","3","3","3","0","9","2","4","2","0","1","9"
"Kendal","GB","-8.1099","111.8483","7","0","0","0","2","0","0","9","1","4","3","0","8","3","3","3","0","9","2","4","2","0","1","9"
"Kendal","GB","-7.0436","113.5874","7","0","0","0","2","0","0","9","1","4","3","0","8","3","3","3","0","9","2","4","2","0","1","9"
"Kenilworth","GB","42.08586","-87.71756","4","0","0","0","1","0","0","5","1","3","1","0","5","0","0","5","0","5","1","2","2","0","0","5"
"Kenilworth","GB","40.23149","-75.63408","4","0","0","0","1","0","0","5","1","3","1","0","5","0","0","5","0","5","1","2","2","0","0","5"
"Kenilworth","GB","40.67649","-74.2907","4","0","0","0","1","0","0","5","1","3","1","0","5","0","0","5","0","5","1","2","2","0","0","5"
"Kenilworth","GB","52.34958","-1.58276","4","0","0","0","1","0","0","5","1","3","1","0","5","0","0","5","0","5","1","2","2","0","0","5"
"Kenilworth","GB","-26.59662","152.72807","4","0","0","0","1","0","0","5","1","3","1","0","5","0","0","5","0","5","1","2","2","0","0","5"
"Kenley","GB","52.6","-2.63333","1","1","0","0","0","0","1","3","2","1","0","0","3","0","0","3","0","3","1","1","1","0","0","3"
"Kensington","GB","37.91048","-122.28025","1","0","0","0","0","0","0","1","0","0","1","0","1","0","0","1","0","1","0","0","1","0","0","1"
"Kensington","GB","39.02567","-77.07637","1","0","0","0","0","0","0","1","0","0","1","0","1","0","0","1","0","1","0","0","1","0","0","1"
"Kensington","GB","40.64621","-73.97069","1","0","0","0","0","0","0","1","0","0","1","0","1","0","0","1","0","1","0","0","1","0","0","1"
"Kensington","GB","40.79343","-73.72208","1","0","0","0","0","0","0","1","0","0","1","0","1","0","0","1","0","1","0","0","1","0","0","1"
"Kensington","GB","41.63538","-72.76871","1","0","0","0","0","0","0","1","0","0","1","0","1","0","0","1","0","1","0","0","1","0","0","1"
"Kensington","GB","42.92703","-70.94394","1","0","0","0","0","0","0","1","0","0","1","0","1","0","0","1","0","1","0","0","1","0","0","1"
"Kensington","GB","46.43343","-63.64871","1","0","0","0","0","0","0","1","0","0","1","0","1","0","0","1","0","1","0","0","1","0","0","1"
"Kensington","GB","51.50094","-0.19175","1","0","0","0","0","0","0","1","0","0","1","0","1","0","0","1","0","1","0","0","1","0","0","1"
"Kensington","GB","-37.79188","144.93114","1","0","0","0","0","0","0","1","0","0","1","0","1","0","0","1","0","1","0","0","1","0","0","1"
"Kensington","GB","-33.92019","151.22241","1","0","0","0","0","0","0","1","0","0","1","0","1","0","0","1","0","1","0","0","1","0","0","1"
"Kensington","GB","-24.91711","152.31822","1","0","0","0","0","0","0","1","0","0","1","0","1","0","0","1","0","1","0","0","1","0","0","1"
"Kenton","GB","45.58178","-122.68149","1","0","0","0","0","0","0","1","1","0","0","0","1","0","0","1","0","1","0","1","0","0","0","1"
"Kenton","GB","36.20229","-89.01229","1","0","0","0","0","0","0","1","1","0","0","0","1","0","0","1","0","1","0","1","0","0","0","1"
"Kenton","GB","40.647","-83.60965","1","0","0","0","0","0","0","1","1","0","0","0","1","0","0","1","0","1","0","1","0","0","0","1"
"Kenton","GB","50.63978","-3.47151","1","0","0","0","0","0","0","1","1","0","0","0","1","0","0","1","0","1","0","1","0","0","0","1"
"Keswick","GB","44.25011","-79.46632","1","0","0","0","0","0","1","2","1","0","1","0","2","0","1","1","0","2","0","2","0","0","0","2"
"Keswick","GB","54.59947","-3.13256","1","0","0","0","0","0","1","2","1","0","1","0","2","0","1","1","0","2","0","2","0","0","0","2"
"Keswick","GB","-34.94178","138.57459","1","0","0","0","0","0","1","2","1","0","1","0","2","0","1","1","0","2","0","2","0","0","0","2"
"Kettering","GB","39.6895","-84.16883","14","1","0","0","5","0","0","20","2","7","2","2","13","10","3","7","0","20","6","2","11","0","1","20"
"Kettering","GB","38.88456","-76.81469","14","1","0","0","5","0","0","20","2","7","2","2","13","10","3","7","0","20","6","2","11","0","1","20"
"Kettering","GB","52.39836","-0.72571","14","1","0","0","5","0","0","20","2","7","2","2","13","10","3","7","0","20","6","2","11","0","1","20"
"Kettering","GB","-43.12623","147.24641","14","1","0","0","5","0","0","20","2","7","2","2","13","10","3","7","0","20","6","2","11","0","1","20"
"Keynsham","GB","51.41387","-2.4978","3","0","0","0","0","0","0","3","0","0","2","0","2","1","0","2","0","3","0","1","2","0","0","3"
"Kidderminster","GB","52.38819","-2.25","24","1","0","1","2","0","0","28","5","5","17","0","27","7","3","18","0","28","6","9","13","0","0","28"
"Kidlington","GB","51.82166","-1.2886","5","1","0","0","0","0","0","6","1","2","3","0","6","2","1","3","0","6","0","2","3","1","0","6"
"Kidsgrove","GB","53.08691","-2.23777","2","0","0","0","0","0","0","2","0","2","0","0","2","0","1","1","0","2","1","0","1","0","0","2"
"Kidwelly","GB","51.73639","-4.30333","1","0","0","0","0","0","0","1","0","1","0","0","1","0","0","1","0","1","1","0","0","0","0","1"
"Kilgetty","GB","51.73203","-4.71983","5","0","0","0","1","0","0","6","1","0","1","0","2","2","1","3","0","6","0","3","3","0","0","6"
"Killamarsh","GB","53.32395","-1.31688","1","0","0","0","0","0","0","1","0","0","1","0","1","0","0","1","0","1","0","0","1","0","0","1"
"Kilmarnock","GB","37.71041","-76.37967","17","2","0","0","1","0","1","21","3","12","6","0","21","6","5","10","0","21","5","7","9","0","0","21"
"Kilmarnock","GB","55.61171","-4.49581","17","2","0","0","1","0","1","21","3","12","6","0","21","6","5","10","0","21","5","7","9","0","0","21"
"Kilwinning","GB","55.65333","-4.70666","2","0","0","0","1","0","0","3","1","2","0","0","3","2","0","1","0","3","2","1","0","0","0","3"
"Kingsbridge","GB","50.28451","-3.77638","1","0","0","0","0","0","0","1","0","0","1","0","1","0","1","0","0","1","0","1","0","0","0","1"
"Kingsbury Episcopi","GB","50.98853","-2.80662","0","0","0","0","1","0","0","1","1","0","0","0","1","1","0","0","0","1","0","1","0","0","0","1"
"Kingsclere","GB","51.32487","-1.24339","1","0","0","0","0","0","0","1","0","0","0","0","0","1","0","0","0","1","0","0","1","0","0","1"
"Kings Hill","GB","51.27437","0.40237","0","0","0","0","0","0","1","1","0","0","1","0","1","0","1","0","0","1","0","0","1","0","0","1"
"Kings Langley","GB","51.71395","-0.45044","2","0","0","0","0","0","1","3","1","1","0","0","2","1","1","1","0","3","1","1","1","0","0","3"
"Kings Langley","GB","-33.75005","150.93542","2","0","0","0","0","0","1","3","1","1","0","0","2","1","1","1","0","3","1","1","1","0","0","3"
"King's Lynn","GB","52.75172","0.39516","3","0","0","0","1","0","1","5","2","1","0","0","3","1","1","3","0","5","0","2","2","0","1","5"
"Kingston upon Hull","GB","53.7446","-0.33525","26","1","0","0","6","0","3","36","7","11","14","1","33","11","7","18","0","36","7","10","18","0","1","36"
"Kingston upon Thames","GB","51.41259","-0.2974","16","2","0","6","2","0","5","31","12","6","9","1","28","9","6","16","0","31","2","14","14","0","1","31"
"Kingswinford","GB","52.49755","-2.16889","6","1","0","0","0","0","0","7","3","2","2","0","7","5","0","2","0","7","1","0","6","0","0","7"
"Kinloss","GB","57.63494","-3.57012","1","0","0","0","0","0","0","1","0","1","0","0","1","0","0","1","0","1","0","1","0","0","0","1"
"Kinross","GB","56.20466","-3.42138","1","0","0","0","0","0","1","2","0","0","1","0","1","1","1","0","0","2","0","0","2","0","0","2"
"Kinross","GB","-31.71868","115.73839","1","0","0","0","0","0","1","2","0","0","1","0","1","1","1","0","0","2","0","0","2","0","0","2"
"Kirkby Lonsdale","GB","54.20259","-2.59827","2","0","0","0","0","0","0","2","0","1","1","0","2","0","0","2","0","2","0","1","1","0","0","2"
"Kirkcaldy","GB","56.11683","-3.15999","7","0","0","0","0","0","0","7","0","3","4","0","7","1","2","4","0","7","2","2","3","0","0","7"
"Kirkham","GB","53.78244","-2.87189","0","0","0","0","0","0","0","0","0","0","1","0","1","1","0","0","0","1","0","0","1","0","0","1"
"Kirkham","GB","-34.03878","150.7111","0","0","0","0","0","0","0","0","0","0","1","0","1","1","0","0","0","1","0","0","1","0","0","1"
"Kirkliston","GB","55.95364","-3.40288","1","0","0","0","0","0","0","1","0","1","0","0","1","0","0","1","0","1","0","0","1","0","0","1"
"Kirkwall","GB","58.98479","-2.95873","4","0","0","0","0","0","0","4","0","0","1","0","1","1","0","3","0","4","1","2","0","0","1","4"
"Kirriemuir","GB","56.67398","-3.00343","2","0","0","0","0","0","0","2","0","1","1","0","2","1","0","1","0","2","0","2","0","0","0","2"
"Kirton","GB","52.92774","-0.06008","1","0","0","0","0","0","0","1","0","0","0","0","0","0","0","1","0","1","1","0","0","0","0","1"
"Knaresborough","GB","54.0091","-1.46851","10","0","0","1","1","0","0","12","3","2","5","0","10","3","2","7","0","12","0","3","9","0","0","12"
"Knebworth","GB","51.86674","-0.18394","0","0","0","1","0","0","0","1","1","0","0","0","1","0","0","1","0","1","0","0","1","0","0","1"
"Knighton","GB","52.34251","-3.04708","1","0","0","0","0","0","0","1","0","0","1","0","1","1","0","0","0","1","0","1","0","0","0","1"
"Knottingley","GB","53.70778","-1.25639","7","2","0","0","0","0","1","10","1","7","2","0","10","0","7","3","0","10","2","0","2","0","6","10"
"Knutsford","GB","53.30289","-2.37482","3","0","0","0","1","0","0","4","0","2","2","0","4","1","0","3","0","4","0","1","3","0","0","4"
"Lacock","GB","51.41528","-2.12194","1","0","0","0","0","0","0","1","0","0","1","0","1","0","0","1","0","1","0","0","1","0","0","1"
"Ladybank","GB","56.27421","-3.1239","0","0","0","1","0","0","0","1","1","0","0","0","1","1","0","0","0","1","0","0","1","0","0","1"
"Lambeth","GB","51.49635","-0.11152","1","2","0","0","1","0","0","4","3","0","1","0","4","1","0","3","0","4","0","0","3","1","0","4"
"Lampeter","GB","39.9901","-76.23968","4","0","0","0","0","0","0","4","0","2","1","0","3","3","1","0","0","4","1","1","2","0","0","4"
"Lampeter","GB","52.11285","-4.08039","4","0","0","0","0","0","0","4","0","2","1","0","3","3","1","0","0","4","1","1","2","0","0","4"
"Lamphey","GB","51.6664","-4.87205","2","0","0","0","0","0","0","2","0","0","0","0","0","1","0","1","0","2","0","1","1","0","0","2"
"Lanark","GB","42.10225","-89.83345","3","0","0","0","0","0","0","3","1","1","1","0","3","1","1","1","0","3","1","0","2","0","0","3"
"Lanark","GB","55.67371","-3.7817","3","0","0","0","0","0","0","3","1","1","1","0","3","1","1","1","0","3","1","0","2","0","0","3"
"Lancaster","GB","34.69804","-118.13674","20","0","0","0","2","0","1","23","8","10","4","0","22","5","3","15","0","23","5","7","8","0","3","23"
"Lancaster","GB","32.59208","-96.75611","20","0","0","0","2","0","1","23","8","10","4","0","22","5","3","15","0","23","5","7","8","0","3","23"
"Lancaster","GB","40.52086","-92.52797","20","0","0","0","2","0","1","23","8","10","4","0","22","5","3","15","0","23","5","7","8","0","3","23"
"Lancaster","GB","42.84749","-90.71068","20","0","0","0","2","0","1","23","8","10","4","0","22","5","3","15","0","23","5","7","8","0","3","23"
"Lancaster","GB","37.61952","-84.578","20","0","0","0","2","0","1","23","8","10","4","0","22","5","3","15","0","23","5","7","8","0","3","23"
"Lancaster","GB","39.71368","-82.59933","20","0","0","0","2","0","1","23","8","10","4","0","22","5","3","15","0","23","5","7","8","0","3","23"
"Lancaster","GB","34.72043","-80.7709","20","0","0","0","2","0","1","23","8","10","4","0","22","5","3","15","0","23","5","7","8","0","3","23"
"Lancaster","GB","42.90061","-78.67031","20","0","0","0","2","0","1","23","8","10","4","0","22","5","3","15","0","23","5","7","8","0","3","23"
"Lancaster","GB","37.76986","-76.46634","20","0","0","0","2","0","1","23","8","10","4","0","22","5","3","15","0","23","5","7","8","0","3","23"
"Lancaster","GB","40.03788","-76.30551","20","0","0","0","2","0","1","23","8","10","4","0","22","5","3","15","0","23","5","7","8","0","3","23"
"Lancaster","GB","42.45565","-71.67312","20","0","0","0","2","0","1","23","8","10","4","0","22","5","3","15","0","23","5","7","8","0","3","23"
"Lancaster","GB","44.48895","-71.56925","20","0","0","0","2","0","1","23","8","10","4","0","22","5","3","15","0","23","5","7","8","0","3","23"
"Lancaster","GB","54.04649","-2.79988","20","0","0","0","2","0","1","23","8","10","4","0","22","5","3","15","0","23","5","7","8","0","3","23"
"Lanchester","GB","54.82108","-1.74256","1","0","0","0","0","0","0","1","0","0","1","0","1","0","0","1","0","1","0","0","1","0","0","1"
"Lancing","GB","50.82882","-0.32247","7","0","0","0","0","0","0","7","0","2","3","0","5","3","0","4","0","7","2","2","3","0","0","7"
"Langport","GB","51.03778","-2.82806","1","0","0","0","0","0","0","1","0","1","0","0","1","1","0","0","0","1","1","0","0","0","0","1"
"Langtoft","GB","52.69834","-0.3404","0","0","0","0","1","0","0","1","1","0","0","0","1","0","0","1","0","1","0","0","1","0","0","1"
"Larbert","GB","56.02246","-3.82872","1","0","0","0","1","0","0","2","0","0","1","0","1","1","0","1","0","2","0","1","1","0","0","2"
"Largs","GB","55.79629","-4.86337","4","0","0","0","0","0","0","4","0","2","1","1","4","0","0","3","1","4","2","1","1","0","0","4"
"Largs","GB","-32.7","151.6","4","0","0","0","0","0","0","4","0","2","1","1","4","0","0","3","1","4","2","1","1","0","0","4"
"Larkhall","GB","55.73333","-3.96667","1","0","0","1","0","0","0","2","1","0","1","0","2","0","0","2","0","2","0","1","1","0","0","2"
"Lauder","GB","55.71908","-2.74755","1","0","0","0","0","0","0","1","0","0","1","0","1","1","0","0","0","1","0","0","1","0","0","1"
"Launceston","GB","50.63699","-4.36006","4","0","0","0","1","0","0","5","0","2","1","0","3","2","0","3","0","5","1","1","3","0","0","5"
"Launceston","GB","-41.43876","147.13467","4","0","0","0","1","0","0","5","0","2","1","0","3","2","0","3","0","5","1","1","3","0","0","5"
"Laurencekirk","GB","56.83338","-2.4654","1","0","0","0","0","0","0","1","0","1","0","0","1","0","1","0","0","1","1","0","0","0","0","1"
"Layer de la Haye","GB","51.84593","0.85745","1","0","0","0","0","0","0","1","0","0","1","0","1","0","0","1","0","1","0","0","1","0","0","1"
"Leatherhead","GB","51.29652","-0.3338","7","0","0","1","0","0","0","8","1","2","4","0","7","3","2","3","0","8","2","1","5","0","0","8"
"Lechlade","GB","51.69403","-1.69128","2","0","0","0","0","0","0","2","2","0","0","0","2","1","0","1","0","2","0","1","1","0","0","2"
"Leeds","GB","37.23859","-113.35912","138","6","0","7","17","0","6","174","31","51","59","2","143","69","25","79","1","174","24","34","114","0","3","175"
"Leeds","GB","33.54816","-86.54443","138","6","0","7","17","0","6","174","31","51","59","2","143","69","25","79","1","174","24","34","114","0","3","175"
"Leeds","GB","44.3034","-70.1195","138","6","0","7","17","0","6","174","31","51","59","2","143","69","25","79","1","174","24","34","114","0","3","175"
"Leeds","GB","53.79648","-1.54785","138","6","0","7","17","0","6","174","31","51","59","2","143","69","25","79","1","174","24","34","114","0","3","175"
"Leek","GB","53.10434","-2.02207","9","1","0","0","0","0","0","10","2","3","4","0","9","3","1","5","0","9","0","4","4","0","1","9"
"Leek","GB","53.1625","6.37639","9","1","0","0","0","0","0","10","2","3","4","0","9","3","1","5","0","9","0","4","4","0","1","9"
"Lee-on-the-Solent","GB","50.80169","-1.20174","1","0","0","0","0","0","0","1","0","0","1","0","1","0","0","1","0","1","0","0","1","0","0","1"
"Leicester","GB","43.86673","-73.10789","128","2","0","3","12","0","4","149","19","46","47","3","115","49","23","74","2","148","33","35","72","1","8","149"
"Leicester","GB","42.24593","-71.90868","128","2","0","3","12","0","4","149","19","46","47","3","115","49","23","74","2","148","33","35","72","1","8","149"
"Leicester","GB","52.6386","-1.13169","128","2","0","3","12","0","4","149","19","46","47","3","115","49","23","74","2","148","33","35","72","1","8","149"
"Leigh","GB","53.49642","-2.51973","5","0","0","0","1","0","0","6","2","2","2","0","6","1","1","4","0","6","1","1","4","0","0","6"
"Leigh","GB","52.17677","-2.31631","5","0","0","0","1","0","0","6","2","2","2","0","6","1","1","4","0","6","1","1","4","0","0","6"
"Leigh","GB","51.61667","-1.9","5","0","0","0","1","0","0","6","2","2","2","0","6","1","1","4","0","6","1","1","4","0","0","6"
"Leigh-on-Sea","GB","51.54297","0.64905","4","1","0","1","0","0","0","6","1","1","2","0","4","1","1","4","0","6","0","1","5","0","0","6"
"Leighton Buzzard","GB","51.91722","-0.65802","11","0","0","1","0","0","0","12","1","3","5","1","10","5","1","6","0","12","1","4","7","0","0","12"
"Leiston","GB","52.20611","1.57757","1","0","0","0","0","0","0","1","1","0","0","0","1","1","0","0","0","1","0","1","0","0","0","1"
"Lennoxtown","GB","55.97263","-4.20001","1","0","0","0","0","0","0","1","0","1","0","0","1","1","0","0","0","1","1","0","0","0","0","1"
"Leominster","GB","42.52509","-71.75979","2","0","0","0","0","0","0","2","0","2","0","0","2","2","0","0","0","2","1","0","1","0","0","2"
"Leominster","GB","52.22583","-2.74491","2","0","0","0","0","0","0","2","0","2","0","0","2","2","0","0","0","2","1","0","1","0","0","2"
"Letchworth Garden City","GB","51.97938","-0.22664","7","0","0","0","3","0","0","10","1","3","4","0","8","2","3","5","0","10","1","4","4","0","1","10"
"Leven","GB","56.2","-3","1","0","0","0","0","0","0","1","0","0","1","0","1","0","0","1","0","1","1","0","0","0","0","1"
"Leven","GB","53.89028","-0.31783","1","0","0","0","0","0","0","1","0","0","1","0","1","0","0","1","0","1","1","0","0","0","0","1"
"Levens","GB","54.26906","-2.78735","2","0","0","0","0","0","0","2","1","0","1","0","2","1","0","1","0","2","0","0","2","0","0","2"
"Levens","GB","43.85948","7.22583","2","0","0","0","0","0","0","2","1","0","1","0","2","1","0","1","0","2","0","0","2","0","0","2"
"Lewes","GB","38.77456","-75.13935","17","2","0","1","0","0","1","21","5","1","8","0","14","4","0","17","0","21","1","8","12","0","0","21"
"Lewes","GB","50.87398","0.0088","17","2","0","1","0","0","1","21","5","1","8","0","14","4","0","17","0","21","1","8","12","0","0","21"
"Leyland","GB","53.69786","-2.68758","4","0","0","0","1","0","3","8","1","3","2","0","6","2","1","5","0","8","3","1","4","0","0","8"
"Lichfield","GB","52.68154","-1.82549","18","0","0","1","3","0","0","22","4","3","3","0","10","7","4","10","1","22","4","2","15","0","1","22"
"Lifton","GB","50.64356","-4.28216","1","0","0","0","0","0","0","1","0","0","0","0","0","0","0","1","0","1","0","0","1","0","0","1"
"Lightwater","GB","51.34846","-0.67147","0","0","0","0","1","0","0","1","0","0","1","0","1","0","0","1","0","1","0","0","1","0","0","1"
"Limavady","GB","55.05045","-6.95074","3","0","0","1","0","0","0","4","1","1","2","0","4","2","0","2","0","4","1","2","1","0","0","4"
"Lincoln","GB","38.89156","-121.29301","30","1","0","2","2","0","2","37","7","15","11","0","33","13","6","18","0","37","10","9","16","0","2","37"
"Lincoln","GB","46.95494","-112.68171","30","1","0","2","2","0","2","37","7","15","11","0","33","13","6","18","0","37","10","9","16","0","2","37"
"Lincoln","GB","43.51297","-111.96441","30","1","0","2","2","0","2","37","7","15","11","0","33","13","6","18","0","37","10","9","16","0","2","37"
"Lincoln","GB","46.76249","-100.7004","30","1","0","2","2","0","2","37","7","15","11","0","33","13","6","18","0","37","10","9","16","0","2","37"
"Lincoln","GB","39.04084","-98.14477","30","1","0","2","2","0","2","37","7","15","11","0","33","13","6","18","0","37","10","9","16","0","2","37"
"Lincoln","GB","40.8","-96.66696","30","1","0","2","2","0","2","37","7","15","11","0","33","13","6","18","0","37","10","9","16","0","2","37"
"Lincoln","GB","35.94953","-94.42355","30","1","0","2","2","0","2","37","7","15","11","0","33","13","6","18","0","37","10","9","16","0","2","37"
"Lincoln","GB","38.39086","-93.33465","30","1","0","2","2","0","2","37","7","15","11","0","33","13","6","18","0","37","10","9","16","0","2","37"
"Lincoln","GB","40.14838","-89.36482","30","1","0","2","2","0","2","37","7","15","11","0","33","13","6","18","0","37","10","9","16","0","2","37"
"Lincoln","GB","33.61316","-86.11831","30","1","0","2","2","0","2","37","7","15","11","0","33","13","6","18","0","37","10","9","16","0","2","37"
"Lincoln","GB","40.31896","-79.85477","30","1","0","2","2","0","2","37","7","15","11","0","33","13","6","18","0","37","10","9","16","0","2","37"
"Lincoln","GB","44.10589","-72.99706","30","1","0","2","2","0","2","37","7","15","11","0","33","13","6","18","0","37","10","9","16","0","2","37"
"Lincoln","GB","44.04562","-71.67008","30","1","0","2","2","0","2","37","7","15","11","0","33","13","6","18","0","37","10","9","16","0","2","37"
"Lincoln","GB","41.92111","-71.435","30","1","0","2","2","0","2","37","7","15","11","0","33","13","6","18","0","37","10","9","16","0","2","37"
"Lincoln","GB","42.42593","-71.30395","30","1","0","2","2","0","2","37","7","15","11","0","33","13","6","18","0","37","10","9","16","0","2","37"
"Lincoln","GB","45.36228","-68.50502","30","1","0","2","2","0","2","37","7","15","11","0","33","13","6","18","0","37","10","9","16","0","2","37"
"Lincoln","GB","45.90012","-66.58218","30","1","0","2","2","0","2","37","7","15","11","0","33","13","6","18","0","37","10","9","16","0","2","37"
"Lincoln","GB","-34.86649","-61.5302","30","1","0","2","2","0","2","37","7","15","11","0","33","13","6","18","0","37","10","9","16","0","2","37"
"Lincoln","GB","53.22683","-0.53792","30","1","0","2","2","0","2","37","7","15","11","0","33","13","6","18","0","37","10","9","16","0","2","37"
"Lincoln","GB","-43.65","172.48333","30","1","0","2","2","0","2","37","7","15","11","0","33","13","6","18","0","37","10","9","16","0","2","37"
"Lingfield","GB","51.17719","-0.01558","1","0","0","0","0","0","0","1","0","0","1","0","1","1","0","0","0","1","0","0","1","0","0","1"
"Linlithgow","GB","55.97639","-3.60364","2","1","0","0","0","0","1","4","1","1","2","0","4","3","1","0","0","4","0","2","2","0","0","4"
"Linwood","GB","43.58171","-80.72815","0","1","0","0","0","0","0","1","0","0","1","0","1","0","0","1","0","1","0","0","1","0","0","1"
"Linwood","GB","39.8265","-75.42547","0","1","0","0","0","0","0","1","0","0","1","0","1","0","0","1","0","1","0","0","1","0","0","1"
"Linwood","GB","39.33984","-74.57516","0","1","0","0","0","0","0","1","0","0","1","0","1","0","0","1","0","1","0","0","1","0","0","1"
"Linwood","GB","55.84834","-4.49337","0","1","0","0","0","0","0","1","0","0","1","0","1","0","0","1","0","1","0","0","1","0","0","1"
"Liphook","GB","51.07673","-0.8032","2","1","0","0","0","0","1","4","3","0","0","0","3","1","2","1","0","4","0","2","1","0","1","4"
"Lisburn","GB","54.52337","-6.03527","6","0","0","0","0","0","1","7","0","2","3","1","6","0","1","6","0","7","1","3","3","0","0","7"
"Liskeard","GB","50.4545","-4.46517","4","0","0","1","0","0","0","5","2","1","1","1","5","1","0","4","0","5","0","4","1","0","0","5"
"Liss","GB","51.04277","-0.89238","1","0","0","0","1","0","1","3","1","0","1","0","2","2","0","1","0","3","0","1","2","0","0","3"
"Litherland","GB","53.46993","-2.99809","0","1","0","0","0","0","0","1","0","0","1","0","1","0","0","1","0","1","0","0","1","0","0","1"
"Littlehampton","GB","50.81137","-0.54078","2","0","0","0","0","0","1","3","1","0","3","0","4","1","0","3","0","4","0","3","1","0","0","4"
"Liverpool","GB","29.29496","-95.27882","120","8","0","9","13","0","8","158","25","40","48","5","118","66","19","69","3","157","31","40","79","1","6","157"
"Liverpool","GB","40.57481","-76.98915","120","8","0","9","13","0","8","158","25","40","48","5","118","66","19","69","3","157","31","40","79","1","6","157"
"Liverpool","GB","43.10646","-76.2177","120","8","0","9","13","0","8","158","25","40","48","5","118","66","19","69","3","157","31","40","79","1","6","157"
"Liverpool","GB","53.41058","-2.97794","120","8","0","9","13","0","8","158","25","40","48","5","118","66","19","69","3","157","31","40","79","1","6","157"
"Liverpool","GB","-33.91938","150.92588","120","8","0","9","13","0","8","158","25","40","48","5","118","66","19","69","3","157","31","40","79","1","6","157"
"Liversedge","GB","53.70514","-1.69327","2","0","0","1","0","0","0","3","0","0","3","0","3","2","0","1","0","3","2","1","0","0","0","3"
"Livingston","GB","37.38688","-120.72353","3","0","0","0","2","0","0","5","1","1","1","0","3","1","1","3","0","5","1","0","4","0","0","5"
"Livingston","GB","45.66244","-110.56104","3","0","0","0","2","0","0","5","1","1","1","0","3","1","1","3","0","5","1","0","4","0","0","5"
"Livingston","GB","30.71103","-94.93299","3","0","0","0","2","0","0","5","1","1","1","0","3","1","1","3","0","5","1","0","4","0","0","5"
"Livingston","GB","30.50213","-90.74787","3","0","0","0","2","0","0","5","1","1","1","0","3","1","1","3","0","5","1","0","4","0","0","5"
"Livingston","GB","42.89999","-90.43096","3","0","0","0","2","0","0","5","1","1","1","0","3","1","1","3","0","5","1","0","4","0","0","5"
"Livingston","GB","38.96755","-89.76398","3","0","0","0","2","0","0","5","1","1","1","0","3","1","1","3","0","5","1","0","4","0","0","5"
"Livingston","GB","32.5843","-88.18725","3","0","0","0","2","0","0","5","1","1","1","0","3","1","1","3","0","5","1","0","4","0","0","5"
"Livingston","GB","36.3834","-85.32302","3","0","0","0","2","0","0","5","1","1","1","0","3","1","1","3","0","5","1","0","4","0","0","5"
"Livingston","GB","40.79593","-74.31487","3","0","0","0","2","0","0","5","1","1","1","0","3","1","1","3","0","5","1","0","4","0","0","5"
"Livingston","GB","55.90288","-3.52261","3","0","0","0","2","0","0","5","1","1","1","0","3","1","1","3","0","5","1","0","4","0","0","5"
"Llanberis","GB","53.11809","-4.12923","1","0","0","0","0","0","0","1","0","1","0","0","1","0","0","1","0","1","1","0","0","0","0","1"
"Llanboidy","GB","51.87889","-4.59278","1","0","0","0","0","0","0","1","0","0","0","0","0","0","0","1","0","1","0","1","0","0","0","1"
"Llanbradach","GB","51.60639","-3.23028","0","0","0","0","0","0","0","0","0","0","0","0","0","0","0","0","0","0","0","0","0","0","0","0"
"Llandovery","GB","51.99415","-3.79637","1","0","0","0","0","0","0","1","0","0","1","0","1","0","0","1","0","1","0","0","1","0","0","1"
"Llandrindod Wells","GB","52.24164","-3.37868","4","0","0","0","1","0","0","5","1","1","3","0","5","2","1","2","0","5","1","0","4","0","0","5"
"Llandudno","GB","53.32498","-3.83148","4","1","0","0","0","0","0","5","2","1","1","0","4","2","0","3","0","5","1","2","2","0","0","5"
"Llandybie","GB","51.82044","-4.0071","1","0","0","0","0","0","0","1","0","0","0","0","0","0","0","1","0","1","0","0","1","0","0","1"
"Llandysul","GB","52.04166","-4.30909","3","0","0","0","0","0","0","3","0","0","3","0","3","3","0","0","0","3","1","1","1","0","0","3"
"Llanelli","GB","51.68195","-4.16191","18","1","0","3","5","0","2","29","6","12","7","1","26","14","4","10","1","29","10","6","11","0","1","28"
"Llangattock","GB","51.85184","-3.14778","1","0","0","0","0","0","0","1","1","0","0","0","1","1","0","0","0","1","0","0","1","0","0","1"
"Llangefni","GB","53.25561","-4.31063","1","0","0","0","0","0","0","1","0","0","1","0","1","1","0","0","0","1","0","0","1","0","0","1"
"Llangollen","GB","52.96829","-3.17127","0","0","0","1","1","0","0","2","1","0","1","0","2","1","0","1","0","2","0","0","2","0","0","2"
"Llangwm","GB","51.74833","-4.91361","2","0","0","0","0","0","0","2","0","0","2","0","2","0","0","2","0","2","0","2","0","0","0","2"
"Llangwm","GB","52.98333","-3.53333","2","0","0","0","0","0","0","2","0","0","2","0","2","0","0","2","0","2","0","2","0","0","0","2"
"Llangwm","GB","51.69611","-2.83","2","0","0","0","0","0","0","2","0","0","2","0","2","0","0","2","0","2","0","2","0","0","0","2"
"Llanrhaeadr-ym-Mochnant","GB","52.82507","-3.30225","1","0","0","0","0","0","0","1","0","0","1","0","1","0","0","1","0","1","0","1","0","0","0","1"
"Llantrisant","GB","51.54028","-3.37389","1","0","0","0","0","0","0","1","0","0","1","0","1","0","0","1","0","1","0","0","1","0","0","1"
"Llantwit Fardre","GB","51.5546","-3.33241","1","0","0","0","0","0","0","1","0","1","0","0","1","0","0","1","0","1","1","0","0","0","0","1"
"Llantwit Major","GB","51.4107","-3.48632","3","0","0","0","0","0","0","3","1","0","2","0","3","1","1","1","0","3","0","1","2","0","0","3"
"Loans","GB","55.5504","-4.6241","0","0","0","0","0","0","1","1","0","0","0","0","0","1","0","0","0","1","0","1","0","0","0","1"
"Lochgilphead","GB","56.03796","-5.43206","1","0","0","0","0","0","0","1","0","0","1","0","1","0","0","1","0","1","0","0","1","0","0","1"
"Lochwinnoch","GB","55.79521","-4.63034","1","0","0","0","0","0","0","1","1","0","0","0","1","0","0","1","0","1","0","1","0","0","0","1"
"Lockerbie","GB","55.12302","-3.35635","2","0","0","0","0","0","0","2","0","0","2","0","2","0","0","2","0","2","0","1","1","0","0","2"
"Loddington","GB","52.39734","-0.80174","1","0","0","0","0","0","0","1","0","1","0","0","1","0","0","1","0","1","0","0","1","0","0","1"
"Loftus","GB","54.55543","-0.89459","1","0","0","0","0","0","0","1","0","0","0","0","0","0","1","0","0","1","0","0","0","0","1","1"
"Loftus","GB","-34.04467","151.04646","1","0","0","0","0","0","0","1","0","0","0","0","0","0","1","0","0","1","0","0","0","0","1","1"
"Londesborough","GB","53.88333","-0.68333","1","0","0","1","0","0","0","2","1","0","0","0","1","1","0","1","0","2","0","1","1","0","0","2"
"London","GB","36.47606","-119.44318","1982","117","6","198","196","3","264","2766","674","430","748","33","1885","1044","351","1360","12","2767","199","432","1952","82","100","2765"
"London","GB","35.32897","-93.25296","1982","117","6","198","196","3","264","2766","674","430","748","33","1885","1044","351","1360","12","2767","199","432","1952","82","100","2765"
"London","GB","37.12898","-84.08326","1982","117","6","198","196","3","264","2766","674","430","748","33","1885","1044","351","1360","12","2767","199","432","1952","82","100","2765"
"London","GB","39.88645","-83.44825","1982","117","6","198","196","3","264","2766","674","430","748","33","1885","1044","351","1360","12","2767","199","432","1952","82","100","2765"
"London","GB","42.98339","-81.23304","1982","117","6","198","196","3","264","2766","674","430","748","33","1885","1044","351","1360","12","2767","199","432","1952","82","100","2765"
"London","GB","51.50853","-0.12574","1982","117","6","198","196","3","264","2766","674","430","748","33","1885","1044","351","1360","12","2767","199","432","1952","82","100","2765"
"Londonderry County Borough","GB","54.99721","-7.30917","16","1","0","4","2","0","0","23","7","3","8","0","18","10","2","11","0","23","3","8","11","0","1","23"
"Long Bennington","GB","52.99314","-0.75803","1","0","0","0","0","0","0","1","0","1","0","0","1","0","0","1","0","1","0","0","1","0","0","1"
"Long Clawson","GB","52.83725","-0.9288","1","0","0","0","0","0","0","1","0","1","0","0","1","1","0","0","0","1","0","0","1","0","0","1"
"Long Crendon","GB","51.77294","-0.99684","2","0","0","0","0","0","0","2","0","1","1","0","2","0","1","1","0","2","1","0","1","0","0","2"
"Long Eaton","GB","52.89855","-1.27136","4","0","0","0","0","0","0","4","0","3","1","0","4","0","4","0","0","4","1","0","1","0","2","4"
"Longfield","GB","51.3969","0.30212","2","0","0","1","1","0","0","4","2","1","1","0","4","1","0","3","0","4","0","0","4","0","0","4"
"Looe","GB","50.35778","-4.45418","2","0","0","0","0","0","0","2","0","1","1","0","2","1","0","1","0","2","0","1","1","0","0","2"
"Lossiemouth","GB","57.72136","-3.28341","1","0","0","0","0","0","1","2","0","1","1","0","2","0","1","1","0","2","1","0","1","0","0","2"
"Loughborough","GB","52.76667","-1.2","18","2","0","0","4","0","0","24","10","3","5","0","18","11","0","13","0","24","1","4","19","0","0","24"
"Loughton","GB","52.03037","-0.78642","5","0","0","0","0","0","1","6","1","1","2","0","4","2","1","3","0","6","0","0","5","0","0","5"
"Louth","GB","53.94861","-6.54139","4","0","0","0","0","0","0","4","0","0","3","0","3","1","0","3","0","4","0","3","1","0","0","4"
"Louth","GB","53.36664","-0.00438","4","0","0","0","0","0","0","4","0","0","3","0","3","1","0","3","0","4","0","3","1","0","0","4"
"Lowestoft","GB","52.47523","1.75167","4","0","0","0","0","0","0","4","0","2","1","0","3","3","1","0","0","4","2","1","1","0","0","4"
"Loxwood","GB","51.07781","-0.51872","0","0","0","0","1","0","0","1","0","0","1","0","1","0","0","1","0","1","0","0","1","0","0","1"
"Luddenden Foot","GB","53.71873","-1.94582","1","0","0","0","0","0","0","1","1","0","0","0","1","1","0","0","0","1","0","1","0","0","0","1"
"Ludlow","GB","39.09256","-84.54744","4","0","0","0","0","0","0","4","0","3","1","0","4","1","1","2","0","4","2","1","1","0","0","4"
"Ludlow","GB","43.39591","-72.70065","4","0","0","0","0","0","0","4","0","3","1","0","4","1","1","2","0","4","2","1","1","0","0","4"
"Ludlow","GB","42.16009","-72.47592","4","0","0","0","0","0","0","4","0","3","1","0","4","1","1","2","0","4","2","1","1","0","0","4"
"Ludlow","GB","52.37431","-2.71311","4","0","0","0","0","0","0","4","0","3","1","0","4","1","1","2","0","4","2","1","1","0","0","4"
"Lundin Links","GB","56.21399","-2.95173","0","0","0","0","0","0","1","1","0","1","0","0","1","0","0","1","0","1","0","0","1","0","0","1"
"Luton","GB","51.87967","-0.41748","25","0","0","1","2","0","0","28","3","5","12","1","21","8","6","13","0","27","3","7","16","2","0","28"
"Lutterworth","GB","52.45634","-1.20218","2","0","0","0","0","0","1","3","0","1","1","0","2","1","0","2","0","3","0","2","1","0","0","3"
"Lydbrook","GB","51.83763","-2.57818","1","0","0","0","0","0","0","1","0","0","1","0","1","0","0","1","0","1","0","1","0","0","0","1"
"Lydd","GB","50.95132","0.90654","2","0","0","0","0","0","0","2","0","0","2","0","2","0","1","1","0","2","0","2","0","0","0","2"
"Lydney","GB","51.72598","-2.52605","3","0","0","0","1","0","0","4","1","0","2","0","3","1","0","3","0","4","0","1","3","0","0","4"
"Lymington","GB","50.75767","-1.5443","5","0","0","0","0","0","0","5","1","2","1","0","4","2","1","2","0","5","2","1","2","0","0","5"
"Lymm","GB","53.38105","-2.47763","1","0","0","0","0","0","1","2","1","0","1","0","2","1","0","1","0","2","0","0","2","0","0","2"
"Lympstone","GB","50.64751","-3.43162","2","0","0","0","0","0","0","2","0","1","1","0","2","1","1","0","0","2","0","0","0","1","1","2"
"Lyndhurst","GB","41.52005","-81.48873","1","0","0","0","0","0","0","1","0","0","1","0","1","0","0","1","0","1","0","0","1","0","0","1"
"Lyndhurst","GB","38.0293","-78.94502","1","0","0","0","0","0","0","1","0","0","1","0","1","0","0","1","0","1","0","0","1","0","0","1"
"Lyndhurst","GB","40.81204","-74.12431","1","0","0","0","0","0","0","1","0","0","1","0","1","0","0","1","0","1","0","0","1","0","0","1"
"Lyndhurst","GB","50.87259","-1.57662","1","0","0","0","0","0","0","1","0","0","1","0","1","0","0","1","0","1","0","0","1","0","0","1"
"Lytham St Annes","GB","53.7426","-2.997","8","0","0","1","1","0","1","11","2","7","1","0","10","3","1","7","0","11","2","2","7","0","0","11"
"Mablethorpe","GB","53.3409","0.26102","1","0","0","0","0","0","0","1","0","1","0","0","1","1","0","0","0","1","1","0","0","0","0","1"
"Macclesfield","GB","53.26023","-2.12564","8","0","0","0","1","0","1","10","3","3","2","0","8","5","0","4","1","10","1","3","5","0","1","10"
"Macclesfield","GB","-35.17182","138.83589","8","0","0","0","1","0","1","10","3","3","2","0","8","5","0","4","1","10","1","3","5","0","1","10"
"Macclesfield","GB","-37.88333","145.48333","8","0","0","0","1","0","1","10","3","3","2","0","8","5","0","4","1","10","1","3","5","0","1","10"
"Machen","GB","51.59599","-3.1419","1","0","0","0","0","0","0","1","0","1","0","0","1","1","0","0","0","1","1","0","0","0","0","1"
"Maenclochog","GB","51.91183","-4.78754","1","0","0","0","0","0","0","1","1","0","0","0","1","0","0","1","0","1","0","1","0","0","0","1"
"Maesteg","GB","51.60926","-3.65823","2","0","0","0","0","0","0","2","0","0","1","0","1","1","0","1","0","2","0","1","1","0","0","2"
"Magherafelt","GB","54.75356","-6.60656","4","0","0","0","0","0","0","4","2","2","0","0","4","1","1","2","0","4","2","0","2","0","0","4"
"Maidenhead","GB","51.52279","-0.71986","27","1","0","3","3","0","2","36","11","8","6","1","26","16","2","18","0","36","3","9","22","0","2","36"
"Maiden Newton","GB","50.77909","-2.57226","1","0","0","0","0","0","0","1","0","0","0","0","0","0","0","1","0","1","0","1","0","0","0","1"
"Maidstone","GB","51.26667","0.51667","46","2","0","2","4","0","1","55","8","17","17","1","43","20","2","33","0","55","10","17","27","0","1","55"
"Maidstone","GB","-37.78035","144.87353","46","2","0","2","4","0","1","55","8","17","17","1","43","20","2","33","0","55","10","17","27","0","1","55"
"Maldon","GB","51.7311","0.67463","2","0","0","0","3","0","0","5","0","3","2","0","5","1","3","1","0","5","2","0","2","1","0","5"
"Maldon","GB","-36.9957","144.06834","2","0","0","0","3","0","0","5","0","3","2","0","5","1","3","1","0","5","2","0","2","1","0","5"
"Malmesbury","GB","51.58175","-2.09708","7","0","0","0","0","0","1","8","1","2","5","0","8","2","1","5","0","8","0","2","5","0","1","8"
"Malmesbury","GB","-33.4608","18.72714","7","0","0","0","0","0","1","8","1","2","5","0","8","2","1","5","0","8","0","2","5","0","1","8"
"Malpas","GB","53.01667","-2.76667","3","0","0","0","1","0","0","4","0","1","1","0","2","0","1","3","0","4","1","1","2","0","0","4"
"Malton","GB","54.13695","-0.7996","3","0","0","0","0","0","0","3","0","3","0","0","3","1","1","1","0","3","2","0","1","0","0","3"
"Manby","GB","53.36291","0.09653","1","0","0","0","0","0","0","1","0","0","0","0","0","0","0","1","0","1","0","0","1","0","0","1"
"Manchester","GB","47.55566","-122.54507","167","5","0","10","28","0","13","223","40","74","69","2","185","73","36","112","1","222","52","45","123","1","4","225"
"Manchester","GB","42.48415","-91.45543","167","5","0","10","28","0","13","223","40","74","69","2","185","73","36","112","1","222","52","45","123","1","4","225"
"Manchester","GB","38.597","-90.50929","167","5","0","10","28","0","13","223","40","74","69","2","185","73","36","112","1","222","52","45","123","1","4","225"
"Manchester","GB","43.69054","-89.04845","167","5","0","10","28","0","13","223","40","74","69","2","185","73","36","112","1","222","52","45","123","1","4","225"
"Manchester","GB","35.48174","-86.0886","167","5","0","10","28","0","13","223","40","74","69","2","185","73","36","112","1","222","52","45","123","1","4","225"
"Manchester","GB","32.85985","-84.61993","167","5","0","10","28","0","13","223","40","74","69","2","185","73","36","112","1","222","52","45","123","1","4","225"
"Manchester","GB","42.15032","-84.03772","167","5","0","10","28","0","13","223","40","74","69","2","185","73","36","112","1","222","52","45","123","1","4","225"
"Manchester","GB","37.1537","-83.76186","167","5","0","10","28","0","13","223","40","74","69","2","185","73","36","112","1","222","52","45","123","1","4","225"
"Manchester","GB","38.68813","-83.60936","167","5","0","10","28","0","13","223","40","74","69","2","185","73","36","112","1","222","52","45","123","1","4","225"
"Manchester","GB","40.937","-81.56929","167","5","0","10","28","0","13","223","40","74","69","2","185","73","36","112","1","222","52","45","123","1","4","225"
"Manchester","GB","42.96979","-77.23026","167","5","0","10","28","0","13","223","40","74","69","2","185","73","36","112","1","222","52","45","123","1","4","225"
"Manchester","GB","39.66121","-76.88498","167","5","0","10","28","0","13","223","40","74","69","2","185","73","36","112","1","222","52","45","123","1","4","225"
"Manchester","GB","40.06315","-76.7183","167","5","0","10","28","0","13","223","40","74","69","2","185","73","36","112","1","222","52","45","123","1","4","225"
"Manchester","GB","43.16369","-73.07233","167","5","0","10","28","0","13","223","40","74","69","2","185","73","36","112","1","222","52","45","123","1","4","225"
"Manchester","GB","41.77593","-72.52148","167","5","0","10","28","0","13","223","40","74","69","2","185","73","36","112","1","222","52","45","123","1","4","225"
"Manchester","GB","42.99564","-71.45479","167","5","0","10","28","0","13","223","40","74","69","2","185","73","36","112","1","222","52","45","123","1","4","225"
"Manchester","GB","44.32451","-69.86033","167","5","0","10","28","0","13","223","40","74","69","2","185","73","36","112","1","222","52","45","123","1","4","225"
"Manchester","GB","53.48095","-2.23743","167","5","0","10","28","0","13","223","40","74","69","2","185","73","36","112","1","222","52","45","123","1","4","225"
"Manningtree","GB","51.94538","1.06112","0","0","0","0","1","0","0","1","0","0","1","0","1","0","0","1","0","1","0","1","0","0","0","1"
"Manorbier","GB","51.64614","-4.79901","0","0","0","0","1","0","0","1","1","0","0","0","1","1","0","0","0","1","0","1","0","0","0","1"
"Mansfield","GB","32.56319","-97.14168","4","0","0","0","1","0","0","5","1","2","1","0","4","1","2","2","0","5","3","1","1","0","0","5"
"Mansfield","GB","35.05954","-94.25271","4","0","0","0","1","0","0","5","1","2","1","0","4","1","2","2","0","5","3","1","1","0","0","5"
"Mansfield","GB","32.03766","-93.70018","4","0","0","0","1","0","0","5","1","2","1","0","4","1","2","2","0","5","3","1","1","0","0","5"
"Mansfield","GB","37.10672","-92.58072","4","0","0","0","1","0","0","5","1","2","1","0","4","1","2","2","0","5","3","1","1","0","0","5"
"Mansfield","GB","40.21142","-88.50617","4","0","0","0","1","0","0","5","1","2","1","0","4","1","2","2","0","5","3","1","1","0","0","5"
"Mansfield","GB","40.75839","-82.51545","4","0","0","0","1","0","0","5","1","2","1","0","4","1","2","2","0","5","3","1","1","0","0","5"
"Mansfield","GB","41.8073","-77.07747","4","0","0","0","1","0","0","5","1","2","1","0","4","1","2","2","0","5","3","1","1","0","0","5"
"Mansfield","GB","42.03343","-71.21894","4","0","0","0","1","0","0","5","1","2","1","0","4","1","2","2","0","5","3","1","1","0","0","5"
"Mansfield","GB","53.13333","-1.2","4","0","0","0","1","0","0","5","1","2","1","0","4","1","2","2","0","5","3","1","1","0","0","5"
"Mansfield","GB","-37.052","146.08846","4","0","0","0","1","0","0","5","1","2","1","0","4","1","2","2","0","5","3","1","1","0","0","5"
"Mansfield","GB","-27.53929","153.09895","4","0","0","0","1","0","0","5","1","2","1","0","4","1","2","2","0","5","3","1","1","0","0","5"
"Mansfield Woodhouse","GB","53.16495","-1.19384","2","0","0","0","0","0","1","3","1","1","1","0","3","3","0","0","0","3","0","0","3","0","0","3"
"Maple Cross","GB","51.625","-0.508","0","0","0","1","0","0","0","1","1","0","0","0","1","0","0","1","0","1","0","0","1","0","0","1"
"March","GB","52.55131","0.08828","3","0","0","0","0","0","0","3","0","2","0","1","3","1","1","1","0","3","2","0","1","0","0","3"
"March","GB","37.52845","70.4482","3","0","0","0","0","0","0","3","0","2","0","1","3","1","1","1","0","3","2","0","1","0","0","3"
"Marden","GB","51.17482","0.48855","2","0","0","0","1","0","0","3","1","0","2","0","3","0","1","2","0","3","0","0","3","0","0","3"
"Marden","GB","-34.89569","138.6378","2","0","0","0","1","0","0","3","1","0","2","0","3","0","1","2","0","3","0","0","3","0","0","3"
"Margate","GB","26.24453","-80.20644","3","0","0","0","0","0","1","4","1","1","1","0","3","2","1","1","0","4","1","0","3","0","0","4"
"Margate","GB","51.38132","1.38617","3","0","0","0","0","0","1","4","1","1","1","0","3","2","1","1","0","4","1","0","3","0","0","4"
"Margate","GB","-30.8636","30.37052","3","0","0","0","0","0","1","4","1","1","1","0","3","2","1","1","0","4","1","0","3","0","0","4"
"Margate","GB","-43.02814","147.26256","3","0","0","0","0","0","1","4","1","1","1","0","3","2","1","1","0","4","1","0","3","0","0","4"
"Margate","GB","-27.24761","153.09809","3","0","0","0","0","0","1","4","1","1","1","0","3","2","1","1","0","4","1","0","3","0","0","4"
"Market Bosworth","GB","52.62428","-1.40174","1","0","0","0","0","0","0","1","0","0","0","0","0","1","0","0","0","1","0","0","1","0","0","1"
"Market Deeping","GB","52.67654","-0.31629","1","0","0","0","0","0","0","1","0","0","0","0","0","1","0","0","0","1","0","0","1","0","0","1"
"Market Drayton","GB","52.90538","-2.49012","6","0","0","0","0","0","0","6","1","4","0","0","5","2","0","4","0","6","1","0","4","0","0","5"
"Market Harborough","GB","52.4776","-0.92053","8","0","0","0","0","0","0","8","1","4","3","0","8","2","3","3","0","8","2","0","6","0","0","8"
"Market Weighton","GB","53.8631","-0.66505","2","0","0","0","0","0","0","2","0","1","0","0","1","2","0","0","0","2","2","0","0","0","0","2"
"Markfield","GB","52.68747","-1.27476","1","0","0","0","0","0","1","2","0","1","1","0","2","0","0","2","0","2","0","0","2","0","0","2"
"Marlborough","GB","38.57033","-90.33706","10","2","0","3","0","0","3","18","7","3","2","0","12","6","3","9","0","18","0","9","8","1","0","18"
"Marlborough","GB","42.90425","-72.20786","10","2","0","3","0","0","3","18","7","3","2","0","12","6","3","9","0","18","0","9","8","1","0","18"
"Marlborough","GB","42.34593","-71.55229","10","2","0","3","0","0","3","18","7","3","2","0","12","6","3","9","0","18","0","9","8","1","0","18"
"Marlborough","GB","51.42027","-1.72949","10","2","0","3","0","0","3","18","7","3","2","0","12","6","3","9","0","18","0","9","8","1","0","18"
"Marlow","GB","34.64813","-97.95809","12","2","0","0","1","0","0","15","2","3","7","0","12","6","0","9","0","15","1","3","11","0","0","15"
"Marlow","GB","43.11591","-72.19703","12","2","0","0","1","0","0","15","2","3","7","0","12","6","0","9","0","15","1","3","11","0","0","15"
"Marlow","GB","51.56933","-0.77415","12","2","0","0","1","0","0","15","2","3","7","0","12","6","0","9","0","15","1","3","11","0","0","15"
"Marlow","GB","54.15439","12.57261","12","2","0","0","1","0","0","15","2","3","7","0","12","6","0","9","0","15","1","3","11","0","0","15"
"Marple","GB","53.39452","-2.06292","3","0","0","0","1","0","0","4","2","1","1","0","4","0","0","4","0","4","0","2","2","0","0","4"
"Marshfield","GB","37.33866","-92.90712","1","0","0","0","0","0","0","1","0","0","1","0","1","0","0","1","0","1","0","0","1","0","0","1"
"Marshfield","GB","44.66885","-90.1718","1","0","0","0","0","0","0","1","0","0","1","0","1","0","0","1","0","1","0","0","1","0","0","1"
"Marshfield","GB","42.09177","-70.70559","1","0","0","0","0","0","0","1","0","0","1","0","1","0","0","1","0","1","0","0","1","0","0","1"
"Marshfield","GB","44.73313","-67.47749","1","0","0","0","0","0","0","1","0","0","1","0","1","0","0","1","0","1","0","0","1","0","0","1"
"Marshfield","GB","51.53389","-3.07306","1","0","0","0","0","0","0","1","0","0","1","0","1","0","0","1","0","1","0","0","1","0","0","1"
"Marshfield","GB","51.46194","-2.32","1","0","0","0","0","0","0","1","0","0","1","0","1","0","0","1","0","1","0","0","1","0","0","1"
"Marston Moretaine","GB","52.0641","-0.54932","1","0","0","0","0","0","0","1","0","1","0","0","1","1","0","0","0","1","0","0","1","0","0","1"
"Martock","GB","50.97361","-2.76684","2","0","0","2","0","0","0","4","2","0","2","0","4","1","0","3","0","4","0","3","1","0","0","4"
"Maryport","GB","54.71434","-3.49509","0","0","0","0","1","0","0","1","1","0","0","0","1","0","0","1","0","1","0","0","1","0","0","1"
"Matlock","GB","53.13838","-1.5556","19","1","0","2","2","0","2","26","9","1","1","0","11","13","0","13","0","26","5","9","11","0","1","26"
"Mauchline","GB","55.51604","-4.37928","1","0","0","0","0","0","0","1","0","1","0","0","1","0","0","1","0","1","0","0","1","0","0","1"
"Maud","GB","35.13036","-96.77585","1","0","0","0","0","0","0","1","0","1","0","0","1","1","0","0","0","1","0","1","0","0","0","1"
"Maud","GB","33.3329","-94.3427","1","0","0","0","0","0","0","1","0","1","0","0","1","1","0","0","0","1","0","1","0","0","0","1"
"Maud","GB","57.52165","-2.1257","1","0","0","0","0","0","0","1","0","1","0","0","1","1","0","0","0","1","0","1","0","0","0","1"
"Maybole","GB","55.35503","-4.68026","1","0","0","0","0","0","0","1","0","0","1","0","1","0","0","1","0","1","0","1","0","0","0","1"
"Mayfield","GB","39.11413","-111.71075","0","0","0","0","1","0","0","1","1","0","0","0","1","0","0","1","0","1","0","0","1","0","0","1"
"Mayfield","GB","36.74172","-88.63672","0","0","0","0","1","0","0","1","1","0","0","0","1","0","0","1","0","1","0","0","1","0","0","1"
"Mayfield","GB","39.49478","-84.37272","0","0","0","0","1","0","0","1","1","0","0","0","1","0","0","1","0","1","0","0","1","0","0","1"
"Mayfield","GB","41.552","-81.43928","0","0","0","0","1","0","0","1","1","0","0","0","1","0","0","1","0","1","0","0","1","0","0","1"
"Mayfield","GB","40.13618","-79.59782","0","0","0","0","1","0","0","1","1","0","0","0","1","0","0","1","0","1","0","0","1","0","0","1"
"Mayfield","GB","41.53814","-75.53602","0","0","0","0","1","0","0","1","1","0","0","0","1","0","0","1","0","1","0","0","1","0","0","1"
"Mayfield","GB","43.10452","-74.26486","0","0","0","0","1","0","0","1","1","0","0","0","1","0","0","1","0","1","0","0","1","0","0","1"
"Mayfield","GB","55.87172","-3.03875","0","0","0","0","1","0","0","1","1","0","0","0","1","0","0","1","0","1","0","0","1","0","0","1"
"Mayfield","GB","53","-1.76667","0","0","0","0","1","0","0","1","1","0","0","0","1","0","0","1","0","1","0","0","1","0","0","1"
"Mayfield","GB","-41.3876","147.13052","0","0","0","0","1","0","0","1","1","0","0","0","1","0","0","1","0","1","0","0","1","0","0","1"
"Mayfield","GB","-32.89793","151.73613","0","0","0","0","1","0","0","1","1","0","0","0","1","0","0","1","0","1","0","0","1","0","0","1"
"Measham","GB","52.70644","-1.50637","1","0","0","0","0","0","0","1","0","0","0","0","0","1","0","0","0","1","0","1","0","0","0","1"
"Melbourn","GB","52.08128","0.01514","0","0","0","0","1","0","1","2","1","0","0","1","2","0","1","1","0","2","1","0","1","0","0","2"
"Melksham","GB","51.37281","-2.14002","6","0","0","0","1","0","0","7","0","5","0","0","5","3","1","3","0","7","1","1","2","1","2","7"
"Melrose","GB","43.24762","-123.45897","2","1","0","0","1","0","1","5","1","1","3","0","5","0","0","5","0","5","0","4","1","0","0","5"
"Melrose","GB","34.43035","-103.63246","2","1","0","0","1","0","1","5","1","1","3","0","5","0","0","5","0","5","0","4","1","0","0","5"
"Melrose","GB","45.67469","-94.80752","2","1","0","0","1","0","1","5","1","1","3","0","5","0","0","5","0","5","0","4","1","0","0","5"
"Melrose","GB","40.82455","-73.91041","2","1","0","0","1","0","1","5","1","1","3","0","5","0","0","5","0","5","0","4","1","0","0","5"
"Melrose","GB","42.45843","-71.06616","2","1","0","0","1","0","1","5","1","1","3","0","5","0","0","5","0","5","0","4","1","0","0","5"
"Melrose","GB","55.59969","-2.7277","2","1","0","0","1","0","1","5","1","1","3","0","5","0","0","5","0","5","0","4","1","0","0","5"
"Melrose","GB","-20.26972","57.63194","2","1","0","0","1","0","1","5","1","1","3","0","5","0","0","5","0","5","0","4","1","0","0","5"
"Melton Mowbray","GB","52.76588","-0.88693","4","0","0","1","0","0","1","6","2","1","2","0","5","1","0","5","0","6","0","3","3","0","0","6"
"Menai Bridge","GB","53.22775","-4.16926","3","0","0","0","0","0","0","3","0","0","3","0","3","2","0","1","0","3","0","1","2","0","0","3"
"Menston","GB","53.89041","-1.74395","1","0","0","0","0","0","0","1","0","0","0","0","0","0","0","1","0","1","0","0","1","0","0","1"
"Mere","GB","53.3321","-2.40935","0","1","0","0","0","0","0","1","0","1","0","0","1","0","0","1","0","1","0","0","1","0","0","1"
"Mere","GB","51.08889","-2.26694","0","1","0","0","0","0","0","1","0","1","0","0","1","0","0","1","0","1","0","0","1","0","0","1"
"Merriott","GB","50.91275","-2.79538","1","0","0","0","1","0","0","2","1","0","1","0","2","1","0","1","0","2","0","1","0","0","1","2"
"Merthyr Tydfil","GB","51.74794","-3.37779","25","0","0","0","2","0","1","28","5","14","7","1","27","12","5","10","1","28","12","4","11","0","1","28"
"Metheringham","GB","53.14015","-0.40368","1","0","0","0","0","0","0","1","1","0","0","0","1","0","0","1","0","1","0","0","1","0","0","1"
"Middleham","GB","54.28592","-1.80838","1","0","0","0","0","0","0","1","0","0","0","0","0","0","0","1","0","1","0","1","0","0","0","1"
"Middlesbrough","GB","54.57623","-1.23483","20","1","0","1","2","0","0","24","3","13","5","1","22","6","2","15","1","24","7","4","12","0","1","24"
"Middlewich","GB","53.19296","-2.44402","2","0","0","0","0","0","0","2","0","0","2","0","2","1","1","0","0","2","0","0","2","0","0","2"
"Midhurst","GB","50.98559","-0.74003","2","0","0","0","0","0","0","2","0","1","1","0","2","1","0","1","0","2","0","1","1","0","0","2"
"Midsomer Norton","GB","51.28567","-2.48591","5","0","0","0","0","0","0","5","1","0","3","0","4","2","0","3","0","5","1","3","1","0","0","5"
"Mildenhall","GB","51.4256","-1.69988","1","0","0","0","0","0","0","1","0","1","0","0","1","0","0","1","0","1","1","0","0","0","0","1"
"Mildenhall","GB","52.34446","0.51086","1","0","0","0","0","0","0","1","0","1","0","0","1","0","0","1","0","1","1","0","0","0","0","1"
"Milford","GB","38.39691","-113.01079","2","0","0","0","0","0","0","2","0","0","1","0","1","1","0","1","0","2","0","1","1","0","0","2"
"Milford","GB","40.77445","-97.05059","2","0","0","0","0","0","0","2","0","0","1","0","1","1","0","1","0","2","0","1","1","0","0","2"
"Milford","GB","32.1246","-96.94528","2","0","0","0","0","0","0","2","0","0","1","0","1","1","0","1","0","2","0","1","1","0","0","2"
"Milford","GB","39.16833","-96.91251","2","0","0","0","0","0","0","2","0","0","1","0","1","1","0","1","0","2","0","1","1","0","0","2"
"Milford","GB","43.32469","-95.15","2","0","0","0","0","0","0","2","0","0","1","0","1","1","0","1","0","2","0","1","1","0","0","2"
"Milford","GB","43.10083","-88.84677","2","0","0","0","0","0","0","2","0","0","1","0","1","1","0","1","0","2","0","1","1","0","0","2"
"Milford","GB","40.62837","-87.69614","2","0","0","0","0","0","0","2","0","0","1","0","1","1","0","1","0","2","0","1","1","0","0","2"
"Milford","GB","41.40977","-85.84555","2","0","0","0","0","0","0","2","0","0","1","0","1","1","0","1","0","2","0","1","1","0","0","2"
"Milford","GB","39.17534","-84.29438","2","0","0","0","0","0","0","2","0","0","1","0","1","1","0","1","0","2","0","1","1","0","0","2"
"Milford","GB","42.59364","-83.59939","2","0","0","0","0","0","0","2","0","0","1","0","1","1","0","1","0","2","0","1","1","0","0","2"
"Milford","GB","39.95313","-79.10419","2","0","0","0","0","0","0","2","0","0","1","0","1","1","0","1","0","2","0","1","1","0","0","2"
"Milford","GB","38.91261","-75.42797","2","0","0","0","0","0","0","2","0","0","1","0","1","1","0","1","0","2","0","1","1","0","0","2"
"Milford","GB","40.56871","-75.09462","2","0","0","0","0","0","0","2","0","0","1","0","1","1","0","1","0","2","0","1","1","0","0","2"
"Milford","GB","41.32232","-74.80239","2","0","0","0","0","0","0","2","0","0","1","0","1","1","0","1","0","2","0","1","1","0","0","2"
"Milford","GB","41.22232","-73.0565","2","0","0","0","0","0","0","2","0","0","1","0","1","1","0","1","0","2","0","1","1","0","0","2"
"Milford","GB","42.83536","-71.64896","2","0","0","0","0","0","0","2","0","0","1","0","1","1","0","1","0","2","0","1","1","0","0","2"
"Milford","GB","42.13982","-71.51617","2","0","0","0","0","0","0","2","0","0","1","0","1","1","0","1","0","2","0","1","1","0","0","2"
"Milford","GB","44.94618","-68.64392","2","0","0","0","0","0","0","2","0","0","1","0","1","1","0","1","0","2","0","1","1","0","0","2"
"Milford","GB","51.17272","-0.65042","2","0","0","0","0","0","0","2","0","0","1","0","1","1","0","1","0","2","0","1","1","0","0","2"
"Milford Haven","GB","51.71278","-5.0341","26","2","0","2","4","0","1","35","15","3","3","0","21","14","2","16","3","35","16","17","2","0","0","35"
"Milland","GB","51.03117","-0.80376","1","0","0","0","0","0","0","1","1","0","0","0","1","1","0","0","0","1","0","1","0","0","0","1"
"Millom","GB","54.21072","-3.272","1","0","0","0","0","0","0","1","0","1","0","0","1","1","0","0","0","1","0","1","0","0","0","1"
"Milnthorpe","GB","54.22785","-2.76939","1","0","0","0","0","0","0","1","0","0","1","0","1","0","0","1","0","1","0","1","0","0","0","1"
"Milton Keynes","GB","52.04172","-0.75583","60","1","0","0","8","0","1","70","11","11","28","0","50","20","5","45","0","70","4","19","47","0","0","70"
"Minehead","GB","51.20452","-3.48284","1","0","0","0","1","0","0","2","1","1","0","0","2","1","0","1","0","2","1","1","0","0","0","2"
"Mirfield","GB","53.67343","-1.69636","1","0","0","0","0","0","0","1","0","1","0","0","1","0","0","1","0","1","0","0","1","0","0","1"
"Moira","GB","54.48021","-6.22822","1","0","0","0","1","0","0","2","1","1","0","0","2","1","0","1","0","2","0","0","2","0","0","2"
"Moira","GB","52.73698","-1.53496","1","0","0","0","1","0","0","2","1","1","0","0","2","1","0","1","0","2","0","0","2","0","0","2"
"Mold","GB","53.16674","-3.14143","16","0","0","0","3","0","1","20","3","9","5","0","17","6","3","11","0","20","2","8","9","0","1","20"
"Moneymore","GB","54.69229","-6.66956","1","0","0","0","0","0","0","1","0","1","0","0","1","1","0","0","0","1","1","0","0","0","0","1"
"Monkton","GB","55.51356","-4.59339","1","0","0","0","0","0","0","1","1","0","0","0","1","1","0","0","0","1","0","1","0","0","0","1"
"Monmouth","GB","44.84845","-123.23399","1","0","0","0","1","0","0","2","1","1","0","0","2","1","0","1","0","2","0","2","0","0","0","2"
"Monmouth","GB","40.91143","-90.64736","1","0","0","0","1","0","0","2","1","1","0","0","2","1","0","1","0","2","0","2","0","0","0","2"
"Monmouth","GB","44.23868","-70.03561","1","0","0","0","1","0","0","2","1","1","0","0","2","1","0","1","0","2","0","2","0","0","0","2"
"Monmouth","GB","51.81265","-2.71363","1","0","0","0","1","0","0","2","1","1","0","0","2","1","0","1","0","2","0","2","0","0","0","2"
"Montgomery","GB","30.38826","-95.69634","3","0","0","0","0","0","0","3","1","0","1","0","2","1","1","1","0","3","1","1","1","0","0","3"
"Montgomery","GB","44.43885","-93.58134","3","0","0","0","0","0","0","3","1","0","1","0","2","1","1","1","0","3","1","1","1","0","0","3"
"Montgomery","GB","31.66739","-92.89071","3","0","0","0","0","0","0","3","1","0","1","0","2","1","1","1","0","3","1","1","1","0","0","3"
"Montgomery","GB","41.73058","-88.3459","3","0","0","0","0","0","0","3","1","0","1","0","2","1","1","1","0","3","1","1","1","0","0","3"
"Montgomery","GB","32.36681","-86.29997","3","0","0","0","0","0","0","3","1","0","1","0","2","1","1","1","0","3","1","1","1","0","0","3"
"Montgomery","GB","39.22811","-84.35411","3","0","0","0","0","0","0","3","1","0","1","0","2","1","1","1","0","3","1","1","1","0","0","3"
"Montgomery","GB","38.18038","-81.32845","3","0","0","0","0","0","0","3","1","0","1","0","2","1","1","1","0","3","1","1","1","0","0","3"
"Montgomery","GB","31.94049","-81.12205","3","0","0","0","0","0","0","3","1","0","1","0","2","1","1","1","0","3","1","1","1","0","0","3"
"Montgomery","GB","41.17036","-76.87691","3","0","0","0","0","0","0","3","1","0","1","0","2","1","1","1","0","3","1","1","1","0","0","3"
"Montgomery","GB","41.52759","-74.23682","3","0","0","0","0","0","0","3","1","0","1","0","2","1","1","1","0","3","1","1","1","0","0","3"
"Montgomery","GB","42.20676","-72.8051","3","0","0","0","0","0","0","3","1","0","1","0","2","1","1","1","0","3","1","1","1","0","0","3"
"Montgomery","GB","44.90255","-72.63818","3","0","0","0","0","0","0","3","1","0","1","0","2","1","1","1","0","3","1","1","1","0","0","3"
"Montgomery","GB","52.56133","-3.14612","3","0","0","0","0","0","0","3","1","0","1","0","2","1","1","1","0","3","1","1","1","0","0","3"
"Montrose","GB","38.47832","-107.87617","0","1","0","0","0","0","0","1","0","0","1","0","1","0","0","1","0","1","0","0","1","0","0","1"
"Montrose","GB","45.06496","-93.91108","0","1","0","0","0","0","0","1","0","0","1","0","1","0","0","1","0","1","0","0","1","0","0","1"
"Montrose","GB","40.53226","-91.41488","0","1","0","0","0","0","0","1","0","0","1","0","1","0","0","1","0","1","0","0","1","0","0","1"
"Montrose","GB","43.17669","-83.89274","0","1","0","0","0","0","0","1","0","0","1","0","1","0","0","1","0","1","0","0","1","0","0","1"
"Montrose","GB","37.5207","-77.37831","0","1","0","0","0","0","0","1","0","0","1","0","1","0","0","1","0","1","0","0","1","0","0","1"
"Montrose","GB","40.30648","-75.98771","0","1","0","0","0","0","0","1","0","0","1","0","1","0","0","1","0","1","0","0","1","0","0","1"
"Montrose","GB","41.83397","-75.87714","0","1","0","0","0","0","0","1","0","0","1","0","1","0","0","1","0","1","0","0","1","0","0","1"
"Montrose","GB","41.25232","-73.93153","0","1","0","0","0","0","0","1","0","0","1","0","1","0","0","1","0","1","0","0","1","0","0","1"
"Montrose","GB","56.71683","-2.46695","0","1","0","0","0","0","0","1","0","0","1","0","1","0","0","1","0","1","0","0","1","0","0","1"
"Montrose","GB","-37.81667","145.35","0","1","0","0","0","0","0","1","0","0","1","0","1","0","0","1","0","1","0","0","1","0","0","1"
"Montrose","GB","-42.82895","147.24735","0","1","0","0","0","0","0","1","0","0","1","0","1","0","0","1","0","1","0","0","1","0","0","1"
"Moor Row","GB","54.51515","-3.53725","1","0","0","0","0","0","0","1","0","1","0","0","1","1","0","0","0","1","0","0","1","0","0","1"
"Morden","GB","49.1919","-98.10136","6","0","0","0","0","0","0","6","1","1","1","0","3","1","1","4","0","6","0","2","4","0","0","6"
"Morden","GB","51.39822","-0.19837","6","0","0","0","0","0","0","6","1","1","1","0","3","1","1","4","0","6","0","2","4","0","0","6"
"Morecambe","GB","54.06835","-2.86108","2","0","0","0","0","0","1","3","0","2","1","0","3","2","0","1","0","3","1","1","0","0","1","3"
"Moreton","GB","53.4","-3.11667","1","0","0","0","1","0","0","2","1","0","1","0","2","0","0","2","0","2","0","1","1","0","0","2"
"Moreton in Marsh","GB","51.98964","-1.70297","2","0","0","0","0","0","0","2","0","0","1","0","1","0","0","2","0","2","0","0","2","0","0","2"
"Morley","GB","37.04366","-89.61036","1","0","0","0","0","0","0","1","0","1","0","0","1","0","0","1","0","1","0","0","0","0","1","1"
"Morley","GB","53.74013","-1.59877","1","0","0","0","0","0","0","1","0","1","0","0","1","0","0","1","0","1","0","0","0","0","1","1"
"Morley","GB","-31.88775","115.9099","1","0","0","0","0","0","0","1","0","1","0","0","1","0","0","1","0","1","0","0","0","0","1","1"
"Morpeth","GB","55.16882","-1.68893","11","0","0","0","1","0","0","12","3","1","3","0","7","5","2","5","0","12","2","4","6","0","0","12"
"Morpeth","GB","-32.73333","151.63333","11","0","0","0","1","0","0","12","3","1","3","0","7","5","2","5","0","12","2","4","6","0","0","12"
"Mossley","GB","53.51454","-2.03462","1","0","0","0","0","0","0","1","0","1","0","0","1","1","0","0","0","1","0","0","1","0","0","1"
"Motherwell","GB","55.78924","-3.99187","8","1","0","0","0","0","0","9","2","5","2","0","9","4","0","5","0","9","3","2","3","0","1","9"
"Mountain Ash","GB","51.68361","-3.38008","3","1","0","1","0","0","0","5","2","3","0","0","5","0","2","3","0","5","2","2","1","0","0","5"
"Mountsorrel","GB","52.71667","-1.15","1","0","0","0","0","0","0","1","1","0","0","0","1","0","0","1","0","1","0","1","0","0","0","1"
"Much Hadham","GB","51.85407","0.07188","1","0","0","0","0","0","0","1","0","0","1","0","1","1","0","0","0","1","0","0","1","0","0","1"
"Much Wenlock","GB","52.59582","-2.55749","2","0","0","0","0","0","0","2","1","0","0","0","1","1","1","0","0","2","0","2","0","0","0","2"
"Mursley","GB","51.94961","-0.81161","0","1","0","0","0","0","0","1","1","0","0","0","1","0","0","1","0","1","0","0","1","0","0","1"
"Musselburgh","GB","55.9417","-3.04991","4","0","0","1","1","0","0","6","1","1","1","0","3","4","1","1","0","6","1","3","1","1","0","6"
"Nailsea","GB","51.43239","-2.75847","3","0","0","0","0","0","0","3","0","0","2","1","3","2","0","1","0","3","0","2","0","0","1","3"
"Nairn","GB","57.58094","-3.87973","2","0","0","0","0","0","0","2","0","0","2","0","2","0","0","2","0","2","0","1","1","0","0","2"
"Nantwich","GB","53.06878","-2.52051","2","1","0","1","0","0","0","4","1","2","1","0","4","1","0","3","0","4","0","2","2","0","0","4"
"Narberth","GB","40.00845","-75.26046","4","1","0","1","0","0","0","6","4","1","0","0","5","0","1","4","1","6","0","4","2","0","0","6"
"Narberth","GB","51.79784","-4.74275","4","1","0","1","0","0","0","6","4","1","0","0","5","0","1","4","1","6","0","4","2","0","0","6"
"Neath","GB","51.66317","-3.80443","15","0","0","1","1","0","3","20","4","11","4","0","19","10","4","6","0","20","8","4","8","0","0","20"
"Nelson","GB","49.49985","-117.28553","6","1","0","0","0","0","0","7","0","4","2","0","6","1","2","4","0","7","3","2","2","0","0","7"
"Nelson","GB","40.20168","-98.06782","6","1","0","0","0","0","0","7","0","4","2","0","6","1","2","4","0","7","3","2","2","0","0","7"
"Nelson","GB","34.38204","-84.37103","6","1","0","0","0","0","0","7","0","4","2","0","6","1","2","4","0","7","3","2","2","0","0","7"
"Nelson","GB","42.99064","-72.13092","6","1","0","0","0","0","0","7","0","4","2","0","6","1","2","4","0","7","3","2","2","0","0","7"
"Nelson","GB","51.65333","-3.28444","6","1","0","0","0","0","0","7","0","4","2","0","6","1","2","4","0","7","3","2","2","0","0","7"
"Nelson","GB","53.83333","-2.2","6","1","0","0","0","0","0","7","0","4","2","0","6","1","2","4","0","7","3","2","2","0","0","7"
"Nelson","GB","-41.27078","173.28404","6","1","0","0","0","0","0","7","0","4","2","0","6","1","2","4","0","7","3","2","2","0","0","7"
"Neston","GB","53.28333","-3.05","3","0","0","0","1","0","0","4","1","0","1","1","3","0","2","2","0","4","1","1","2","0","0","4"
"Neston","GB","51.41222","-2.20056","3","0","0","0","1","0","0","4","1","0","1","1","3","0","2","2","0","4","1","1","2","0","0","4"
"Netheravon","GB","51.23613","-1.79083","0","0","0","0","1","0","0","1","1","0","0","0","1","0","1","0","0","1","0","0","1","0","0","1"
"Netley","GB","50.87634","-1.35398","0","0","0","0","1","0","0","1","0","0","1","0","1","1","0","0","0","1","0","1","0","0","0","1"
"Netley","GB","-34.94887","138.54983","0","0","0","0","1","0","0","1","0","0","1","0","1","1","0","0","0","1","0","1","0","0","0","1"
"Newark on Trent","GB","53.06667","-0.81667","12","0","0","0","1","0","1","14","2","5","4","1","12","9","4","1","0","14","5","1","7","0","1","14"
"Newbiggin-by-the-Sea","GB","55.18532","-1.51469","1","0","0","0","0","0","0","1","0","1","0","0","1","0","0","1","0","1","1","0","0","0","0","1"
"Newbury","GB","43.32146","-72.03592","16","0","0","1","3","0","1","21","5","6","8","0","19","6","4","11","0","21","2","6","12","0","1","21"
"Newbury","GB","51.40148","-1.32471","16","0","0","1","3","0","1","21","5","6","8","0","19","6","4","11","0","21","2","6","12","0","1","21"
"Newcastle","GB","47.53899","-122.15568","79","1","0","5","8","0","2","95","16","25","21","0","62","35","15","44","1","95","27","22","39","2","4","94"
"Newcastle","GB","38.87407","-121.13328","79","1","0","5","8","0","2","95","16","25","21","0","62","35","15","44","1","95","27","22","39","2","4","94"
"Newcastle","GB","43.8547","-104.20494","79","1","0","5","8","0","2","95","16","25","21","0","62","35","15","44","1","95","27","22","39","2","4","94"
"Newcastle","GB","33.194","-98.73867","79","1","0","5","8","0","2","95","16","25","21","0","62","35","15","44","1","95","27","22","39","2","4","94"
"Newcastle","GB","35.24729","-97.59976","79","1","0","5","8","0","2","95","16","25","21","0","62","35","15","44","1","95","27","22","39","2","4","94"
"Newcastle","GB","44.03508","-69.53671","79","1","0","5","8","0","2","95","16","25","21","0","62","35","15","44","1","95","27","22","39","2","4","94"
"Newcastle","GB","17.2","-62.58333","79","1","0","5","8","0","2","95","16","25","21","0","62","35","15","44","1","95","27","22","39","2","4","94"
"Newcastle","GB","53.30111","-6.50222","79","1","0","5","8","0","2","95","16","25","21","0","62","35","15","44","1","95","27","22","39","2","4","94"
"Newcastle","GB","53.06833","-6.06583","79","1","0","5","8","0","2","95","16","25","21","0","62","35","15","44","1","95","27","22","39","2","4","94"
"Newcastle","GB","54.21804","-5.88979","79","1","0","5","8","0","2","95","16","25","21","0","62","35","15","44","1","95","27","22","39","2","4","94"
"Newcastle","GB","-27.75796","29.9318","79","1","0","5","8","0","2","95","16","25","21","0","62","35","15","44","1","95","27","22","39","2","4","94"
"Newcastle","GB","-32.92953","151.7801","79","1","0","5","8","0","2","95","16","25","21","0","62","35","15","44","1","95","27","22","39","2","4","94"
"Newcastle Emlyn","GB","52.04056","-4.4667","1","0","0","0","0","0","0","1","0","0","0","0","0","0","1","0","0","1","0","0","1","0","0","1"
"Newcastle under Lyme","GB","53","-2.23333","12","1","0","0","0","0","1","14","1","4","8","0","13","4","1","9","0","14","1","2","11","0","0","14"
"Newcastle upon Tyne","GB","54.97328","-1.61396","119","2","0","3","14","0","7","145","23","32","40","4","99","61","19","64","1","145","33","30","78","2","2","145"
"Newhaven","GB","53.13987","-1.75261","1","0","0","0","1","0","0","2","1","1","0","0","2","2","0","0","0","2","1","0","1","0","0","2"
"Newhaven","GB","50.79693","0.05545","1","0","0","0","1","0","0","2","1","1","0","0","2","2","0","0","0","2","1","0","1","0","0","2"
"New Malden","GB","51.40065","-0.2617","2","0","0","2","0","0","2","6","3","1","1","0","5","2","1","3","0","6","0","2","4","0","0","6"
"Newmarket","GB","44.05011","-79.46631","5","0","0","0","0","0","1","6","0","1","2","0","3","4","0","2","0","6","1","0","5","0","0","6"
"Newmarket","GB","43.08286","-70.93506","5","0","0","0","0","0","1","6","0","1","2","0","3","4","0","2","0","6","1","0","5","0","0","6"
"Newmarket","GB","52.21667","-9","5","0","0","0","0","0","1","6","0","1","2","0","3","4","0","2","0","6","1","0","5","0","0","6"
"Newmarket","GB","52.24467","0.40418","5","0","0","0","0","0","1","6","0","1","2","0","3","4","0","2","0","6","1","0","5","0","0","6"
"Newmarket","GB","-27.43534","153.00781","5","0","0","0","0","0","1","6","0","1","2","0","3","4","0","2","0","6","1","0","5","0","0","6"
"New Mills","GB","53.36592","-1.99986","1","0","0","1","0","0","0","2","1","1","0","0","2","2","0","0","0","2","1","0","1","0","0","2"
"New Milton","GB","50.75601","-1.6658","7","0","0","0","0","0","0","7","0","4","2","0","6","2","2","3","0","7","3","1","2","0","1","7"
"Newport","GB","44.63678","-124.05345","45","1","0","2","7","0","8","63","11","22","25","0","58","18","11","33","1","63","14","14","33","0","2","63"
"Newport","GB","47.57121","-122.18068","45","1","0","2","7","0","8","63","11","22","25","0","58","18","11","33","1","63","14","14","33","0","2","63"
"Newport","GB","48.17963","-117.04326","45","1","0","2","7","0","8","63","11","22","25","0","58","18","11","33","1","63","14","14","33","0","2","63"
"Newport","GB","44.86636","-93.00049","45","1","0","2","7","0","8","63","11","22","25","0","58","18","11","33","1","63","14","14","33","0","2","63"
"Newport","GB","35.6048","-91.2818","45","1","0","2","7","0","8","63","11","22","25","0","58","18","11","33","1","63","14","14","33","0","2","63"
"Newport","GB","39.8842","-87.40863","45","1","0","2","7","0","8","63","11","22","25","0","58","18","11","33","1","63","14","14","33","0","2","63"
"Newport","GB","39.09145","-84.49578","45","1","0","2","7","0","8","63","11","22","25","0","58","18","11","33","1","63","14","14","33","0","2","63"
"Newport","GB","35.96704","-83.18766","45","1","0","2","7","0","8","63","11","22","25","0","58","18","11","33","1","63","14","14","33","0","2","63"
"Newport","GB","39.39091","-81.22678","45","1","0","2","7","0","8","63","11","22","25","0","58","18","11","33","1","63","14","14","33","0","2","63"
"Newport","GB","34.98986","-81.10091","45","1","0","2","7","0","8","63","11","22","25","0","58","18","11","33","1","63","14","14","33","0","2","63"
"Newport","GB","40.47786","-77.13054","45","1","0","2","7","0","8","63","11","22","25","0","58","18","11","33","1","63","14","14","33","0","2","63"
"Newport","GB","34.78655","-76.85911","45","1","0","2","7","0","8","63","11","22","25","0","58","18","11","33","1","63","14","14","33","0","2","63"
"Newport","GB","39.71372","-75.60937","45","1","0","2","7","0","8","63","11","22","25","0","58","18","11","33","1","63","14","14","33","0","2","63"
"Newport","GB","43.1859","-75.01432","45","1","0","2","7","0","8","63","11","22","25","0","58","18","11","33","1","63","14","14","33","0","2","63"
"Newport","GB","44.93644","-72.2051","45","1","0","2","7","0","8","63","11","22","25","0","58","18","11","33","1","63","14","14","33","0","2","63"
"Newport","GB","43.36535","-72.17342","45","1","0","2","7","0","8","63","11","22","25","0","58","18","11","33","1","63","14","14","33","0","2","63"
"Newport","GB","41.4901","-71.31283","45","1","0","2","7","0","8","63","11","22","25","0","58","18","11","33","1","63","14","14","33","0","2","63"
"Newport","GB","44.83534","-69.27394","45","1","0","2","7","0","8","63","11","22","25","0","58","18","11","33","1","63","14","14","33","0","2","63"
"Newport","GB","53.88508","-9.54526","45","1","0","2","7","0","8","63","11","22","25","0","58","18","11","33","1","63","14","14","33","0","2","63"
"Newport","GB","52.71111","-8.40972","45","1","0","2","7","0","8","63","11","22","25","0","58","18","11","33","1","63","14","14","33","0","2","63"
"Newport","GB","52.01667","-4.83333","45","1","0","2","7","0","8","63","11","22","25","0","58","18","11","33","1","63","14","14","33","0","2","63"
"Newport","GB","51.58774","-2.99835","45","1","0","2","7","0","8","63","11","22","25","0","58","18","11","33","1","63","14","14","33","0","2","63"
"Newport","GB","52.76684","-2.37734","45","1","0","2","7","0","8","63","11","22","25","0","58","18","11","33","1","63","14","14","33","0","2","63"
"Newport","GB","50.70146","-1.29124","45","1","0","2","7","0","8","63","11","22","25","0","58","18","11","33","1","63","14","14","33","0","2","63"
"Newport","GB","53.76333","-0.69986","45","1","0","2","7","0","8","63","11","22","25","0","58","18","11","33","1","63","14","14","33","0","2","63"
"Newport","GB","51.98425","0.21355","45","1","0","2","7","0","8","63","11","22","25","0","58","18","11","33","1","63","14","14","33","0","2","63"
"Newport","GB","-37.84427","144.88483","45","1","0","2","7","0","8","63","11","22","25","0","58","18","11","33","1","63","14","14","33","0","2","63"
"Newport","GB","-33.65639","151.31401","45","1","0","2","7","0","8","63","11","22","25","0","58","18","11","33","1","63","14","14","33","0","2","63"
"Newport","GB","-27.20731","153.10135","45","1","0","2","7","0","8","63","11","22","25","0","58","18","11","33","1","63","14","14","33","0","2","63"
"Newport Pagnell","GB","52.08731","-0.72218","3","1","0","0","1","0","0","5","1","1","2","1","5","0","3","2","0","5","2","2","1","0","0","5"
"Newquay","GB","50.41557","-5.07319","2","0","0","0","0","0","0","2","0","0","1","0","1","0","0","2","0","2","0","1","1","0","0","2"
"Newry","GB","54.17841","-6.33739","4","0","0","0","0","0","1","5","1","2","1","0","4","1","0","4","0","5","0","3","2","0","0","5"
"Newton Abbot","GB","50.52858","-3.61186","13","0","0","1","0","0","1","15","3","3","6","0","12","5","4","6","0","15","2","5","7","0","1","15"
"Newton Aycliffe","GB","54.61842","-1.5719","5","0","0","0","0","0","0","5","2","1","2","0","5","1","1","3","0","5","2","1","2","0","0","5"
"Newton-le-Willows","GB","53.45","-2.6","3","0","0","0","0","0","0","3","1","0","0","0","1","0","2","1","0","3","0","1","2","0","0","3"
"Newton Stewart","GB","54.95784","-4.48315","0","0","0","0","2","0","0","2","0","0","2","0","2","1","0","1","0","2","0","0","2","0","0","2"
"Newtown","GB","39.1245","-84.36161","3","0","0","0","0","0","0","3","0","2","1","0","3","0","0","3","0","3","0","1","1","1","0","3"
"Newtown","GB","40.22928","-74.93683","3","0","0","0","0","0","0","3","0","2","1","0","3","0","0","3","0","3","0","1","1","1","0","3"
"Newtown","GB","41.41398","-73.30345","3","0","0","0","0","0","0","3","0","2","1","0","3","0","0","3","0","3","0","1","1","1","0","3"
"Newtown","GB","52.51667","-3.3","3","0","0","0","0","0","0","3","0","2","1","0","3","0","0","3","0","3","0","1","1","1","0","3"
"Newtown","GB","-38.15391","144.33507","3","0","0","0","0","0","0","3","0","2","1","0","3","0","0","3","0","3","0","1","1","1","0","3"
"Newtown","GB","-33.89835","151.17754","3","0","0","0","0","0","0","3","0","2","1","0","3","0","0","3","0","3","0","1","1","1","0","3"
"Newtown","GB","-27.55602","151.93255","3","0","0","0","0","0","0","3","0","2","1","0","3","0","0","3","0","3","0","1","1","1","0","3"
"Newtown","GB","-27.6163","152.77675","3","0","0","0","0","0","0","3","0","2","1","0","3","0","0","3","0","3","0","1","1","1","0","3"
"Newtownabbey","GB","54.65983","-5.90858","3","0","0","0","1","0","0","4","1","1","1","0","3","1","1","2","0","4","2","0","2","0","0","4"
"Newtownards","GB","54.59236","-5.69092","4","0","0","0","0","0","0","4","1","2","1","0","4","1","2","0","1","4","2","2","0","0","0","4"
"Neyland","GB","51.71014","-4.95155","4","0","0","0","0","0","1","5","2","0","0","0","2","4","0","1","0","5","3","0","2","0","0","5"
"Ninfield","GB","50.88641","0.42529","1","0","0","0","0","0","0","1","0","1","0","0","1","0","0","1","0","1","0","1","0","0","0","1"
"Normanton","GB","53.7","-1.41667","1","0","0","0","1","0","0","2","0","1","1","0","2","0","0","2","0","2","1","0","1","0","0","2"
"Normanton","GB","-17.67183","141.07721","1","0","0","0","1","0","0","2","0","1","1","0","2","0","0","2","0","2","1","0","1","0","0","2"
"Northallerton","GB","54.33901","-1.43243","5","0","0","0","0","0","0","5","0","1","2","0","3","2","0","3","0","5","0","2","3","0","0","5"
"Northampton","GB","40.68621","-75.49685","74","2","0","2","6","0","6","90","23","25","30","1","79","26","14","50","0","90","16","23","47","0","3","89"
"Northampton","GB","40.88871","-72.68954","74","2","0","2","6","0","6","90","23","25","30","1","79","26","14","50","0","90","16","23","47","0","3","89"
"Northampton","GB","42.32509","-72.6412","74","2","0","2","6","0","6","90","23","25","30","1","79","26","14","50","0","90","16","23","47","0","3","89"
"Northampton","GB","52.25","-0.88333","74","2","0","2","6","0","6","90","23","25","30","1","79","26","14","50","0","90","16","23","47","0","3","89"
"Northampton","GB","-28.34994","114.63821","74","2","0","2","6","0","6","90","23","25","30","1","79","26","14","50","0","90","16","23","47","0","3","89"
"North Berwick","GB","43.3037","-70.73339","1","0","0","1","0","0","0","2","1","0","1","0","2","0","0","2","0","2","0","0","2","0","0","2"
"North Berwick","GB","56.05825","-2.7229","1","0","0","1","0","0","0","2","1","0","1","0","2","0","0","2","0","2","0","0","2","0","0","2"
"North Ferriby","GB","53.72124","-0.5052","2","0","0","0","0","0","0","2","0","0","2","0","2","1","0","1","0","2","0","1","1","0","0","2"
"Northleach","GB","51.82994","-1.83712","1","0","0","0","0","0","0","1","0","1","0","0","1","0","0","1","0","1","1","0","0","0","0","1"
"North Lopham","GB","52.40352","0.99169","1","0","0","0","0","0","0","1","0","1","0","0","1","0","0","1","0","1","0","0","1","0","0","1"
"Northolt","GB","51.54855","-0.36778","1","0","0","0","0","0","0","1","1","0","0","0","1","1","0","0","0","1","0","1","0","0","0","1"
"North Shields","GB","55.01646","-1.44925","11","0","0","0","2","0","1","14","2","2","5","0","9","4","3","7","0","14","2","6","4","0","2","14"
"North Tawton","GB","50.79968","-3.89759","0","0","0","1","0","0","0","1","1","0","0","0","1","0","0","1","0","1","0","0","1","0","0","1"
"North Thoresby","GB","53.46651","-0.05575","0","0","0","0","1","0","0","1","1","0","0","0","1","0","0","1","0","1","0","1","0","0","0","1"
"North Walsham","GB","52.82121","1.38746","1","0","0","0","1","0","0","2","0","0","2","0","2","0","1","1","0","2","0","1","1","0","0","2"
"Northwich","GB","53.25882","-2.52025","14","0","0","0","2","0","1","17","3","4","9","0","16","7","0","10","0","17","2","1","13","0","1","17"
"Northwood","GB","47.73415","-97.56675","1","1","0","0","1","0","0","3","0","1","1","0","2","2","1","0","0","3","1","0","2","0","0","3"
"Northwood","GB","43.44412","-93.22104","1","1","0","0","1","0","0","3","0","1","1","0","2","2","1","0","0","3","1","0","2","0","0","3"
"Northwood","GB","40.47283","-83.73243","1","1","0","0","1","0","0","3","0","1","1","0","2","2","1","0","0","3","1","0","2","0","0","3"
"Northwood","GB","41.60727","-83.46882","1","1","0","0","1","0","0","3","0","1","1","0","2","2","1","0","0","3","1","0","2","0","0","3"
"Northwood","GB","43.19425","-71.1509","1","1","0","0","1","0","0","3","0","1","1","0","2","2","1","0","0","3","1","0","2","0","0","3"
"Northwood","GB","50.74102","-1.31192","1","1","0","0","1","0","0","3","0","1","1","0","2","2","1","0","0","3","1","0","2","0","0","3"
"Northwood","GB","-33.82895","151.1803","1","1","0","0","1","0","0","3","0","1","1","0","2","2","1","0","0","3","1","0","2","0","0","3"
"Norwich","GB","42.53118","-75.52351","63","2","0","5","5","1","1","77","17","29","18","0","64","31","11","34","0","76","10","23","39","2","3","77"
"Norwich","GB","43.71535","-72.30787","63","2","0","5","5","1","1","77","17","29","18","0","64","31","11","34","0","76","10","23","39","2","3","77"
"Norwich","GB","41.52426","-72.07591","63","2","0","5","5","1","1","77","17","29","18","0","64","31","11","34","0","76","10","23","39","2","3","77"
"Norwich","GB","52.62783","1.29834","63","2","0","5","5","1","1","77","17","29","18","0","64","31","11","34","0","76","10","23","39","2","3","77"
"Nottingham","GB","43.11453","-71.09978","143","9","0","5","18","0","9","184","33","51","59","2","145","61","31","91","0","183","30","44","99","4","5","182"
"Nottingham","GB","52.9536","-1.15047","143","9","0","5","18","0","9","184","33","51","59","2","145","61","31","91","0","183","30","44","99","4","5","182"
"Nuneaton","GB","52.52323","-1.46523","40","2","0","1","3","0","1","47","10","14","21","0","45","11","6","30","0","47","7","24","14","0","2","47"
"Oakham","GB","42.35287","-72.04535","9","0","0","1","2","0","1","13","5","3","4","1","13","6","3","4","0","13","4","3","6","0","0","13"
"Oakham","GB","52.66667","-0.73333","9","0","0","1","2","0","1","13","5","3","4","1","13","6","3","4","0","13","4","3","6","0","0","13"
"Oakley","GB","37.99742","-121.71245","2","0","0","0","0","0","0","2","0","0","1","0","1","0","0","2","0","2","0","0","2","0","0","2"
"Oakley","GB","42.24325","-113.88196","2","0","0","0","0","0","0","2","0","0","1","0","1","0","0","2","0","2","0","0","2","0","0","2"
"Oakley","GB","40.71467","-111.30074","2","0","0","0","0","0","0","2","0","0","1","0","1","0","0","2","0","2","0","0","2","0","0","2"
"Oakley","GB","39.13334","-100.86376","2","0","0","0","0","0","0","2","0","0","1","0","1","0","0","2","0","2","0","0","2","0","0","2"
"Oakley","GB","56.08421","-3.56311","2","0","0","0","0","0","0","2","0","0","1","0","1","0","0","2","0","2","0","0","2","0","0","2"
"Oakley","GB","51.80406","-1.07261","2","0","0","0","0","0","0","2","0","0","1","0","1","0","0","2","0","2","0","0","2","0","0","2"
"Oakley","GB","52.16862","-0.52649","2","0","0","0","0","0","0","2","0","0","1","0","1","0","0","2","0","2","0","0","2","0","0","2"
"Oban","GB","56.41535","-5.47184","1","0","0","0","0","0","0","1","1","0","0","0","1","0","0","0","1","1","0","1","0","0","0","1"
"Ockley","GB","51.14678","-0.36366","1","0","0","0","0","0","0","1","0","0","1","0","1","1","0","0","0","1","0","0","1","0","0","1"
"Odiham","GB","51.25407","-0.93933","1","0","0","0","0","0","0","1","1","0","0","0","1","0","0","1","0","1","0","0","1","0","0","1"
"Ogmore Vale","GB","51.6023","-3.54217","0","0","0","1","0","0","0","1","1","0","0","0","1","0","1","0","0","1","0","1","0","0","0","1"
"Okehampton","GB","50.73841","-4.0016","4","0","0","0","0","0","2","6","1","3","1","0","5","1","2","3","0","6","2","0","3","0","1","6"
"Oldbury","GB","52.5","-2.01667","2","0","0","0","0","0","0","2","0","1","0","0","1","1","0","1","0","2","1","0","1","0","0","2"
"Oldham","GB","53.54051","-2.1183","15","0","0","0","2","0","1","18","3","7","5","1","16","5","4","9","0","18","5","3","9","0","1","18"
"Old Windsor","GB","51.45807","-0.58674","1","1","0","0","0","0","0","2","0","1","1","0","2","1","0","1","0","2","0","0","2","0","0","2"
"Olney","GB","33.37066","-98.75284","1","0","0","0","0","0","0","1","0","0","1","0","1","0","0","1","0","1","0","0","1","0","0","1"
"Olney","GB","38.73088","-88.08532","1","0","0","0","0","0","0","1","0","0","1","0","1","0","0","1","0","1","0","0","1","0","0","1"
"Olney","GB","39.15316","-77.06692","1","0","0","0","0","0","0","1","0","0","1","0","1","0","0","1","0","1","0","0","1","0","0","1"
"Olney","GB","52.15345","-0.70201","1","0","0","0","0","0","0","1","0","0","1","0","1","0","0","1","0","1","0","0","1","0","0","1"
"Omagh","GB","54.6","-7.3","1","0","0","0","0","0","0","1","0","0","0","0","0","0","0","1","0","1","1","0","0","0","0","1"
"Ormskirk","GB","53.56685","-2.88178","11","1","0","0","0","0","1","13","2","3","3","0","8","7","1","5","0","13","3","4","6","0","0","13"
"Orpington","GB","51.37457","0.09785","9","0","0","1","1","0","3","14","5","3","5","0","13","1","3","10","0","14","1","3","10","0","0","14"
"Ossett","GB","53.67978","-1.58006","1","0","0","0","0","0","0","1","0","0","0","0","0","0","0","1","0","1","0","1","0","0","0","1"
"Oswestry","GB","52.86195","-3.05497","5","0","0","0","0","0","1","6","1","1","3","0","5","3","1","2","0","6","0","2","3","0","1","6"
"Otford","GB","51.31283","0.19046","2","0","0","0","0","0","0","2","0","1","0","0","1","0","1","1","0","2","0","0","1","1","0","2"
"Otley","GB","53.90553","-1.69383","3","0","0","0","0","0","1","4","2","0","1","0","3","0","1","3","0","4","1","1","2","0","0","4"
"Otley","GB","52.15134","1.22","3","0","0","0","0","0","1","4","2","0","1","0","3","0","1","3","0","4","1","1","2","0","0","4"
"Ottershaw","GB","51.36262","-0.52752","1","0","0","0","0","0","0","1","0","1","0","0","1","1","0","0","0","1","0","1","0","0","0","1"
"Ottery St Mary","GB","50.75","-3.26667","1","0","0","0","0","0","0","1","0","0","1","0","1","0","0","1","0","1","0","0","1","0","0","1"
"Oundle","GB","52.48093","-0.46732","1","0","0","0","0","0","0","1","0","0","1","0","1","0","0","1","0","1","0","0","1","0","0","1"
"Oxford","GB","40.24834","-99.63344","124","7","0","7","6","0","5","149","29","52","45","1","127","49","20","79","0","148","18","38","73","3","15","147"
"Oxford","GB","37.27419","-97.16893","124","7","0","7","6","0","5","149","29","52","45","1","127","49","20","79","0","148","18","38","73","3","15","147"
"Oxford","GB","36.22118","-91.92932","124","7","0","7","6","0","5","149","29","52","45","1","127","49","20","79","0","148","18","38","73","3","15","147"
"Oxford","GB","41.72334","-91.79045","124","7","0","7","6","0","5","149","29","52","45","1","127","49","20","79","0","148","18","38","73","3","15","147"
"Oxford","GB","43.78137","-89.57262","124","7","0","7","6","0","5","149","29","52","45","1","127","49","20","79","0","148","18","38","73","3","15","147"
"Oxford","GB","34.3665","-89.51925","124","7","0","7","6","0","5","149","29","52","45","1","127","49","20","79","0","148","18","38","73","3","15","147"
"Oxford","GB","40.51976","-87.24779","124","7","0","7","6","0","5","149","29","52","45","1","127","49","20","79","0","148","18","38","73","3","15","147"
"Oxford","GB","33.61427","-85.83496","124","7","0","7","6","0","5","149","29","52","45","1","127","49","20","79","0","148","18","38","73","3","15","147"
"Oxford","GB","39.507","-84.74523","124","7","0","7","6","0","5","149","29","52","45","1","127","49","20","79","0","148","18","38","73","3","15","147"
"Oxford","GB","33.619","-83.86741","124","7","0","7","6","0","5","149","29","52","45","1","127","49","20","79","0","148","18","38","73","3","15","147"
"Oxford","GB","42.82475","-83.26466","124","7","0","7","6","0","5","149","29","52","45","1","127","49","20","79","0","148","18","38","73","3","15","147"
"Oxford","GB","36.3107","-78.59083","124","7","0","7","6","0","5","149","29","52","45","1","127","49","20","79","0","148","18","38","73","3","15","147"
"Oxford","GB","38.68651","-76.17161","124","7","0","7","6","0","5","149","29","52","45","1","127","49","20","79","0","148","18","38","73","3","15","147"
"Oxford","GB","39.78539","-75.97883","124","7","0","7","6","0","5","149","29","52","45","1","127","49","20","79","0","148","18","38","73","3","15","147"
"Oxford","GB","42.44202","-75.59769","124","7","0","7","6","0","5","149","29","52","45","1","127","49","20","79","0","148","18","38","73","3","15","147"
"Oxford","GB","40.80315","-74.98962","124","7","0","7","6","0","5","149","29","52","45","1","127","49","20","79","0","148","18","38","73","3","15","147"
"Oxford","GB","41.43399","-73.11678","124","7","0","7","6","0","5","149","29","52","45","1","127","49","20","79","0","148","18","38","73","3","15","147"
"Oxford","GB","42.11676","-71.86479","124","7","0","7","6","0","5","149","29","52","45","1","127","49","20","79","0","148","18","38","73","3","15","147"
"Oxford","GB","44.13174","-70.49311","124","7","0","7","6","0","5","149","29","52","45","1","127","49","20","79","0","148","18","38","73","3","15","147"
"Oxford","GB","45.73345","-63.86542","124","7","0","7","6","0","5","149","29","52","45","1","127","49","20","79","0","148","18","38","73","3","15","147"
"Oxford","GB","51.75222","-1.25596","124","7","0","7","6","0","5","149","29","52","45","1","127","49","20","79","0","148","18","38","73","3","15","147"
"Oxford","GB","-43.3","172.18333","124","7","0","7","6","0","5","149","29","52","45","1","127","49","20","79","0","148","18","38","73","3","15","147"
"Oxted","GB","51.25687","-0.00601","9","0","0","0","0","0","0","9","2","2","2","0","6","3","0","6","0","9","2","2","4","0","1","9"
"Paddock Wood","GB","51.18187","0.38229","3","0","0","0","0","0","0","3","0","1","2","0","3","3","0","0","0","3","1","0","2","0","0","3"
"Padstow","GB","50.53885","-4.93664","3","0","0","0","0","0","0","3","1","0","2","0","3","0","0","3","0","3","0","1","1","0","0","2"
"Padstow","GB","-33.95687","151.03191","3","0","0","0","0","0","0","3","1","0","2","0","3","0","0","3","0","3","0","1","1","0","0","2"
"Paignton","GB","50.43565","-3.56789","3","0","0","0","0","0","0","3","0","3","0","0","3","2","0","1","0","3","2","1","0","0","0","3"
"Painswick","GB","51.78568","-2.19555","2","0","0","0","1","0","0","3","1","1","0","0","2","2","0","1","0","3","0","2","1","0","0","3"
"Paisley","GB","28.9836","-81.54174","3","0","0","0","1","0","2","6","1","2","1","1","5","0","0","6","0","6","1","1","4","0","0","6"
"Paisley","GB","44.30641","-81.27265","3","0","0","0","1","0","2","6","1","2","1","1","5","0","0","6","0","6","1","1","4","0","0","6"
"Paisley","GB","55.83173","-4.43254","3","0","0","0","1","0","2","6","1","2","1","1","5","0","0","6","0","6","1","1","4","0","0","6"
"Pangbourne","GB","51.4837","-1.08519","1","0","0","0","0","0","0","1","0","0","1","0","1","0","0","1","0","1","0","1","0","0","0","1"
"Paulerspury","GB","52.10271","-0.95023","1","0","0","0","0","0","0","1","0","0","0","0","0","1","0","0","0","1","0","0","1","0","0","1"
"Paulton","GB","51.30472","-2.50028","1","0","0","0","0","0","0","1","0","0","1","0","1","0","0","1","0","1","0","0","1","0","0","1"
"Peacehaven","GB","50.7927","-0.00652","4","0","0","0","1","0","0","5","2","1","2","0","5","1","1","3","0","5","1","3","1","0","0","5"
"Peakirk","GB","52.64567","-0.27294","1","0","0","0","0","0","0","1","0","1","0","0","1","1","0","0","0","1","0","0","1","0","0","1"
"Peebles","GB","38.94896","-83.40575","1","0","0","0","0","0","0","1","0","0","0","0","0","1","0","0","0","1","0","0","0","0","1","1"
"Peebles","GB","55.6519","-3.1888","1","0","0","0","0","0","0","1","0","0","0","0","0","1","0","0","0","1","0","0","0","0","1","1"
"Pembroke","GB","36.77588","-87.35556","93","2","0","5","11","0","1","112","26","10","11","3","50","39","19","52","2","112","40","47","24","0","1","112"
"Pembroke","GB","32.13634","-81.62348","93","2","0","5","11","0","1","112","26","10","11","3","50","39","19","52","2","112","40","47","24","0","1","112"
"Pembroke","GB","37.31957","-80.63895","93","2","0","5","11","0","1","112","26","10","11","3","50","39","19","52","2","112","40","47","24","0","1","112"
"Pembroke","GB","34.68016","-79.19504","93","2","0","5","11","0","1","112","26","10","11","3","50","39","19","52","2","112","40","47","24","0","1","112"
"Pembroke","GB","45.81681","-77.11616","93","2","0","5","11","0","1","112","26","10","11","3","50","39","19","52","2","112","40","47","24","0","1","112"
"Pembroke","GB","43.14675","-71.45757","93","2","0","5","11","0","1","112","26","10","11","3","50","39","19","52","2","112","40","47","24","0","1","112"
"Pembroke","GB","44.95369","-67.16193","93","2","0","5","11","0","1","112","26","10","11","3","50","39","19","52","2","112","40","47","24","0","1","112"
"Pembroke","GB","51.67464","-4.91286","93","2","0","5","11","0","1","112","26","10","11","3","50","39","19","52","2","112","40","47","24","0","1","112"
"Pembroke","GB","35.93056","14.47639","93","2","0","5","11","0","1","112","26","10","11","3","50","39","19","52","2","112","40","47","24","0","1","112"
"Pembroke Dock","GB","51.69161","-4.94036","94","1","0","4","15","0","4","118","33","6","7","2","48","37","22","56","1","116","29","51","32","0","4","116"
"Penarth","GB","51.4386","-3.17342","8","0","0","1","0","0","2","11","3","2","4","0","9","2","1","8","0","11","1","3","7","0","0","11"
"Penicuik","GB","55.83116","-3.22608","1","0","0","0","0","0","0","1","0","1","0","0","1","0","0","1","0","1","0","0","1","0","0","1"
"Penistone","GB","53.52572","-1.63027","1","0","0","0","0","0","0","1","0","1","0","0","1","0","1","0","0","1","0","0","0","0","1","1"
"Penkridge","GB","52.72556","-2.1156","1","0","0","0","0","0","0","1","0","1","0","0","1","0","0","1","0","1","0","0","1","0","0","1"
"Penrhyndeudraeth","GB","52.93333","-4.06667","1","0","0","0","0","0","0","1","0","0","1","0","1","0","0","1","0","1","0","0","1","0","0","1"
"Penrith","GB","54.66579","-2.75757","8","1","0","0","2","0","0","11","4","3","3","0","10","4","2","5","0","11","3","2","6","0","0","11"
"Penrith","GB","-33.75","150.7","8","1","0","0","2","0","0","11","4","3","3","0","10","4","2","5","0","11","3","2","6","0","0","11"
"Pensford","GB","51.37111","-2.54722","1","0","0","0","0","0","0","1","0","0","0","0","0","0","0","1","0","1","0","0","1","0","0","1"
"Penshurst","GB","51.17267","0.18282","0","0","0","0","0","0","1","1","1","0","0","0","1","0","0","1","0","1","0","0","1","0","0","1"
"Penshurst","GB","-37.87528","142.29071","0","0","0","0","0","0","1","1","1","0","0","0","1","0","0","1","0","1","0","0","1","0","0","1"
"Penshurst","GB","-33.96667","151.08333","0","0","0","0","0","0","1","1","1","0","0","0","1","0","0","1","0","1","0","0","1","0","0","1"
"Pentre","GB","51.65429","-3.49133","2","0","0","0","0","0","0","2","1","0","1","0","2","1","0","1","0","2","0","2","0","0","0","2"
"Penyffordd","GB","53.14829","-3.04584","1","0","0","0","0","0","0","1","0","0","1","0","1","0","0","1","0","1","0","1","0","0","0","1"
"Penysarn","GB","53.38978","-4.31698","1","0","0","0","0","0","0","1","0","1","0","0","1","0","1","0","0","1","0","0","1","0","0","1"
"Penzance","GB","50.11861","-5.53715","3","0","0","0","0","0","1","4","2","0","2","0","4","1","1","2","0","4","0","2","2","0","0","4"
"Perranporth","GB","50.34377","-5.15558","2","0","0","0","0","0","0","2","0","1","0","0","1","1","1","0","0","2","1","1","0","0","0","2"
"Pershore","GB","52.11163","-2.07586","1","2","0","0","0","0","0","3","0","3","0","0","3","1","0","2","0","3","0","0","3","0","0","3"
"Perth","GB","44.90011","-76.24939","12","1","0","1","0","0","2","16","1","5","6","0","12","4","3","10","0","17","1","6","10","0","0","17"
"Perth","GB","43.01757","-74.19402","12","1","0","1","0","0","2","16","1","5","6","0","12","4","3","10","0","17","1","6","10","0","0","17"
"Perth","GB","56.39522","-3.43139","12","1","0","1","0","0","2","16","1","5","6","0","12","4","3","10","0","17","1","6","10","0","0","17"
"Perth","GB","-31.95224","115.8614","12","1","0","1","0","0","2","16","1","5","6","0","12","4","3","10","0","17","1","6","10","0","0","17"
"Perth","GB","-41.57231","147.17096","12","1","0","1","0","0","2","16","1","5","6","0","12","4","3","10","0","17","1","6","10","0","0","17"
"Peterborough","GB","44.30012","-78.31623","28","0","0","0","2","0","3","33","5","8","15","0","28","10","2","22","0","34","3","7","22","2","0","34"
"Peterborough","GB","42.87064","-71.95175","28","0","0","0","2","0","3","33","5","8","15","0","28","10","2","22","0","34","3","7","22","2","0","34"
"Peterborough","GB","52.57364","-0.24777","28","0","0","0","2","0","3","33","5","8","15","0","28","10","2","22","0","34","3","7","22","2","0","34"
"Peterborough","GB","-32.97205","138.84073","28","0","0","0","2","0","3","33","5","8","15","0","28","10","2","22","0","34","3","7","22","2","0","34"
"Peterhead","GB","57.50517","-1.78435","1","0","0","0","0","0","0","1","0","0","0","0","0","0","1","0","0","1","1","0","0","0","0","1"
"Peterhead","GB","-34.83118","138.49892","1","0","0","0","0","0","0","1","0","0","0","0","0","0","1","0","0","1","1","0","0","0","0","1"
"Peterlee","GB","54.76032","-1.33649","9","1","0","1","0","0","0","11","1","6","2","0","9","4","2","5","0","11","3","4","4","0","0","11"
"Petersfield","GB","18.26158","-78.07117","5","0","0","0","1","0","0","6","1","0","3","0","4","2","1","3","0","6","1","1","4","0","0","6"
"Petersfield","GB","51.00495","-0.93375","5","0","0","0","1","0","0","6","1","0","3","0","4","2","1","3","0","6","1","1","4","0","0","6"
"Petworth","GB","50.98669","-0.61","1","0","0","0","0","0","0","1","0","0","0","0","0","0","0","1","0","1","0","0","1","0","0","1"
"Pevensey","GB","50.81966","0.33963","1","0","0","0","0","0","0","1","0","1","0","0","1","0","0","1","0","1","0","0","1","0","0","1"
"Pewsey","GB","51.33855","-1.76545","1","1","1","0","0","0","1","4","0","0","2","0","2","2","0","2","0","4","1","1","2","0","0","4"
"Pickering","GB","43.90012","-79.13289","1","0","0","0","0","0","0","1","0","0","1","0","1","0","0","1","0","1","0","1","0","0","0","1"
"Pickering","GB","54.25","-0.76667","1","0","0","0","0","0","0","1","0","0","1","0","1","0","0","1","0","1","0","1","0","0","0","1"
"Pinner","GB","51.59384","-0.38216","4","0","0","1","0","0","0","5","2","1","1","0","4","3","1","1","0","5","2","0","3","0","0","5"
"Pitsea","GB","51.56387","0.50859","1","0","0","0","0","0","0","1","0","0","0","0","0","1","0","0","0","1","0","0","1","0","0","1"
"Pitstone","GB","51.8283","-0.63987","0","1","0","0","0","0","0","1","0","0","1","0","1","0","0","1","0","1","0","1","0","0","0","1"
"Plymouth","GB","38.48185","-120.84466","33","0","0","1","2","0","1","37","8","15","10","1","34","10","5","22","0","37","7","7","20","1","2","37"
"Plymouth","GB","45.01052","-93.45551","33","0","0","1","2","0","1","37","8","15","10","1","34","10","5","22","0","37","7","7","20","1","2","37"
"Plymouth","GB","43.74861","-87.97704","33","0","0","1","2","0","1","37","8","15","10","1","34","10","5","22","0","37","7","7","20","1","2","37"
"Plymouth","GB","41.34366","-86.30973","33","0","0","1","2","0","1","37","8","15","10","1","34","10","5","22","0","37","7","7","20","1","2","37"
"Plymouth","GB","42.37143","-83.47021","33","0","0","1","2","0","1","37","8","15","10","1","34","10","5","22","0","37","7","7","20","1","2","37"
"Plymouth","GB","40.99561","-82.66712","33","0","0","1","2","0","1","37","8","15","10","1","34","10","5","22","0","37","7","7","20","1","2","37"
"Plymouth","GB","35.86683","-76.74856","33","0","0","1","2","0","1","37","8","15","10","1","34","10","5","22","0","37","7","7","20","1","2","37"
"Plymouth","GB","41.24036","-75.94464","33","0","0","1","2","0","1","37","8","15","10","1","34","10","5","22","0","37","7","7","20","1","2","37"
"Plymouth","GB","41.67204","-73.05289","33","0","0","1","2","0","1","37","8","15","10","1","34","10","5","22","0","37","7","7","20","1","2","37"
"Plymouth","GB","43.75702","-71.68813","33","0","0","1","2","0","1","37","8","15","10","1","34","10","5","22","0","37","7","7","20","1","2","37"
"Plymouth","GB","41.95844","-70.66726","33","0","0","1","2","0","1","37","8","15","10","1","34","10","5","22","0","37","7","7","20","1","2","37"
"Plymouth","GB","44.76729","-69.21033","33","0","0","1","2","0","1","37","8","15","10","1","34","10","5","22","0","37","7","7","20","1","2","37"
"Plymouth","GB","16.70555","-62.21292","33","0","0","1","2","0","1","37","8","15","10","1","34","10","5","22","0","37","7","7","20","1","2","37"
"Plymouth","GB","50.37153","-4.14305","33","0","0","1","2","0","1","37","8","15","10","1","34","10","5","22","0","37","7","7","20","1","2","37"
"Plympton","GB","41.95288","-70.81448","2","0","0","0","0","0","1","3","0","0","2","0","2","1","1","1","0","3","1","0","2","0","0","3"
"Plympton","GB","50.39074","-4.06022","2","0","0","0","0","0","1","3","0","0","2","0","2","1","1","1","0","3","1","0","2","0","0","3"
"Plympton","GB","-34.962","138.55496","2","0","0","0","0","0","1","3","0","0","2","0","2","1","1","1","0","3","1","0","2","0","0","3"
"Plymstock","GB","50.35999","-4.09049","2","0","0","0","0","0","0","2","0","2","0","0","2","1","1","0","0","2","1","0","1","0","0","2"
"Pocklington","GB","53.93335","-0.78106","3","0","0","0","0","0","0","3","0","2","1","0","3","0","1","2","0","3","1","0","2","0","0","3"
"Pontarddulais","GB","51.71423","-4.03859","0","0","0","0","0","0","1","1","1","0","0","0","1","0","0","1","0","1","0","1","0","0","0","1"
"Pontefract","GB","53.69107","-1.31269","8","0","0","0","0","0","0","8","0","3","3","0","6","2","1","5","0","8","1","1","6","0","0","8"
"Ponteland","GB","55.05024","-1.74532","3","0","0","0","0","0","1","4","1","0","2","0","3","0","0","4","0","4","0","1","3","0","0","4"
"Pontyberem","GB","51.77826","-4.1689","0","0","0","0","1","0","0","1","0","0","1","0","1","0","0","1","0","1","0","0","1","0","0","1"
"Pontyclun","GB","51.52162","-3.39145","6","0","0","0","1","0","0","7","4","1","2","0","7","0","2","5","0","7","0","1","6","0","0","7"
"Pontypool","GB","51.70111","-3.04444","6","0","0","0","1","0","0","7","1","3","3","0","7","1","2","4","0","7","2","2","3","0","0","7"
"Pontypridd","GB","51.6021","-3.34211","11","1","0","0","1","0","1","14","3","5","3","1","12","5","1","8","0","14","3","6","5","0","0","14"
"Poole","GB","50.71429","-1.98458","23","3","0","2","4","0","1","33","2","9","15","2","28","12","6","15","0","33","9","7","15","0","2","33"
"Port Glasgow","GB","55.93464","-4.6895","1","0","0","0","0","0","0","1","0","1","0","0","1","0","0","1","0","1","1","0","0","0","0","1"
"Porth","GB","51.61306","-3.40361","9","0","0","1","0","0","1","11","2","4","5","0","11","5","3","3","0","11","0","5","6","0","0","11"
"Porthcawl","GB","51.47903","-3.70362","0","0","0","0","0","0","1","1","1","0","0","0","1","0","0","1","0","1","1","0","0","0","0","1"
"Portishead","GB","51.48199","-2.76973","3","0","0","0","0","0","0","3","0","1","2","0","3","1","0","2","0","3","0","0","3","0","0","3"
"Portland","GB","45.52345","-122.67621","2","0","0","0","0","0","0","2","0","2","0","0","2","0","0","2","0","2","1","0","1","0","0","2"
"Portland","GB","47.49832","-97.37037","2","0","0","0","0","0","0","2","0","2","0","0","2","0","0","2","0","2","1","0","1","0","0","2"
"Portland","GB","27.87725","-97.32388","2","0","0","0","0","0","0","2","0","2","0","0","2","0","0","2","0","2","1","0","1","0","0","2"
"Portland","GB","43.76886","-90.85819","2","0","0","0","0","0","0","2","0","2","0","0","2","0","0","2","0","2","1","0","1","0","0","2"
"Portland","GB","36.58171","-86.51638","2","0","0","0","0","0","0","2","0","2","0","0","2","0","0","2","0","2","1","0","1","0","0","2"
"Portland","GB","40.43449","-84.97775","2","0","0","0","0","0","0","2","0","2","0","0","2","0","0","2","0","2","1","0","1","0","0","2"
"Portland","GB","42.8692","-84.90305","2","0","0","0","0","0","0","2","0","2","0","0","2","0","0","2","0","2","1","0","1","0","0","2"
"Portland","GB","42.37978","-79.46755","2","0","0","0","0","0","0","2","0","2","0","0","2","0","0","2","0","2","1","0","1","0","0","2"
"Portland","GB","40.92315","-75.09657","2","0","0","0","0","0","0","2","0","2","0","0","2","0","0","2","0","2","1","0","1","0","0","2"
"Portland","GB","41.57288","-72.64065","2","0","0","0","0","0","0","2","0","2","0","0","2","0","0","2","0","2","1","0","1","0","0","2"
"Portland","GB","43.65737","-70.2589","2","0","0","0","0","0","0","2","0","2","0","0","2","0","0","2","0","2","1","0","1","0","0","2"
"Portland","GB","50.56748","-2.44472","2","0","0","0","0","0","0","2","0","2","0","0","2","0","0","2","0","2","1","0","1","0","0","2"
"Portland","GB","-38.3462","141.60257","2","0","0","0","0","0","0","2","0","2","0","0","2","0","0","2","0","2","1","0","1","0","0","2"
"Portland","GB","-33.35709","149.98148","2","0","0","0","0","0","0","2","0","2","0","0","2","0","0","2","0","2","1","0","1","0","0","2"
"Portree","GB","57.41288","-6.19418","1","0","0","0","2","0","0","3","0","1","1","0","2","0","1","2","0","3","1","1","1","0","0","3"
"Portrush","GB","55.19592","-6.6493","2","0","0","0","0","0","0","2","0","1","1","0","2","1","0","1","0","2","0","1","1","0","0","2"
"Portsmouth","GB","38.73174","-82.99767","56","0","0","1","4","0","3","64","15","22","22","0","59","22","8","34","0","64","9","13","34","4","4","64"
"Portsmouth","GB","36.83543","-76.29827","56","0","0","1","4","0","3","64","15","22","22","0","59","22","8","34","0","64","9","13","34","4","4","64"
"Portsmouth","GB","41.60232","-71.25033","56","0","0","1","4","0","3","64","15","22","22","0","59","22","8","34","0","64","9","13","34","4","4","64"
"Portsmouth","GB","43.07704","-70.75766","56","0","0","1","4","0","3","64","15","22","22","0","59","22","8","34","0","64","9","13","34","4","4","64"
"Portsmouth","GB","15.58333","-61.46667","56","0","0","1","4","0","3","64","15","22","22","0","59","22","8","34","0","64","9","13","34","4","4","64"
"Portsmouth","GB","50.79899","-1.09125","56","0","0","1","4","0","3","64","15","22","22","0","59","22","8","34","0","64","9","13","34","4","4","64"
"Portstewart","GB","55.18132","-6.71402","2","0","0","0","0","0","0","2","0","0","1","0","1","1","0","1","0","2","0","2","0","0","0","2"
"Port Talbot","GB","51.59241","-3.78019","14","0","0","0","0","0","1","15","3","9","3","0","15","5","3","7","0","15","8","2","5","0","0","15"
"Potters Bar","GB","51.69353","-0.17835","5","0","0","0","0","0","0","5","0","0","2","0","2","2","0","3","0","5","1","1","3","0","0","5"
"Potton","GB","52.12911","-0.21561","1","0","0","1","0","0","0","2","1","0","1","0","2","0","0","2","0","2","0","0","2","0","0","2"
"Poulton-le-Fylde","GB","53.83333","-2.98333","4","0","0","0","0","0","0","4","2","1","0","0","3","2","0","2","0","4","1","0","3","0","0","4"
"Poynton","GB","53.35","-2.11667","2","0","0","0","0","0","0","2","0","1","0","0","1","2","0","0","0","2","0","0","2","0","0","2"
"Preesall","GB","53.9182","-2.96633","1","0","0","0","0","0","0","1","0","1","0","0","1","0","1","0","0","1","1","0","0","0","0","1"
"Prenton","GB","53.36762","-3.05479","2","0","0","0","0","0","0","2","0","2","0","0","2","1","0","1","0","2","2","0","0","0","0","2"
"Prescot","GB","53.42948","-2.80031","0","1","0","0","0","0","0","1","1","0","0","0","1","0","0","1","0","1","0","0","1","0","0","1"
"Prestatyn","GB","53.33748","-3.40776","1","0","0","0","0","0","0","1","0","1","0","0","1","0","1","0","0","1","1","0","0","0","0","1"
"Prestbury","GB","41.78329","-88.41764","1","0","0","0","0","0","0","1","0","0","0","0","0","0","0","1","0","1","0","0","1","0","0","1"
"Prestbury","GB","53.28333","-2.15","1","0","0","0","0","0","0","1","0","0","0","0","0","0","0","1","0","1","0","0","1","0","0","1"
"Preston","GB","42.09631","-111.87662","50","2","0","1","2","0","0","55","8","12","23","1","44","18","14","21","2","55","14","12","25","0","4","55"
"Preston","GB","33.88232","-96.63305","50","2","0","1","2","0","0","55","8","12","23","1","44","18","14","21","2","55","14","12","25","0","4","55"
"Preston","GB","43.67024","-92.08322","50","2","0","1","2","0","0","55","8","12","23","1","44","18","14","21","2","55","14","12","25","0","4","55"
"Preston","GB","42.0503","-90.41402","50","2","0","1","2","0","0","55","8","12","23","1","44","18","14","21","2","55","14","12","25","0","4","55"
"Preston","GB","32.06599","-84.53742","50","2","0","1","2","0","0","55","8","12","23","1","44","18","14","21","2","55","14","12","25","0","4","55"
"Preston","GB","38.71262","-75.90994","50","2","0","1","2","0","0","55","8","12","23","1","44","18","14","21","2","55","14","12","25","0","4","55"
"Preston","GB","53.76282","-2.70452","50","2","0","1","2","0","0","55","8","12","23","1","44","18","14","21","2","55","14","12","25","0","4","55"
"Preston","GB","52.61264","-0.71437","50","2","0","1","2","0","0","55","8","12","23","1","44","18","14","21","2","55","14","12","25","0","4","55"
"Preston","GB","53.75663","-0.19775","50","2","0","1","2","0","0","55","8","12","23","1","44","18","14","21","2","55","14","12","25","0","4","55"
"Preston","GB","-37.75","145.01667","50","2","0","1","2","0","0","55","8","12","23","1","44","18","14","21","2","55","14","12","25","0","4","55"
"Preston","GB","-27.66037","151.98658","50","2","0","1","2","0","0","55","8","12","23","1","44","18","14","21","2","55","14","12","25","0","4","55"
"Preston Candover","GB","51.17057","-1.13372","1","0","0","0","0","0","0","1","0","0","1","0","1","1","0","0","0","1","0","1","0","0","0","1"
"Prestonpans","GB","55.95939","-2.98038","3","0","0","0","0","0","0","3","0","2","1","0","3","0","0","3","0","3","0","0","3","0","0","3"
"Prestwich","GB","53.53333","-2.28333","1","0","0","0","0","0","0","1","0","0","1","0","1","1","0","0","0","1","0","1","0","0","0","1"
"Prestwick","GB","55.48333","-4.61667","1","0","0","0","1","0","0","2","0","2","0","0","2","0","2","0","0","2","2","0","0","0","0","2"
"Princes Risborough","GB","51.72549","-0.83144","4","0","0","0","0","0","1","5","1","1","2","1","5","2","1","2","0","5","1","0","4","0","0","5"
"Prudhoe","GB","54.96154","-1.85168","2","0","0","0","2","0","0","4","1","1","1","0","3","0","1","3","0","4","1","0","3","0","0","4"
"Puckeridge","GB","51.89013","0.01309","1","0","0","0","0","0","0","1","0","0","1","0","1","1","0","0","0","1","0","0","1","0","0","1"
"Pudsey","GB","53.79538","-1.66134","0","0","0","0","2","0","1","3","1","0","2","0","3","2","0","1","0","3","0","0","3","0","0","3"
"Pulborough","GB","50.95753","-0.5128","5","0","0","0","0","0","2","7","2","2","2","0","6","1","1","5","0","7","1","4","2","0","0","7"
"Purley","GB","51.33678","-0.11201","11","0","0","0","3","0","2","16","4","5","5","1","15","4","5","7","0","16","4","6","6","0","0","16"
"Pwllheli","GB","52.8899","-4.41451","1","1","0","0","0","0","0","2","1","0","0","0","1","0","0","2","0","2","1","0","1","0","0","2"
"Quainton","GB","51.87408","-0.91727","1","0","0","0","0","0","0","1","0","1","0","0","1","0","0","1","0","1","1","0","0","0","0","1"
"Queensferry","GB","55.99089","-3.39847","1","0","0","0","0","0","0","1","0","1","0","0","1","0","0","1","0","1","0","0","1","0","0","1"
"Queensferry","GB","53.2","-3.03333","1","0","0","0","0","0","0","1","0","1","0","0","1","0","0","1","0","1","0","0","1","0","0","1"
"Radcliffe","GB","42.31526","-93.43438","3","0","0","0","0","0","0","3","0","2","0","0","2","2","0","1","0","3","0","2","1","0","0","3"
"Radcliffe","GB","53.56178","-2.32455","3","0","0","0","0","0","0","3","0","2","0","0","2","2","0","1","0","3","0","2","1","0","0","3"
"Radlett","GB","51.68593","-0.31868","7","0","0","1","2","0","0","10","1","2","1","0","4","7","1","2","0","10","1","1","8","0","0","10"
"Radley","GB","51.68746","-1.24025","1","0","0","0","0","0","0","1","0","0","1","0","1","1","0","0","0","1","0","0","1","0","0","1"
"Radstock","GB","51.28862","-2.46003","8","1","0","0","1","0","2","12","4","1","2","0","7","6","1","5","0","12","1","3","8","0","0","12"
"Rainham","GB","51.36323","0.60893","5","0","0","0","0","0","0","5","0","2","3","0","5","0","2","3","0","5","0","3","1","1","0","5"
"Ramsgate","GB","51.33568","1.41797","1","0","0","0","0","0","0","1","0","0","0","0","0","1","0","0","0","1","0","1","0","0","0","1"
"Ramsgate","GB","-33.9822","151.14","1","0","0","0","0","0","0","1","0","0","0","0","0","1","0","0","0","1","0","1","0","0","0","1"
"Rawtenstall","GB","53.70076","-2.28442","1","0","0","0","0","0","0","1","0","0","0","0","0","1","0","0","0","1","0","0","1","0","0","1"
"Rayleigh","GB","51.58571","0.60459","5","0","0","0","0","0","2","7","0","3","3","0","6","4","0","3","0","7","0","2","5","0","0","7"
"Reading","GB","41.83949","-84.74801","83","0","0","1","7","0","7","98","18","24","42","1","85","24","12","61","1","98","9","20","65","0","4","98"
"Reading","GB","39.22367","-84.44216","83","0","0","1","7","0","7","98","18","24","42","1","85","24","12","61","1","98","9","20","65","0","4","98"
"Reading","GB","40.33565","-75.92687","83","0","0","1","7","0","7","98","18","24","42","1","85","24","12","61","1","98","9","20","65","0","4","98"
"Reading","GB","42.52565","-71.09533","83","0","0","1","7","0","7","98","18","24","42","1","85","24","12","61","1","98","9","20","65","0","4","98"
"Reading","GB","51.45625","-0.97113","83","0","0","1","7","0","7","98","18","24","42","1","85","24","12","61","1","98","9","20","65","0","4","98"
"Redcar","GB","54.61657","-1.05999","3","0","0","0","1","0","1","5","1","1","2","0","4","2","2","1","0","5","2","2","1","0","0","5"
"Redditch","GB","52.3065","-1.94569","8","0","0","1","1","0","0","10","3","4","0","0","7","4","0","6","0","10","0","2","8","0","0","10"
"Redhill","GB","51.24048","-0.17044","7","0","0","0","0","0","3","10","1","4","4","0","9","2","0","8","0","10","1","4","4","1","0","10"
"Redruth","GB","50.23315","-5.22434","2","0","0","0","0","0","1","3","1","0","2","0","3","1","0","2","0","3","1","1","1","0","0","3"
"Reigate","GB","51.23736","-0.20582","10","0","0","0","0","0","0","10","3","3","3","0","9","4","2","4","0","10","0","3","7","0","0","10"
"Renfrew","GB","45.46681","-76.68272","2","0","0","0","0","0","1","3","2","0","1","0","3","2","1","0","0","3","0","1","2","0","0","3"
"Renfrew","GB","55.87197","-4.39253","2","0","0","0","0","0","1","3","2","0","1","0","3","2","1","0","0","3","0","1","2","0","0","3"
"Retford","GB","53.32213","-0.94315","5","0","0","0","0","0","0","5","0","1","4","0","5","5","0","0","0","5","1","2","2","0","0","5"
"Rhayader","GB","52.30154","-3.51146","3","0","0","0","0","0","0","3","2","0","1","0","3","0","1","1","1","3","0","1","1","0","1","3"
"Rhondda","GB","51.65896","-3.44885","26","1","0","2","3","0","1","33","12","9","11","0","32","5","7","21","0","33","7","7","18","1","0","33"
"Rhymney","GB","51.75998","-3.28553","5","0","0","0","0","0","0","5","0","4","1","0","5","3","2","0","0","5","4","1","0","0","0","5"
"Richmond","GB","49.17003","-123.13683","24","1","0","8","1","0","4","38","12","9","6","0","27","17","5","16","0","38","2","7","28","1","0","38"
"Richmond","GB","37.93576","-122.34775","24","1","0","8","1","0","4","38","12","9","6","0","27","17","5","16","0","38","2","7","28","1","0","38"
"Richmond","GB","41.92271","-111.81356","24","1","0","8","1","0","4","38","12","9","6","0","27","17","5","16","0","38","2","7","28","1","0","38"
"Richmond","GB","29.58218","-95.76078","24","1","0","8","1","0","4","38","12","9","6","0","27","17","5","16","0","38","2","7","28","1","0","38"
"Richmond","GB","45.45413","-94.51833","24","1","0","8","1","0","4","38","12","9","6","0","27","17","5","16","0","38","2","7","28","1","0","38"
"Richmond","GB","39.27862","-93.97689","24","1","0","8","1","0","4","38","12","9","6","0","27","17","5","16","0","38","2","7","28","1","0","38"
"Richmond","GB","32.38792","-91.18205","24","1","0","8","1","0","4","38","12","9","6","0","27","17","5","16","0","38","2","7","28","1","0","38"
"Richmond","GB","40.36087","-89.36898","24","1","0","8","1","0","4","38","12","9","6","0","27","17","5","16","0","38","2","7","28","1","0","38"
"Richmond","GB","42.71473","-88.74927","24","1","0","8","1","0","4","38","12","9","6","0","27","17","5","16","0","38","2","7","28","1","0","38"
"Richmond","GB","42.47585","-88.30593","24","1","0","8","1","0","4","38","12","9","6","0","27","17","5","16","0","38","2","7","28","1","0","38"
"Richmond","GB","39.82894","-84.89024","24","1","0","8","1","0","4","38","12","9","6","0","27","17","5","16","0","38","2","7","28","1","0","38"
"Richmond","GB","37.74786","-84.29465","24","1","0","8","1","0","4","38","12","9","6","0","27","17","5","16","0","38","2","7","28","1","0","38"
"Richmond","GB","42.8092","-82.75576","24","1","0","8","1","0","4","38","12","9","6","0","27","17","5","16","0","38","2","7","28","1","0","38"
"Richmond","GB","37.55376","-77.46026","24","1","0","8","1","0","4","38","12","9","6","0","27","17","5","16","0","38","2","7","28","1","0","38"
"Richmond","GB","18.25478","-76.88799","24","1","0","8","1","0","4","38","12","9","6","0","27","17","5","16","0","38","2","7","28","1","0","38"
"Richmond","GB","45.1834","-75.83266","24","1","0","8","1","0","4","38","12","9","6","0","27","17","5","16","0","38","2","7","28","1","0","38"
"Richmond","GB","42.37314","-73.36761","24","1","0","8","1","0","4","38","12","9","6","0","27","17","5","16","0","38","2","7","28","1","0","38"
"Richmond","GB","44.40533","-72.9929","24","1","0","8","1","0","4","38","12","9","6","0","27","17","5","16","0","38","2","7","28","1","0","38"
"Richmond","GB","42.75481","-72.27175","24","1","0","8","1","0","4","38","12","9","6","0","27","17","5","16","0","38","2","7","28","1","0","38"
"Richmond","GB","45.66677","-72.1491","24","1","0","8","1","0","4","38","12","9","6","0","27","17","5","16","0","38","2","7","28","1","0","38"
"Richmond","GB","44.0873","-69.79893","24","1","0","8","1","0","4","38","12","9","6","0","27","17","5","16","0","38","2","7","28","1","0","38"
"Richmond","GB","54.4036","-1.73434","24","1","0","8","1","0","4","38","12","9","6","0","27","17","5","16","0","38","2","7","28","1","0","38"
"Richmond","GB","51.46171","-0.30633","24","1","0","8","1","0","4","38","12","9","6","0","27","17","5","16","0","38","2","7","28","1","0","38"
"Richmond","GB","-29.87196","30.27235","24","1","0","8","1","0","4","38","12","9","6","0","27","17","5","16","0","38","2","7","28","1","0","38"
"Richmond","GB","-34.94199","138.56322","24","1","0","8","1","0","4","38","12","9","6","0","27","17","5","16","0","38","2","7","28","1","0","38"
"Richmond","GB","-20.73243","143.14355","24","1","0","8","1","0","4","38","12","9","6","0","27","17","5","16","0","38","2","7","28","1","0","38"
"Richmond","GB","-37.81819","145.00176","24","1","0","8","1","0","4","38","12","9","6","0","27","17","5","16","0","38","2","7","28","1","0","38"
"Richmond","GB","-42.73554","147.43833","24","1","0","8","1","0","4","38","12","9","6","0","27","17","5","16","0","38","2","7","28","1","0","38"
"Richmond","GB","-33.59956","150.75142","24","1","0","8","1","0","4","38","12","9","6","0","27","17","5","16","0","38","2","7","28","1","0","38"
"Richmond","GB","-41.33333","173.18333","24","1","0","8","1","0","4","38","12","9","6","0","27","17","5","16","0","38","2","7","28","1","0","38"
"Rickmansworth","GB","51.63898","-0.47718","11","0","0","1","2","0","2","16","7","2","3","0","12","5","1","10","0","16","2","3","11","0","0","16"
"Ringwood","GB","36.37948","-98.24535","3","0","0","0","0","0","0","3","1","1","1","0","3","0","1","2","0","3","1","2","0","0","0","3"
"Ringwood","GB","42.39224","-88.29703","3","0","0","0","0","0","0","3","1","1","1","0","3","0","1","2","0","3","1","2","0","0","0","3"
"Ringwood","GB","41.11343","-74.24543","3","0","0","0","0","0","0","3","1","1","1","0","3","0","1","2","0","3","1","2","0","0","0","3"
"Ringwood","GB","50.84541","-1.78871","3","0","0","0","0","0","0","3","1","1","1","0","3","0","1","2","0","3","1","2","0","0","0","3"
"Ringwood","GB","-37.81667","145.23333","3","0","0","0","0","0","0","3","1","1","1","0","3","0","1","2","0","3","1","2","0","0","0","3"
"Ripley","GB","33.5253","-114.65607","2","0","0","0","0","0","1","3","0","1","1","0","2","1","1","1","0","3","0","2","1","0","0","3"
"Ripley","GB","35.74536","-89.5298","2","0","0","0","0","0","1","3","0","1","1","0","2","1","1","1","0","3","0","2","1","0","0","3"
"Ripley","GB","34.72982","-88.95062","2","0","0","0","0","0","1","3","0","1","1","0","2","1","1","1","0","3","0","2","1","0","0","3"
"Ripley","GB","38.74563","-83.84492","2","0","0","0","0","0","1","3","0","1","1","0","2","1","1","1","0","3","0","2","1","0","0","3"
"Ripley","GB","38.8187","-81.71069","2","0","0","0","0","0","1","3","0","1","1","0","2","1","1","1","0","3","0","2","1","0","0","3"
"Ripley","GB","42.267","-79.7106","2","0","0","0","0","0","1","3","0","1","1","0","2","1","1","1","0","3","0","2","1","0","0","3"
"Ripley","GB","53.03333","-1.4","2","0","0","0","0","0","1","3","0","1","1","0","2","1","1","1","0","3","0","2","1","0","0","3"
"Ripley","GB","51.29907","-0.49164","2","0","0","0","0","0","1","3","0","1","1","0","2","1","1","1","0","3","0","2","1","0","0","3"
"Ripley","GB","-27.71667","152.83333","2","0","0","0","0","0","1","3","0","1","1","0","2","1","1","1","0","3","0","2","1","0","0","3"
"Ripon","GB","37.74159","-121.12438","6","0","0","1","0","0","0","7","2","2","3","0","7","2","2","3","0","7","2","0","5","0","0","7"
"Ripon","GB","43.8422","-88.83594","6","0","0","1","0","0","0","7","2","2","3","0","7","2","2","3","0","7","2","0","5","0","0","7"
"Ripon","GB","54.13579","-1.52826","6","0","0","1","0","0","0","7","2","2","3","0","7","2","2","3","0","7","2","0","5","0","0","7"
"Ripponden","GB","53.67449","-1.94183","2","0","0","0","0","0","0","2","0","1","1","0","2","1","0","1","0","2","1","0","1","0","0","2"
"Risca","GB","51.60799","-3.10081","2","0","0","0","0","0","0","2","0","2","0","0","2","1","0","1","0","2","1","0","0","0","1","2"
"Rochdale","GB","53.61766","-2.1552","11","0","0","0","2","0","3","16","2","5","6","0","13","10","2","4","0","16","4","1","10","1","0","16"
"Rochester","GB","46.82177","-123.09625","5","1","0","0","1","0","0","7","1","4","0","0","5","2","2","3","0","7","1","3","3","0","0","7"
"Rochester","GB","44.02163","-92.4699","5","1","0","0","1","0","0","7","1","4","0","0","5","2","2","3","0","7","1","3","3","0","0","7"
"Rochester","GB","39.74949","-89.53176","5","1","0","0","1","0","0","7","1","4","0","0","5","2","2","3","0","7","1","3","3","0","0","7"
"Rochester","GB","42.74141","-88.22426","5","1","0","0","1","0","0","7","1","4","0","0","5","2","2","3","0","7","1","3","3","0","0","7"
"Rochester","GB","41.06476","-86.21583","5","1","0","0","1","0","0","7","1","4","0","0","5","2","2","3","0","7","1","3","3","0","0","7"
"Rochester","GB","42.68059","-83.13382","5","1","0","0","1","0","0","7","1","4","0","0","5","2","2","3","0","7","1","3","3","0","0","7"
"Rochester","GB","40.70229","-80.28645","5","1","0","0","1","0","0","7","1","4","0","0","5","2","2","3","0","7","1","3","3","0","0","7"
"Rochester","GB","43.15478","-77.61556","5","1","0","0","1","0","0","7","1","4","0","0","5","2","2","3","0","7","1","3","3","0","0","7"
"Rochester","GB","43.30453","-70.97562","5","1","0","0","1","0","0","7","1","4","0","0","5","2","2","3","0","7","1","3","3","0","0","7"
"Rochester","GB","41.73177","-70.82004","5","1","0","0","1","0","0","7","1","4","0","0","5","2","2","3","0","7","1","3","3","0","0","7"
"Rochester","GB","55.2752","-2.2649","5","1","0","0","1","0","0","7","1","4","0","0","5","2","2","3","0","7","1","3","3","0","0","7"
"Rochester","GB","51.38764","0.50546","5","1","0","0","1","0","0","7","1","4","0","0","5","2","2","3","0","7","1","3","3","0","0","7"
"Rochester","GB","-36.36352","144.70077","5","1","0","0","1","0","0","7","1","4","0","0","5","2","2","3","0","7","1","3","3","0","0","7"
"Rochford","GB","51.58198","0.70673","4","0","0","0","0","0","1","5","1","3","1","0","5","1","2","2","0","5","1","1","2","0","1","5"
"Romford","GB","51.57515","0.18582","18","2","0","1","4","0","1","26","7","7","10","0","24","8","2","15","1","26","1","8","14","2","1","26"
"Romsey","GB","50.98906","-1.49989","7","0","0","0","0","0","1","8","1","2","4","0","7","2","4","2","0","8","3","3","2","0","0","8"
"Romsey","GB","-37.35075","144.743","7","0","0","0","0","0","1","8","1","2","4","0","7","2","4","2","0","8","3","3","2","0","0","8"
"Romsley","GB","52.45","-2.31667","3","0","0","0","1","0","0","4","0","4","0","0","4","3","0","1","0","4","3","0","1","0","0","4"
"Romsley","GB","52.41996","-2.05695","3","0","0","0","1","0","0","4","0","4","0","0","4","3","0","1","0","4","3","0","1","0","0","4"
"Rossendale","GB","53.68456","-2.2769","1","0","0","0","0","0","0","1","0","1","0","0","1","0","0","1","0","1","1","0","0","0","0","1"
"Ross on Wye","GB","51.91667","-2.56667","3","0","0","0","0","0","0","3","0","1","2","0","3","1","0","2","0","3","1","0","2","0","0","3"
"Rotherfield Peppard","GB","51.53064","-0.97847","1","0","0","0","0","0","0","1","0","0","0","0","0","0","0","1","0","1","0","0","1","0","0","1"
"Rotherham","GB","53.43012","-1.35678","22","1","0","0","0","0","0","23","7","3","10","0","20","7","0","16","0","23","6","8","9","0","0","23"
"Rothley","GB","55.18333","-1.91667","0","0","0","0","1","0","0","1","1","0","0","0","1","0","0","1","0","1","0","0","1","0","0","1"
"Rothley","GB","52.70916","-1.13739","0","0","0","0","1","0","0","1","1","0","0","0","1","0","0","1","0","1","0","0","1","0","0","1"
"Rottingdean","GB","50.80984","-0.05939","1","0","0","0","0","0","0","1","0","0","1","0","1","1","0","0","0","1","0","0","1","0","0","1"
"Rowlands Gill","GB","54.91922","-1.74489","1","0","0","0","0","0","0","1","0","0","1","0","1","0","1","0","0","1","0","0","1","0","0","1"
"Royal Leamington Spa","GB","52.2852","-1.52","2","0","0","0","0","0","0","2","0","0","1","0","1","1","0","1","0","2","0","0","2","0","0","2"
"Royal Tunbridge Wells","GB","51.13321","0.26256","5","0","0","0","0","0","2","7","2","2","3","0","7","4","0","3","0","7","0","1","4","0","2","7"
"Royal Wootton Bassett","GB","51.5419","-1.9045","2","0","0","0","0","0","0","2","0","1","1","0","2","1","0","1","0","2","0","1","1","0","0","2"
"Roydon","GB","51.7718","0.0403","1","0","0","0","0","0","0","1","0","0","1","0","1","0","0","1","0","1","0","0","1","0","0","1"
"Royston","GB","49.64703","-124.9467","8","0","0","1","0","0","1","10","2","3","4","0","9","1","0","9","0","10","0","2","8","0","0","10"
"Royston","GB","34.28705","-83.11015","8","0","0","1","0","0","1","10","2","3","4","0","9","1","0","9","0","10","0","2","8","0","0","10"
"Royston","GB","53.6","-1.45","8","0","0","1","0","0","1","10","2","3","4","0","9","1","0","9","0","10","0","2","8","0","0","10"
"Royston","GB","52.04832","-0.02438","8","0","0","1","0","0","1","10","2","3","4","0","9","1","0","9","0","10","0","2","8","0","0","10"
"Rugby","GB","48.36889","-99.99625","15","1","0","2","1","0","1","20","2","6","8","0","16","6","3","11","0","20","7","2","11","0","0","20"
"Rugby","GB","52.37092","-1.26417","15","1","0","2","1","0","1","20","2","6","8","0","16","6","3","11","0","20","7","2","11","0","0","20"
"Rugeley","GB","52.7593","-1.93694","6","0","0","0","0","0","0","6","1","2","3","0","6","1","1","4","0","6","1","4","1","0","0","6"
"Ruislip","GB","51.57344","-0.42341","4","0","0","2","0","0","0","6","3","1","2","0","6","2","0","4","0","6","0","3","3","0","0","6"
"Runcorn","GB","53.34174","-2.73124","6","1","0","0","1","0","1","9","3","3","3","0","9","4","2","3","0","9","3","2","4","0","0","9"
"Runcorn","GB","-27.59756","153.07699","6","1","0","0","1","0","1","9","3","3","3","0","9","4","2","3","0","9","3","2","4","0","0","9"
"Rushden","GB","52.28927","-0.60184","4","1","0","0","1","0","0","6","1","2","2","0","5","3","1","2","0","6","2","2","2","0","0","6"
"Ruskington","GB","53.04544","-0.38692","0","0","0","0","1","0","0","1","1","0","0","0","1","0","1","0","0","1","0","1","0","0","0","1"
"Rusthall","GB","51.13643","0.22931","1","0","0","0","0","0","0","1","0","1","0","0","1","1","0","0","0","1","0","1","0","0","0","1"
"Rustington","GB","50.81027","-0.50674","2","0","0","0","0","0","0","2","0","1","0","0","1","1","1","0","0","2","1","0","1","0","0","2"
"Ruthin","GB","53.11368","-3.31782","5","0","0","0","0","0","0","5","0","3","2","0","5","0","2","3","0","5","2","2","1","0","0","5"
"Ryde","GB","50.72999","-1.1621","3","0","0","0","0","0","0","3","0","1","1","1","3","1","0","2","0","3","2","0","1","0","0","3"
"Ryde","GB","-33.8188","151.1062","3","0","0","0","0","0","0","3","0","1","1","1","3","1","0","2","0","3","2","0","1","0","0","3"
"Rye","GB","40.98065","-73.68374","6","0","0","0","0","0","0","6","1","2","1","0","4","2","0","4","0","6","0","2","4","0","0","6"
"Rye","GB","43.01342","-70.77089","6","0","0","0","0","0","0","6","1","2","1","0","4","2","0","4","0","6","0","2","4","0","0","6"
"Rye","GB","50.95114","0.7337","6","0","0","0","0","0","0","6","1","2","1","0","4","2","0","4","0","6","0","2","4","0","0","6"
"Rye","GB","-38.38528","144.81221","6","0","0","0","0","0","0","6","1","2","1","0","4","2","0","4","0","6","0","2","4","0","0","6"
"Ryton","GB","52.61667","-2.35","1","0","0","0","0","0","0","1","0","1","0","0","1","0","0","1","0","1","0","0","1","0","0","1"
"Saffron Walden","GB","52.02337","0.24234","9","1","0","0","0","0","0","10","3","1","3","0","7","3","2","5","0","10","0","4","5","0","1","10"
"Saint Andrews","GB","34.04543","-81.12926","1","0","0","0","0","0","0","1","0","0","1","0","1","1","0","0","0","1","0","0","1","0","0","1"
"Saint Andrews","GB","45.0737","-67.05312","1","0","0","0","0","0","0","1","0","0","1","0","1","1","0","0","0","1","0","0","1","0","0","1"
"Saint Andrews","GB","56.33871","-2.79902","1","0","0","0","0","0","0","1","0","0","1","0","1","1","0","0","0","1","0","0","1","0","0","1"
"Saint Andrews","GB","-37.60151","145.27235","1","0","0","0","0","0","0","1","0","0","1","0","1","1","0","0","0","1","0","0","1","0","0","1"
"Saint Asaph","GB","53.25815","-3.44524","1","0","0","0","0","0","0","1","0","1","0","0","1","0","1","0","0","1","0","0","1","0","0","1"
"Saint Neots","GB","52.21667","-0.26667","3","0","0","0","0","0","1","4","1","0","1","0","2","3","0","1","0","4","0","1","3","0","0","4"
"Salcombe","GB","50.23743","-3.76874","1","0","0","0","0","0","0","1","0","1","0","0","1","1","0","0","0","1","1","0","0","0","0","1"
"Sale","GB","34.0531","-6.79846","6","0","0","0","1","0","1","8","3","2","1","0","6","1","2","5","0","8","2","1","5","0","0","8"
"Sale","GB","53.42519","-2.32443","6","0","0","0","1","0","1","8","3","2","1","0","6","1","2","5","0","8","2","1","5","0","0","8"
"Sale","GB","44.97932","8.80963","6","0","0","0","1","0","1","8","3","2","1","0","6","1","2","5","0","8","2","1","5","0","0","8"
"Sale","GB","-6.8619","111.6043","6","0","0","0","1","0","1","8","3","2","1","0","6","1","2","5","0","8","2","1","5","0","0","8"
"Sale","GB","-38.11095","147.06802","6","0","0","0","1","0","1","8","3","2","1","0","6","1","2","5","0","8","2","1","5","0","0","8"
"Salford","GB","53.48771","-2.29042","17","0","0","0","3","0","0","20","1","6","10","0","17","7","4","9","0","20","3","5","12","0","0","20"
"Salisbury","GB","39.42392","-92.80158","21","1","0","1","6","0","0","29","7","12","6","1","26","8","4","17","0","29","6","6","17","0","0","29"
"Salisbury","GB","35.67097","-80.47423","21","1","0","1","6","0","0","29","7","12","6","1","26","8","4","17","0","29","6","6","17","0","0","29"
"Salisbury","GB","39.75286","-79.08086","21","1","0","1","6","0","0","29","7","12","6","1","26","8","4","17","0","29","6","6","17","0","0","29"
"Salisbury","GB","38.36067","-75.59937","21","1","0","1","6","0","0","29","7","12","6","1","26","8","4","17","0","29","6","6","17","0","0","29"
"Salisbury","GB","40.74566","-73.56013","21","1","0","1","6","0","0","29","7","12","6","1","26","8","4","17","0","29","6","6","17","0","0","29"
"Salisbury","GB","43.89645","-73.09984","21","1","0","1","6","0","0","29","7","12","6","1","26","8","4","17","0","29","6","6","17","0","0","29"
"Salisbury","GB","43.38008","-71.71702","21","1","0","1","6","0","0","29","7","12","6","1","26","8","4","17","0","29","6","6","17","0","0","29"
"Salisbury","GB","42.84176","-70.86061","21","1","0","1","6","0","0","29","7","12","6","1","26","8","4","17","0","29","6","6","17","0","0","29"
"Salisbury","GB","46.03905","-65.04628","21","1","0","1","6","0","0","29","7","12","6","1","26","8","4","17","0","29","6","6","17","0","0","29"
"Salisbury","GB","15.43689","-61.43637","21","1","0","1","6","0","0","29","7","12","6","1","26","8","4","17","0","29","6","6","17","0","0","29"
"Salisbury","GB","51.06931","-1.79569","21","1","0","1","6","0","0","29","7","12","6","1","26","8","4","17","0","29","6","6","17","0","0","29"
"Salisbury","GB","-34.76667","138.63333","21","1","0","1","6","0","0","29","7","12","6","1","26","8","4","17","0","29","6","6","17","0","0","29"
"Salisbury","GB","-27.55145","153.0325","21","1","0","1","6","0","0","29","7","12","6","1","26","8","4","17","0","29","6","6","17","0","0","29"
"Sallanches","GB","45.94423","6.63162","1","0","0","0","0","0","0","1","1","0","0","0","1","0","0","1","0","1","0","1","0","0","0","1"
"Saltash","GB","50.40959","-4.22514","2","0","0","0","0","0","0","2","0","0","2","0","2","1","0","1","0","2","0","2","0","0","0","2"
"Saltburn-by-the-Sea","GB","54.58237","-0.97367","1","0","0","0","1","0","0","2","1","0","1","0","2","0","0","2","0","2","0","0","2","0","0","2"
"Saltcoats","GB","55.63616","-4.78588","1","0","0","0","0","0","0","1","0","1","0","0","1","0","1","0","0","1","0","0","1","0","0","1"
"Sandbach","GB","53.14515","-2.36251","3","0","0","0","0","0","0","3","1","1","1","0","3","2","0","1","0","3","0","2","0","0","1","3"
"Sandhurst","GB","51.34675","-0.78655","6","0","0","0","0","0","0","6","0","5","1","0","6","0","2","4","0","6","3","0","3","0","0","6"
"Sandhurst","GB","-38.081","145.20767","6","0","0","0","0","0","0","6","0","5","1","0","6","0","2","4","0","6","3","0","3","0","0","6"
"Sandwich","GB","41.64586","-88.62174","1","0","0","0","0","0","0","1","0","0","0","0","0","0","0","1","0","1","0","1","0","0","0","1"
"Sandwich","GB","43.79035","-71.41118","1","0","0","0","0","0","0","1","0","0","0","0","0","0","0","1","0","1","0","1","0","0","0","1"
"Sandwich","GB","41.759","-70.49392","1","0","0","0","0","0","0","1","0","0","0","0","0","0","0","1","0","1","0","1","0","0","0","1"
"Sandwich","GB","51.27223","1.33776","1","0","0","0","0","0","0","1","0","0","0","0","0","0","0","1","0","1","0","1","0","0","0","1"
"Sandy","GB","45.39734","-122.26148","5","0","0","0","0","0","0","5","1","1","3","0","5","2","1","2","0","5","0","2","2","1","0","5"
"Sandy","GB","40.59161","-111.8841","5","0","0","0","0","0","0","5","1","1","3","0","5","2","1","2","0","5","0","2","2","1","0","5"
"Sandy","GB","41.10784","-78.77114","5","0","0","0","0","0","0","5","1","1","3","0","5","2","1","2","0","5","0","2","2","1","0","5"
"Sandy","GB","52.12927","-0.28925","5","0","0","0","0","0","0","5","1","1","3","0","5","2","1","2","0","5","0","2","2","1","0","5"
"Sarratt","GB","51.68458","-0.494","1","0","0","0","0","0","0","1","0","0","1","0","1","0","0","1","0","1","0","0","1","0","0","1"
"Saundersfoot","GB","51.70945","-4.70215","2","0","0","0","0","0","0","2","0","0","0","0","0","0","0","2","0","2","0","2","0","0","0","2"
"Sawbridgeworth","GB","51.81667","0.15","2","1","0","0","0","0","0","3","1","0","0","0","1","1","0","1","1","3","1","1","1","0","0","3"
"Saxmundham","GB","52.21497","1.48805","1","0","0","0","0","0","0","1","0","1","0","0","1","0","0","1","0","1","0","0","0","0","1","1"
"Scalby","GB","53.76667","-0.71667","1","0","0","0","0","0","0","1","0","0","1","0","1","1","0","0","0","1","0","1","0","0","0","1"
"Scarborough","GB","43.77223","-79.25666","10","0","0","0","4","0","3","17","5","4","7","0","16","5","3","9","0","17","6","3","7","0","1","17"
"Scarborough","GB","43.57814","-70.32172","10","0","0","0","4","0","3","17","5","4","7","0","16","5","3","9","0","17","6","3","7","0","1","17"
"Scarborough","GB","11.18229","-60.73525","10","0","0","0","4","0","3","17","5","4","7","0","16","5","3","9","0","17","6","3","7","0","1","17"
"Scarborough","GB","54.27966","-0.40443","10","0","0","0","4","0","3","17","5","4","7","0","16","5","3","9","0","17","6","3","7","0","1","17"
"Scarborough","GB","-31.89578","115.76431","10","0","0","0","4","0","3","17","5","4","7","0","16","5","3","9","0","17","6","3","7","0","1","17"
"Scarborough","GB","-27.20118","153.10939","10","0","0","0","4","0","3","17","5","4","7","0","16","5","3","9","0","17","6","3","7","0","1","17"
"Scunthorpe","GB","53.57905","-0.65437","6","0","0","1","1","0","0","8","3","3","0","0","6","5","0","3","0","8","4","1","3","0","0","8"
"Seaford","GB","38.64123","-75.61104","4","0","0","0","0","0","0","4","1","0","2","0","3","0","2","2","0","4","0","3","1","0","0","4"
"Seaford","GB","40.66593","-73.48818","4","0","0","0","0","0","0","4","1","0","2","0","3","0","2","2","0","4","0","3","1","0","0","4"
"Seaford","GB","50.77141","0.10268","4","0","0","0","0","0","0","4","1","0","2","0","3","0","2","2","0","4","0","3","1","0","0","4"
"Seaford","GB","-35.1898","138.47589","4","0","0","0","0","0","0","4","1","0","2","0","3","0","2","2","0","4","0","3","1","0","0","4"
"Seaford","GB","-38.1","145.13333","4","0","0","0","0","0","0","4","1","0","2","0","3","0","2","2","0","4","0","3","1","0","0","4"
"Seaham","GB","54.83903","-1.34575","3","0","0","0","1","0","2","6","1","1","4","0","6","2","2","2","0","6","1","3","2","0","0","6"
"Seaham","GB","-32.66221","151.72664","3","0","0","0","1","0","2","6","1","1","4","0","6","2","2","2","0","6","1","3","2","0","0","6"
"Seahouses","GB","55.58063","-1.65497","1","0","0","0","0","0","0","1","0","0","1","0","1","0","1","0","0","1","0","0","1","0","0","1"
"Seaton","GB","52.57489","-0.66759","0","0","0","0","1","0","0","1","0","0","1","0","1","1","0","0","0","1","0","1","0","0","0","1"
"Seaton","GB","-34.9","138.51667","0","0","0","0","1","0","0","1","0","0","1","0","1","1","0","0","0","1","0","1","0","0","0","1"
"Sedgefield","GB","54.65329","-1.44952","1","0","0","0","0","0","0","1","0","1","0","0","1","1","0","0","0","1","1","0","0","0","0","1"
"Seghill","GB","55.06225","-1.55027","1","0","0","0","0","0","0","1","0","0","0","0","0","0","0","1","0","1","0","1","0","0","0","1"
"Selby","GB","45.50638","-100.03207","7","0","0","2","1","0","1","11","3","2","6","0","11","4","0","7","0","11","2","3","6","0","0","11"
"Selby","GB","53.78333","-1.06667","7","0","0","2","1","0","1","11","3","2","6","0","11","4","0","7","0","11","2","3","6","0","0","11"
"Selby","GB","-37.91667","145.38333","7","0","0","2","1","0","1","11","3","2","6","0","11","4","0","7","0","11","2","3","6","0","0","11"
"Selkirk","GB","50.1436","-96.88452","1","0","0","0","0","0","1","2","0","0","1","0","1","1","1","0","0","2","0","1","1","0","0","2"
"Selkirk","GB","55.54738","-2.83911","1","0","0","0","0","0","1","2","0","0","1","0","1","1","1","0","0","2","0","1","1","0","0","2"
"Selsey","GB","50.73501","-0.78979","2","0","0","0","1","0","0","3","0","2","1","0","3","2","0","1","0","3","1","0","2","0","0","3"
"Settle","GB","54.06865","-2.2772","3","0","0","0","0","0","0","3","0","2","1","0","3","1","0","2","0","3","0","0","3","0","0","3"
"Sevenoaks","GB","51.27266","0.18883","19","0","0","1","4","0","1","25","4","7","8","0","19","10","3","12","0","25","2","6","15","0","2","25"
"Seven Sisters","GB","51.76667","-3.71667","1","0","0","0","0","0","0","1","0","1","0","0","1","1","0","0","0","1","0","0","1","0","0","1"
"Shaftesbury","GB","51.00528","-2.19333","7","0","0","0","0","0","0","7","1","4","1","0","6","4","1","2","0","7","2","1","4","0","0","7"
"Shanklin","GB","50.62613","-1.1785","1","0","0","0","0","0","0","1","0","0","1","0","1","1","0","0","0","1","0","0","1","0","0","1"
"Shawbury","GB","52.79098","-2.66183","0","0","0","1","0","0","0","1","0","0","1","0","1","0","1","0","0","1","0","0","1","0","0","1"
"Sheering","GB","51.80373","0.18454","2","0","0","0","0","0","0","2","0","1","0","0","1","0","2","0","0","2","1","1","0","0","0","2"
"Sheerness","GB","51.44042","0.76252","1","0","0","1","1","0","0","3","1","2","0","0","3","1","0","2","0","3","1","0","2","0","0","3"
"Sheffield","GB","42.8933","-93.2152","95","2","0","6","13","1","6","123","21","42","35","2","100","52","13","57","1","123","21","16","79","5","2","123"
"Sheffield","GB","41.35837","-89.73732","95","2","0","6","13","1","6","123","21","42","35","2","100","52","13","57","1","123","21","16","79","5","2","123"
"Sheffield","GB","34.76509","-87.69864","95","2","0","6","13","1","6","123","21","42","35","2","100","52","13","57","1","123","21","16","79","5","2","123"
"Sheffield","GB","41.42115","-82.09626","95","2","0","6","13","1","6","123","21","42","35","2","100","52","13","57","1","123","21","16","79","5","2","123"
"Sheffield","GB","41.70395","-79.0356","95","2","0","6","13","1","6","123","21","42","35","2","100","52","13","57","1","123","21","16","79","5","2","123"
"Sheffield","GB","42.11037","-73.35511","95","2","0","6","13","1","6","123","21","42","35","2","100","52","13","57","1","123","21","16","79","5","2","123"
"Sheffield","GB","53.38297","-1.4659","95","2","0","6","13","1","6","123","21","42","35","2","100","52","13","57","1","123","21","16","79","5","2","123"
"Sheffield","GB","-41.39947","146.33897","95","2","0","6","13","1","6","123","21","42","35","2","100","52","13","57","1","123","21","16","79","5","2","123"
"Shefford","GB","52.0387","-0.33399","3","0","0","0","0","0","0","3","0","1","1","0","2","1","0","2","0","3","0","1","1","0","1","3"
"Shenley","GB","46.00007","-70.83234","2","0","0","0","0","0","0","2","0","0","1","0","1","2","0","0","0","2","0","1","1","0","0","2"
"Shenley","GB","51.69054","-0.28067","2","0","0","0","0","0","0","2","0","0","1","0","1","2","0","0","0","2","0","1","1","0","0","2"
"Shepperton","GB","51.39546","-0.44889","3","0","0","0","0","0","0","3","1","1","0","0","2","0","1","2","0","3","0","1","2","0","0","3"
"Shepton Mallet","GB","51.18972","-2.54722","4","0","0","0","0","0","0","4","0","0","2","0","2","0","2","2","0","4","2","1","1","0","0","4"
"Sherborne","GB","50.94599","-2.51776","7","0","0","0","0","0","1","8","0","1","5","0","6","0","1","7","0","8","1","5","1","0","1","8"
"Sherburn in Elmet","GB","53.79519","-1.2466","1","0","0","0","0","0","0","1","0","0","0","0","0","0","0","1","0","1","0","0","1","0","0","1"
"Sheringham","GB","52.94078","1.20931","1","0","0","0","0","0","0","1","0","0","1","0","1","0","0","1","0","1","0","1","0","0","0","1"
"Sherington","GB","52.11172","-0.69973","1","0","0","0","0","0","0","1","0","1","0","0","1","1","0","0","0","1","0","0","0","0","1","1"
"Sherston","GB","51.57205","-2.21278","1","0","0","0","0","0","0","1","0","1","0","0","1","1","0","0","0","1","1","0","0","0","0","1"
"Shifnal","GB","52.67043","-2.37248","6","0","0","0","0","0","1","7","0","4","3","0","7","2","1","4","0","7","4","0","3","0","0","7"
"Shildon","GB","54.62997","-1.64295","2","0","0","0","0","0","0","2","0","1","1","0","2","2","0","0","0","2","0","0","2","0","0","2"
"Shinfield","GB","51.40542","-0.94534","1","0","0","0","0","0","0","1","0","1","0","0","1","0","0","1","0","1","0","1","0","0","0","1"
"Shipham","GB","51.31428","-2.8001","0","0","0","0","1","0","0","1","1","0","0","0","1","0","0","1","0","1","0","0","1","0","0","1"
"Shipley","GB","53.83333","-1.76667","2","0","0","0","0","0","0","2","0","1","1","0","2","0","0","2","0","2","0","0","2","0","0","2"
"Shiremoor","GB","55.03535","-1.5095","1","0","0","0","0","0","0","1","0","0","1","0","1","0","0","1","0","1","0","0","1","0","0","1"
"Shirley","GB","39.89199","-85.57692","1","0","0","0","0","0","0","1","1","0","0","0","1","0","0","1","0","1","0","1","0","0","0","1"
"Shirley","GB","40.80149","-72.8676","1","0","0","0","0","0","0","1","1","0","0","0","1","0","0","1","0","1","0","1","0","0","0","1"
"Shirley","GB","42.5437","-71.64951","1","0","0","0","0","0","0","1","1","0","0","0","1","0","0","1","0","1","0","1","0","0","0","1"
"Shirley","GB","52.41074","-1.81952","1","0","0","0","0","0","0","1","1","0","0","0","1","0","0","1","0","1","0","1","0","0","0","1"
"Shirley","GB","52.97012","-1.6755","1","0","0","0","0","0","0","1","1","0","0","0","1","0","0","1","0","1","0","1","0","0","0","1"
"Shoreham-by-Sea","GB","50.83413","-0.27431","8","0","0","0","1","0","1","10","1","3","3","0","7","5","3","2","0","10","2","1","6","1","0","10"
"Shotton","GB","54.78333","-1.36667","1","0","0","0","0","0","1","2","0","2","0","0","2","1","1","0","0","2","0","1","1","0","0","2"
"Shotts","GB","55.81951","-3.79749","2","0","0","0","0","0","0","2","1","0","1","0","2","1","1","0","0","2","0","2","0","0","0","2"
"Shrewsbury","GB","38.59033","-90.33678","25","4","0","0","4","0","3","36","6","8","12","2","28","12","5","18","1","36","7","13","16","0","0","36"
"Shrewsbury","GB","38.20621","-81.4715","25","4","0","0","4","0","3","36","6","8","12","2","28","12","5","18","1","36","7","13","16","0","0","36"
"Shrewsbury","GB","39.76871","-76.67969","25","4","0","0","4","0","3","36","6","8","12","2","28","12","5","18","1","36","7","13","16","0","0","36"
"Shrewsbury","GB","40.18261","-74.52932","25","4","0","0","4","0","3","36","6","8","12","2","28","12","5","18","1","36","7","13","16","0","0","36"
"Shrewsbury","GB","40.32955","-74.06153","25","4","0","0","4","0","3","36","6","8","12","2","28","12","5","18","1","36","7","13","16","0","0","36"
"Shrewsbury","GB","42.29593","-71.71285","25","4","0","0","4","0","3","36","6","8","12","2","28","12","5","18","1","36","7","13","16","0","0","36"
"Shrewsbury","GB","52.71009","-2.75208","25","4","0","0","4","0","3","36","6","8","12","2","28","12","5","18","1","36","7","13","16","0","0","36"
"Shrivenham","GB","51.59853","-1.65461","0","0","0","0","1","0","0","1","0","0","0","0","0","0","0","0","1","1","0","0","1","0","0","1"
"Sidcup","GB","51.42619","0.1036","7","0","0","0","0","0","1","8","1","1","6","0","8","1","1","6","0","8","0","4","4","0","0","8"
"Sidmouth","GB","50.69094","-3.2397","11","0","0","0","0","0","0","11","1","1","2","0","4","7","0","4","0","11","1","5","5","0","0","11"
"Silchester","GB","51.35356","-1.10061","2","0","0","0","0","0","0","2","0","0","0","0","0","1","0","1","0","2","0","1","1","0","0","2"
"Sileby","GB","52.73286","-1.10773","1","0","0","0","0","0","0","1","0","0","1","0","1","1","0","0","0","1","0","1","0","0","0","1"
"Silloth","GB","54.8687","-3.38448","1","0","0","0","0","0","0","1","0","0","1","0","1","1","0","0","0","1","0","0","1","0","0","1"
"Silsden","GB","53.91443","-1.93802","3","0","0","0","0","0","0","3","0","1","1","0","2","0","0","3","0","3","0","1","2","0","0","3"
"Silsoe","GB","52.00854","-0.42484","2","0","0","0","0","0","0","2","0","2","0","0","2","2","0","0","0","2","2","0","0","0","0","2"
"Sittingbourne","GB","51.34128","0.73282","9","0","0","1","0","0","3","13","2","5","3","0","10","5","1","7","0","13","4","1","9","0","0","14"
"Skelmersdale","GB","53.55024","-2.77348","14","1","0","0","2","0","0","17","2","6","8","0","16","5","2","9","0","16","4","8","4","0","0","16"
"Skidby","GB","53.78921","-0.46131","3","0","0","0","0","0","0","3","0","0","3","0","3","2","0","1","0","3","0","0","3","0","0","3"
"Skipton","GB","53.96144","-2.01676","6","0","0","1","0","0","1","8","1","2","3","0","6","4","1","3","0","8","2","1","5","0","0","8"
"Skipton","GB","-37.686","143.36475","6","0","0","1","0","0","1","8","1","2","3","0","6","4","1","3","0","8","2","1","5","0","0","8"
"Sleaford","GB","52.99826","-0.40941","4","0","0","0","0","0","0","4","0","1","3","0","4","2","0","2","0","4","0","1","2","0","1","4"
"Slough","GB","51.50949","-0.59541","23","0","0","1","3","0","2","29","8","4","8","0","20","9","2","18","0","29","6","4","16","1","1","28"
"Smethwick","GB","52.49268","-1.96745","3","1","0","0","2","0","0","6","2","1","1","0","4","1","1","4","0","6","1","1","4","0","0","6"
"Sole Street","GB","51.38555","0.37843","1","0","0","0","0","0","0","1","0","0","0","0","0","1","0","0","0","1","0","0","1","0","0","1"
"Solihull","GB","52.41426","-1.78094","40","2","0","0","2","0","1","45","10","11","17","1","39","15","3","27","0","45","5","10","30","0","0","45"
"Southall","GB","51.50896","-0.3713","1","0","0","0","0","0","0","1","1","0","0","0","1","0","1","0","0","1","0","0","1","0","0","1"
"Southam","GB","52.25266","-1.3884","3","0","0","0","0","0","0","3","0","0","1","0","1","0","1","2","0","3","0","0","3","0","0","3"
"Southampton","GB","42.22926","-72.73009","75","3","0","4","8","0","11","101","22","22","46","0","90","28","11","62","0","101","21","29","46","0","5","101"
"Southampton","GB","40.88427","-72.38953","75","3","0","4","8","0","11","101","22","22","46","0","90","28","11","62","0","101","21","29","46","0","5","101"
"Southampton","GB","50.90395","-1.40428","75","3","0","4","8","0","11","101","22","22","46","0","90","28","11","62","0","101","21","29","46","0","5","101"
"South Benfleet","GB","51.55295","0.55962","4","1","0","0","0","0","0","5","1","2","2","0","5","3","0","2","0","5","1","1","3","0","0","5"
"South Croydon","GB","51.36217","-0.09421","11","2","0","1","2","0","2","18","5","3","9","1","18","5","1","11","1","18","0","9","9","0","0","18"
"South Elmsall","GB","53.59709","-1.28034","1","0","0","0","0","0","0","1","0","1","0","0","1","0","0","1","0","1","1","0","0","0","0","1"
"Southend-on-Sea","GB","51.53782","0.71433","36","3","1","4","4","0","3","51","12","13","17","0","42","17","5","28","0","50","9","14","27","0","0","50"
"Southminster","GB","51.66228","0.82968","0","0","0","0","1","0","0","1","0","0","1","0","1","0","1","0","0","1","0","1","0","0","0","1"
"South Molton","GB","51.01667","-3.83333","1","0","0","0","0","0","0","1","0","0","0","0","0","0","0","1","0","1","1","0","0","0","0","1"
"South Ockendon","GB","51.50799","0.28333","3","0","0","0","0","0","0","3","2","0","0","0","2","1","1","1","0","3","0","1","2","0","0","3"
"Southport","GB","39.66505","-86.12776","13","2","0","0","1","0","0","16","5","1","8","1","15","7","0","10","0","17","2","3","12","0","0","17"
"Southport","GB","33.92156","-78.02027","13","2","0","0","1","0","0","16","5","1","8","1","15","7","0","10","0","17","2","3","12","0","0","17"
"Southport","GB","42.0548","-76.81912","13","2","0","0","1","0","0","16","5","1","8","1","15","7","0","10","0","17","2","3","12","0","0","17"
"Southport","GB","41.13649","-73.28345","13","2","0","0","1","0","0","16","5","1","8","1","15","7","0","10","0","17","2","3","12","0","0","17"
"Southport","GB","43.84092","-69.65866","13","2","0","0","1","0","0","16","5","1","8","1","15","7","0","10","0","17","2","3","12","0","0","17"
"Southport","GB","53.64581","-3.01008","13","2","0","0","1","0","0","16","5","1","8","1","15","7","0","10","0","17","2","3","12","0","0","17"
"Southport","GB","-27.96724","153.39796","13","2","0","0","1","0","0","16","5","1","8","1","15","7","0","10","0","17","2","3","12","0","0","17"
"Southsea","GB","50.79205","-1.08593","2","0","0","0","0","0","0","2","0","2","0","0","2","0","0","2","0","2","1","0","0","0","1","2"
"South Shields","GB","54.99859","-1.4323","26","0","0","0","3","0","0","29","6","8","7","0","21","13","2","15","0","30","6","6","18","0","0","30"
"Southwell","GB","53.07804","-0.95538","2","0","0","0","0","0","0","2","0","1","1","0","2","0","1","1","0","2","1","0","1","0","0","2"
"Southwick","GB","42.05482","-72.77037","3","0","0","0","0","0","0","3","1","2","0","0","3","2","1","0","0","3","1","0","2","0","0","3"
"Southwick","GB","51.29694","-2.2325","3","0","0","0","0","0","0","3","1","2","0","0","3","2","1","0","0","3","1","0","2","0","0","3"
"Spalding","GB","52.78709","-0.15141","5","0","0","0","0","0","0","5","0","2","2","1","5","4","0","1","0","5","2","2","0","0","1","5"
"Spalding","GB","-28.73525","114.63651","5","0","0","0","0","0","0","5","0","2","2","1","5","4","0","1","0","5","2","2","0","0","1","5"
"Spennymoor","GB","54.6988","-1.60229","1","0","0","0","0","0","0","1","0","0","1","0","1","0","0","1","0","1","0","0","1","0","0","1"
"Spilsby","GB","53.17363","0.09373","1","0","0","0","0","0","0","1","0","1","0","0","1","0","0","1","0","1","0","1","0","0","0","1"
"Stadhampton","GB","51.68131","-1.13138","1","0","0","0","0","0","0","1","1","0","0","0","1","0","0","1","0","1","1","0","0","0","0","1"
"Stafford","GB","45.35734","-122.72259","16","0","0","0","1","0","4","21","5","3","8","0","16","8","1","12","0","21","1","9","9","0","2","21"
"Stafford","GB","37.96224","-98.60064","16","0","0","0","1","0","4","21","5","3","8","0","16","8","1","12","0","21","1","9","9","0","2","21"
"Stafford","GB","29.61607","-95.55772","16","0","0","0","1","0","4","21","5","3","8","0","16","8","1","12","0","21","1","9","9","0","2","21"
"Stafford","GB","38.42207","-77.40832","16","0","0","0","1","0","4","21","5","3","8","0","16","8","1","12","0","21","1","9","9","0","2","21"
"Stafford","GB","41.98482","-72.28897","16","0","0","0","1","0","4","21","5","3","8","0","16","8","1","12","0","21","1","9","9","0","2","21"
"Stafford","GB","52.80521","-2.11636","16","0","0","0","1","0","4","21","5","3","8","0","16","8","1","12","0","21","1","9","9","0","2","21"
"Stafford","GB","-27.41044","153.01105","16","0","0","0","1","0","4","21","5","3","8","0","16","8","1","12","0","21","1","9","9","0","2","21"
"Staindrop","GB","54.58102","-1.80708","0","0","0","0","1","0","0","1","0","0","1","0","1","0","0","1","0","1","0","1","0","0","0","1"
"Staines","GB","51.43092","-0.50606","9","0","0","0","0","0","2","11","3","4","2","1","10","5","0","6","0","11","6","2","3","0","0","11"
"Stakeford","GB","55.1611","-1.57529","1","0","0","0","0","0","0","1","0","0","0","0","0","0","0","1","0","1","1","0","0","0","0","1"
"St Albans","GB","51.75","-0.33333","31","1","0","3","2","0","1","38","6","5","15","1","27","20","3","15","0","38","2","12","24","0","0","38"
"St Albans","GB","-37.74496","144.80049","31","1","0","3","2","0","1","38","6","5","15","1","27","20","3","15","0","38","2","12","24","0","0","38"
"Stalybridge","GB","53.48414","-2.05908","2","0","0","0","1","0","0","3","1","0","1","0","2","0","1","2","0","3","1","0","2","0","0","3"
"Stamford","GB","32.94539","-99.80287","5","0","0","0","0","0","0","5","1","1","2","0","4","3","0","2","0","5","0","0","5","0","0","5"
"Stamford","GB","42.4073","-74.61432","5","0","0","0","0","0","0","5","1","1","2","0","4","3","0","2","0","5","0","0","5","0","0","5"
"Stamford","GB","41.05343","-73.53873","5","0","0","0","0","0","0","5","1","1","2","0","4","3","0","2","0","5","0","0","5","0","0","5"
"Stamford","GB","52.65","-0.48333","5","0","0","0","0","0","0","5","1","1","2","0","4","3","0","2","0","5","0","0","5","0","0","5"
"Stanford-le-Hope","GB","51.52274","0.43422","5","0","0","1","0","0","0","6","1","2","3","0","6","3","0","3","0","6","2","1","3","0","0","6"
"Stanley","GB","48.31724","-102.39045","2","0","0","0","0","0","0","2","0","1","1","0","2","1","0","1","0","2","1","1","0","0","0","2"
"Stanley","GB","44.95997","-90.93708","2","0","0","0","0","0","0","2","0","1","1","0","2","1","0","1","0","2","1","1","0","0","0","2"
"Stanley","GB","35.35903","-81.09702","2","0","0","0","0","0","0","2","0","1","1","0","2","1","0","1","0","2","1","1","0","0","0","2"
"Stanley","GB","38.5754","-78.50251","2","0","0","0","0","0","0","2","0","1","1","0","2","1","0","1","0","2","1","1","0","0","0","2"
"Stanley","GB","-51.69382","-57.85701","2","0","0","0","0","0","0","2","0","1","1","0","2","1","0","1","0","2","1","1","0","0","0","2"
"Stanley","GB","56.4854","-3.45184","2","0","0","0","0","0","0","2","0","1","1","0","2","1","0","1","0","2","1","1","0","0","0","2"
"Stanley","GB","54.86796","-1.69846","2","0","0","0","0","0","0","2","0","1","1","0","2","1","0","1","0","2","1","1","0","0","0","2"
"Stanley","GB","-40.76064","145.29555","2","0","0","0","0","0","0","2","0","1","1","0","2","1","0","1","0","2","1","1","0","0","0","2"
"Stanmore","GB","51.61667","-0.31667","1","1","0","0","0","0","0","2","0","0","0","0","0","1","0","1","0","2","0","0","2","0","0","2"
"Stanmore","GB","-33.89407","151.16424","1","1","0","0","0","0","0","2","0","0","0","0","0","1","0","1","0","2","0","0","2","0","0","2"
"Stansted Mountfitchet","GB","51.9","0.2","2","0","0","0","1","0","0","3","0","1","1","0","2","1","0","2","0","3","0","1","2","0","0","3"
"Staplecross","GB","50.97356","0.53576","0","0","0","0","0","0","1","1","0","0","1","0","1","1","0","0","0","1","0","0","1","0","0","1"
"Staplehurst","GB","51.1611","0.55249","0","0","0","0","1","0","0","1","0","0","1","0","1","0","0","1","0","1","0","1","0","0","0","1"
"St Austell","GB","50.3425","-4.77442","7","0","0","0","0","0","0","7","0","3","2","1","6","1","2","4","0","7","4","1","1","0","1","7"
"Stenhousemuir","GB","56.02676","-3.81462","1","0","0","0","0","0","0","1","0","1","0","0","1","1","0","0","0","1","1","0","0","0","0","1"
"Stevenage","GB","51.90224","-0.20256","12","0","0","3","1","0","1","17","3","8","5","0","16","6","4","7","0","17","3","2","12","0","0","17"
"Stevenston","GB","55.6397","-4.75339","3","0","0","0","1","0","1","5","1","0","2","0","3","1","1","2","0","4","1","3","1","0","0","5"
"Stewarton","GB","55.67986","-4.51435","2","0","0","0","0","0","0","2","0","0","2","0","2","0","0","2","0","2","0","1","1","0","0","2"
"Stewkley","GB","51.92744","-0.76381","0","0","0","0","1","0","0","1","1","0","0","0","1","1","0","0","0","1","0","0","1","0","0","1"
"Steyning","GB","50.88744","-0.32787","1","0","0","0","0","0","0","1","0","0","1","0","1","0","0","1","0","1","0","1","0","0","0","1"
"St Helens","GB","53.45","-2.73333","13","1","0","3","1","0","2","20","8","6","4","0","18","5","4","11","0","20","5","3","11","0","1","20"
"St Helens","GB","-41.32028","148.23889","13","1","0","3","1","0","2","20","8","6","4","0","18","5","4","11","0","20","5","3","11","0","1","20"
"St. Helens","GB","50.69688","-1.11159","2","0","0","0","0","0","0","2","0","1","1","0","2","1","0","1","0","2","1","0","1","0","0","2"
"Stirling","GB","44.30012","-77.54948","10","0","0","0","1","0","0","11","2","5","4","0","11","2","4","4","0","10","4","4","2","0","1","11"
"Stirling","GB","56.11903","-3.93682","10","0","0","0","1","0","0","11","2","5","4","0","11","2","4","4","0","10","4","4","2","0","1","11"
"Stirling","GB","-31.88343","115.8099","10","0","0","0","1","0","0","11","2","5","4","0","11","2","4","4","0","10","4","4","2","0","1","11"
"Stirling","GB","-35.0022","138.71956","10","0","0","0","1","0","0","11","2","5","4","0","11","2","4","4","0","10","4","4","2","0","1","11"
"Stirling","GB","-35.34969","149.0493","10","0","0","0","1","0","0","11","2","5","4","0","11","2","4","4","0","10","4","4","2","0","1","11"
"St Ives","GB","50.20861","-5.4875","7","0","0","0","1","0","0","8","3","1","4","0","8","3","0","5","0","8","0","2","5","0","1","8"
"St Leonards","GB","50.83077","-1.84377","5","0","0","0","0","0","1","6","1","4","1","0","6","4","0","2","0","6","1","1","2","0","2","6"
"St Leonards","GB","-33.82344","151.19836","5","0","0","0","0","0","1","6","1","4","1","0","6","4","0","2","0","6","1","1","2","0","2","6"
"Stockbridge","GB","44.07166","-88.29899","1","0","0","0","0","0","0","1","0","1","0","0","1","0","0","1","0","1","0","0","1","0","0","1"
"Stockbridge","GB","33.54428","-84.23381","1","0","0","0","0","0","0","1","0","1","0","0","1","0","0","1","0","1","0","0","1","0","0","1"
"Stockbridge","GB","42.45115","-84.18051","1","0","0","0","0","0","0","1","0","1","0","0","1","0","0","1","0","1","0","0","1","0","0","1"
"Stockbridge","GB","42.28759","-73.32039","1","0","0","0","0","0","0","1","0","1","0","0","1","0","0","1","0","1","0","0","1","0","0","1"
"Stockbridge","GB","51.11398","-1.48839","1","0","0","0","0","0","0","1","0","1","0","0","1","0","0","1","0","1","0","0","1","0","0","1"
"Stockport","GB","53.40979","-2.15761","63","1","0","4","5","0","5","78","19","20","26","3","68","30","15","33","0","78","13","24","39","0","2","78"
"Stockton","GB","37.9577","-121.29078","5","1","0","0","0","0","0","6","2","3","1","0","6","4","1","1","0","6","2","1","3","0","0","6"
"Stockton","GB","40.45272","-112.36078","5","1","0","0","0","0","0","6","2","3","1","0","6","4","1","1","0","6","2","1","3","0","0","6"
"Stockton","GB","39.43807","-99.2651","5","1","0","0","0","0","0","6","2","3","1","0","6","4","1","1","0","6","2","1","3","0","0","6"
"Stockton","GB","37.69893","-93.79604","5","1","0","0","0","0","0","6","2","3","1","0","6","4","1","1","0","6","2","1","3","0","0","6"
"Stockton","GB","44.02746","-91.76987","5","1","0","0","0","0","0","6","2","3","1","0","6","4","1","1","0","6","2","1","3","0","0","6"
"Stockton","GB","42.34974","-90.00679","5","1","0","0","0","0","0","6","2","3","1","0","6","4","1","1","0","6","2","1","3","0","0","6"
"Stockton","GB","40.40788","-74.97822","5","1","0","0","0","0","0","6","2","3","1","0","6","4","1","1","0","6","2","1","3","0","0","6"
"Stockton","GB","51.14528","-2.03194","5","1","0","0","0","0","0","6","2","3","1","0","6","4","1","1","0","6","2","1","3","0","0","6"
"Stockton","GB","52.27181","-1.36055","5","1","0","0","0","0","0","6","2","3","1","0","6","4","1","1","0","6","2","1","3","0","0","6"
"Stockton","GB","-32.90908","151.7836","5","1","0","0","0","0","0","6","2","3","1","0","6","4","1","1","0","6","2","1","3","0","0","6"
"Stockton-on-Tees","GB","54.56848","-1.3187","9","1","0","0","3","0","0","13","4","0","7","0","11","4","3","6","0","13","2","2","9","0","0","13"
"Stoke","GB","53.25","-2.86667","9","0","0","1","1","0","0","11","0","4","5","0","9","5","2","4","0","11","4","2","3","0","2","11"
"Stokenchurch","GB","51.65831","-0.8974","1","0","0","0","0","0","0","1","0","0","1","0","1","0","0","1","0","1","0","1","0","0","0","1"
"Stoke-on-Trent","GB","53.00415","-2.18538","31","2","0","1","5","0","1","40","9","18","10","0","37","11","10","19","0","40","10","14","14","0","2","40"
"Stoke Poges","GB","51.54441","-0.5888","1","0","0","0","0","0","0","1","0","1","0","0","1","1","0","0","0","1","0","1","0","0","0","1"
"Stokesley","GB","54.46998","-1.1933","1","0","0","0","0","0","0","1","1","0","0","0","1","1","0","0","0","1","0","0","1","0","0","1"
"Stone","GB","52.36667","-2.2","3","0","0","0","0","0","1","4","0","2","0","0","2","0","1","3","0","4","2","2","0","0","0","4"
"Stone","GB","52.9059","-2.15409","3","0","0","0","0","0","1","4","0","2","0","0","2","0","1","3","0","4","2","2","0","0","0","4"
"Stone","GB","51.80246","-0.87032","3","0","0","0","0","0","1","4","0","2","0","0","2","0","1","3","0","4","2","2","0","0","0","4"
"Stone","GB","51.45032","0.2647","3","0","0","0","0","0","1","4","0","2","0","0","2","0","1","3","0","4","2","2","0","0","0","4"
"Stone","GB","51","0.76667","3","0","0","0","0","0","1","4","0","2","0","0","2","0","1","3","0","4","2","2","0","0","0","4"
"Stonehaven","GB","56.96365","-2.21177","5","0","0","0","0","0","0","5","0","2","4","0","6","0","2","4","0","6","0","1","5","0","0","6"
"Stonehouse","GB","55.69435","-3.9878","4","0","0","0","0","0","1","5","0","2","3","0","5","2","0","3","0","5","2","0","2","1","0","5"
"Stonehouse","GB","51.75","-2.28333","4","0","0","0","0","0","1","5","0","2","3","0","5","2","0","3","0","5","2","0","2","1","0","5"
"Stony Stratford","GB","52.05682","-0.85281","2","0","0","0","0","0","0","2","0","0","0","0","0","2","0","0","0","2","0","2","0","0","0","2"
"Stornoway","GB","58.20925","-6.38649","3","0","0","0","0","0","0","3","0","2","1","0","3","0","1","2","0","3","2","1","0","0","0","3"
"Storrington","GB","50.91765","-0.45473","3","0","0","0","0","0","0","3","0","0","2","0","2","2","0","1","0","3","0","1","2","0","0","3"
"Stotfold","GB","52.01632","-0.23209","3","0","0","0","0","0","0","3","1","1","0","0","2","1","1","1","0","3","2","0","1","0","0","3"
"Stourbridge","GB","52.45608","-2.14317","17","0","0","0","0","0","2","19","2","9","7","0","18","4","4","11","0","19","7","3","9","0","0","19"
"Stourport-on-Severn","GB","52.33976","-2.28034","5","1","0","0","1","0","0","7","1","3","2","0","6","3","0","4","0","7","4","1","2","0","0","7"
"Stowmarket","GB","52.18893","0.99774","4","0","0","0","0","0","1","5","1","3","1","0","5","4","0","1","0","5","1","1","3","0","0","5"
"Strabane","GB","54.82373","-7.46916","2","0","0","0","0","0","0","2","0","1","1","0","2","0","1","1","0","2","1","0","1","0","0","2"
"Stranraer","GB","54.90234","-5.02731","0","0","0","0","1","0","0","1","0","0","1","0","1","1","0","0","0","1","0","0","1","0","0","1"
"Stratford-upon-Avon","GB","52.19166","-1.70734","8","0","0","1","1","0","0","10","1","2","5","0","8","1","0","9","0","10","0","2","7","0","1","10"
"Street","GB","51.12472","-2.74","4","0","0","0","0","0","0","4","0","1","3","0","4","1","0","3","0","4","0","0","4","0","0","4"
"Stroud","GB","35.74868","-96.65807","15","1","0","0","2","0","0","18","5","6","3","0","14","4","4","10","0","18","2","4","12","0","0","18"
"Stroud","GB","51.75","-2.2","15","1","0","0","2","0","0","18","5","6","3","0","14","4","4","10","0","18","2","4","12","0","0","18"
"Stroud","GB","-32.40366","151.96699","15","1","0","0","2","0","0","18","5","6","3","0","14","4","4","10","0","18","2","4","12","0","0","18"
"Stuartfield","GB","57.50303","-2.04637","1","0","0","0","0","0","0","1","0","0","0","0","0","0","1","0","0","1","0","1","0","0","0","1"
"Sturminster Newton","GB","50.92681","-2.30515","2","0","0","0","0","0","0","2","0","0","2","0","2","0","1","1","0","2","0","2","0","0","0","2"
"Sudbury","GB","42.38343","-71.41617","7","0","0","0","0","0","1","8","3","2","2","0","7","3","0","5","0","8","1","3","4","0","0","8"
"Sudbury","GB","52.0389","0.73117","7","0","0","0","0","0","1","8","3","2","2","0","7","3","0","5","0","8","1","3","4","0","0","8"
"Sunbury-on-Thames","GB","51.40424","-0.41817","3","0","0","0","1","0","2","6","1","3","2","0","6","2","0","4","0","6","1","1","4","0","0","6"
"Sunderland","GB","42.24454","-71.77174","52","0","0","2","7","0","2","63","14","15","21","1","51","25","5","29","4","63","16","16","27","1","3","63"
"Sunderland","GB","54.90465","-1.38222","52","0","0","2","7","0","2","63","14","15","21","1","51","25","5","29","4","63","16","16","27","1","3","63"
"Sunningdale","GB","51.39878","-0.62944","2","0","0","0","1","0","0","3","0","1","2","0","3","0","1","2","0","3","1","0","2","0","0","3"
"Surbiton","GB","51.39148","-0.29825","12","0","0","1","5","0","1","19","3","5","4","0","12","3","3","13","0","19","1","4","14","0","0","19"
"Sutton","GB","40.60557","-97.85921","22","0","0","3","4","0","3","32","12","7","9","0","28","7","5","20","0","32","7","8","16","1","0","32"
"Sutton","GB","38.66454","-80.70982","22","0","0","3","4","0","3","32","12","7","9","0","28","7","5","20","0","32","7","8","16","1","0","32"
"Sutton","GB","45.10008","-72.61582","22","0","0","3","4","0","3","32","12","7","9","0","28","7","5","20","0","32","7","8","16","1","0","32"
"Sutton","GB","43.33424","-71.95147","22","0","0","3","4","0","3","32","12","7","9","0","28","7","5","20","0","32","7","8","16","1","0","32"
"Sutton","GB","42.1501","-71.76285","22","0","0","3","4","0","3","32","12","7","9","0","28","7","5","20","0","32","7","8","16","1","0","32"
"Sutton","GB","53.38947","-6.11059","22","0","0","3","4","0","3","32","12","7","9","0","28","7","5","20","0","32","7","8","16","1","0","32"
"Sutton","GB","52.1","-2.68333","22","0","0","3","4","0","3","32","12","7","9","0","28","7","5","20","0","32","7","8","16","1","0","32"
"Sutton","GB","52.11078","-0.2138","22","0","0","3","4","0","3","32","12","7","9","0","28","7","5","20","0","32","7","8","16","1","0","32"
"Sutton","GB","51.35","-0.2","22","0","0","3","4","0","3","32","12","7","9","0","28","7","5","20","0","32","7","8","16","1","0","32"
"Sutton","GB","52.38804","0.11866","22","0","0","3","4","0","3","32","12","7","9","0","28","7","5","20","0","32","7","8","16","1","0","32"
"Sutton","GB","-35.16667","149.25","22","0","0","3","4","0","3","32","12","7","9","0","28","7","5","20","0","32","7","8","16","1","0","32"
"Sutton Coldfield","GB","52.56667","-1.81667","26","0","0","0","2","0","2","30","4","3","8","1","16","14","3","13","0","30","6","8","14","0","2","30"
"Sutton in Ashfield","GB","53.12542","-1.26135","1","0","0","0","0","0","1","2","1","0","1","0","2","2","0","0","0","2","1","0","1","0","0","2"
"Swadlincote","GB","52.774","-1.55744","7","1","0","0","0","0","0","8","0","3","3","0","6","3","1","4","0","8","0","2","6","0","0","8"
"Swanage","GB","50.60827","-1.95664","2","0","0","0","0","0","0","2","0","0","1","0","1","0","1","1","0","2","1","0","1","0","0","2"
"Swanley","GB","51.39717","0.17321","1","0","0","0","1","0","1","3","1","1","1","0","3","0","1","2","0","3","1","1","1","0","0","3"
"Swanmore","GB","50.94404","-1.18021","1","0","0","0","0","0","0","1","0","0","1","0","1","1","0","0","0","1","0","0","1","0","0","1"
"Swanscombe","GB","51.44713","0.31028","0","0","0","0","0","0","1","1","0","0","1","0","1","1","0","0","0","1","0","1","0","0","0","1"
"Swansea","GB","38.53394","-89.98899","93","5","0","5","12","0","5","120","26","45","41","3","115","47","12","59","2","120","39","31","46","1","2","119"
"Swansea","GB","33.73821","-81.09787","93","5","0","5","12","0","5","120","26","45","41","3","115","47","12","59","2","120","39","31","46","1","2","119"
"Swansea","GB","41.74816","-71.18977","93","5","0","5","12","0","5","120","26","45","41","3","115","47","12","59","2","120","39","31","46","1","2","119"
"Swansea","GB","51.62079","-3.94323","93","5","0","5","12","0","5","120","26","45","41","3","115","47","12","59","2","120","39","31","46","1","2","119"
"Swansea","GB","-42.12284","148.07434","93","5","0","5","12","0","5","120","26","45","41","3","115","47","12","59","2","120","39","31","46","1","2","119"
"Swansea","GB","-33.08765","151.63745","93","5","0","5","12","0","5","120","26","45","41","3","115","47","12","59","2","120","39","31","46","1","2","119"
"Swindon","GB","51.92363","-2.09839","24","0","0","1","5","0","1","31","4","13","11","0","28","11","8","12","0","31","6","4","20","1","0","31"
"Swindon","GB","51.55797","-1.78116","24","0","0","1","5","0","1","31","4","13","11","0","28","11","8","12","0","31","6","4","20","1","0","31"
"Tadley","GB","51.35045","-1.1285","7","0","0","0","0","0","0","7","1","1","5","0","7","1","2","4","0","7","0","3","4","0","0","7"
"Tadworth","GB","51.29169","-0.23582","6","0","0","0","0","0","0","6","0","2","1","0","3","2","1","3","0","6","3","1","2","0","0","6"
"Tain","GB","57.81204","-4.05518","0","0","0","0","1","0","0","1","1","0","0","0","1","1","0","0","0","1","0","1","0","0","0","1"
"Tamworth","GB","43.8598","-71.26313","13","0","0","0","1","0","2","16","2","3","7","2","14","6","4","6","0","16","3","6","7","0","0","16"
"Tamworth","GB","52.63399","-1.69587","13","0","0","0","1","0","2","16","2","3","7","2","14","6","4","6","0","16","3","6","7","0","0","16"
"Tamworth","GB","-31.09048","150.92905","13","0","0","0","1","0","2","16","2","3","7","2","14","6","4","6","0","16","3","6","7","0","0","16"
"Tandragee","GB","54.35486","-6.41396","1","0","0","0","0","0","0","1","0","1","0","0","1","1","0","0","0","1","1","0","0","0","0","1"
"Tarbert","GB","52.57278","-9.37528","1","0","0","0","0","0","0","1","0","0","1","0","1","0","0","1","0","1","0","0","1","0","0","1"
"Tarbert","GB","55.86277","-5.41622","1","0","0","0","0","0","0","1","0","0","1","0","1","0","0","1","0","1","0","0","1","0","0","1"
"Tarporley","GB","53.15918","-2.66867","2","0","0","0","0","0","0","2","1","0","1","0","2","1","0","1","0","2","0","1","1","0","0","2"
"Taunton","GB","41.9001","-71.08977","27","0","0","0","3","0","0","30","7","8","8","1","24","13","9","8","0","30","6","7","16","1","0","30"
"Taunton","GB","51.01494","-3.10293","27","0","0","0","3","0","0","30","7","8","8","1","24","13","9","8","0","30","6","7","16","1","0","30"
"Tavistock","GB","43.31679","-80.83302","0","0","0","0","1","0","0","1","1","0","0","0","1","1","0","0","0","1","0","0","1","0","0","1"
"Tavistock","GB","50.54944","-4.14418","0","0","0","0","1","0","0","1","1","0","0","0","1","1","0","0","0","1","0","0","1","0","0","1"
"Teddington","GB","51.42233","-0.33053","22","0","0","3","2","0","1","28","5","2","7","0","14","11","0","17","0","28","0","10","17","0","1","28"
"Tehran","GB","35.69439","51.42151","1","0","0","0","0","0","0","1","1","0","0","0","1","0","0","1","0","1","0","0","0","1","0","1"
"Teignmouth","GB","50.54581","-3.49671","3","0","0","0","0","0","0","3","0","1","0","1","2","2","0","1","0","3","0","1","2","0","0","3"
"Telford","GB","36.24899","-82.54515","76","4","0","3","8","0","6","97","19","42","32","0","93","32","10","54","1","97","26","22","46","0","3","97"
"Telford","GB","40.32205","-75.32795","76","4","0","3","8","0","6","97","19","42","32","0","93","32","10","54","1","97","26","22","46","0","3","97"
"Telford","GB","52.67659","-2.44926","76","4","0","3","8","0","6","97","19","42","32","0","93","32","10","54","1","97","26","22","46","0","3","97"
"Tenbury Wells","GB","52.31077","-2.59621","1","0","0","0","2","0","0","3","0","1","2","0","3","0","0","3","0","3","0","2","1","0","0","3"
"Tenby","GB","51.67279","-4.70447","19","0","0","1","2","0","0","22","7","1","3","0","11","12","1","9","0","22","1","7","12","0","2","22"
"Tenterden","GB","51.06845","0.68776","2","0","0","0","0","0","0","2","1","0","1","0","2","1","0","1","0","2","0","2","0","0","0","2"
"Tetbury","GB","51.63944","-2.16222","0","0","0","1","1","0","0","2","1","0","0","0","1","1","1","0","0","2","0","0","2","0","0","2"
"Tewkesbury","GB","51.99244","-2.1601","4","0","0","0","0","0","1","5","0","3","2","0","5","3","0","2","0","5","1","0","3","0","1","5"
"Thame","GB","51.7484","-0.97624","9","0","0","0","3","0","0","12","3","1","5","0","9","4","3","5","0","12","3","6","3","0","0","12"
"Thames Ditton","GB","51.38964","-0.33928","6","0","0","2","0","0","0","8","3","2","2","0","7","1","0","7","0","8","0","3","3","2","0","8"
"Thatcham","GB","51.40366","-1.26049","6","0","0","0","0","0","0","6","0","3","2","0","5","3","1","2","0","6","0","1","5","0","0","6"
"Thaxted","GB","51.95326","0.34478","0","0","0","0","0","0","5","5","5","0","0","0","5","0","0","5","0","5","0","5","0","0","0","5"
"Thetford","GB","52.41667","0.75","4","1","0","0","1","0","0","6","1","2","2","0","5","2","2","2","0","6","2","2","1","0","1","6"
"Thirsk","GB","54.23298","-1.34411","3","1","0","1","0","0","2","7","2","1","3","1","7","3","0","4","0","7","1","1","5","0","0","7"
"Thornaby-on-Tees","GB","54.53333","-1.3","1","0","0","0","0","0","0","1","0","0","1","0","1","0","0","1","0","1","0","0","1","0","0","1"
"Thornbury","GB","52.23333","-2.55","2","0","0","0","1","0","0","3","0","0","3","0","3","1","1","1","0","3","0","1","1","0","1","3"
"Thornbury","GB","51.60889","-2.52028","2","0","0","0","1","0","0","3","0","0","3","0","3","1","1","1","0","3","0","1","1","0","1","3"
"Thornbury","GB","-37.75819","145.00583","2","0","0","0","1","0","0","3","0","0","3","0","3","1","1","1","0","3","0","1","1","0","1","3"
"Thornton-Cleveleys","GB","53.87389","-3.02244","1","1","0","0","0","0","0","2","1","1","0","0","2","1","0","1","0","2","1","0","1","0","0","2"
"Thornton Heath","GB","51.39884","-0.09872","1","0","0","0","0","0","0","1","0","1","0","0","1","0","0","1","0","1","1","0","0","0","0","1"
"Thrapston","GB","52.39675","-0.5392","1","0","0","0","0","0","0","1","0","0","1","0","1","1","0","0","0","1","0","1","0","0","0","1"
"Thurlestone","GB","50.26932","-3.86264","1","0","0","0","0","0","0","1","0","0","1","0","1","0","0","1","0","1","0","0","1","0","0","1"
"Thurso","GB","45.6001","-75.24931","1","0","0","0","0","0","0","1","0","0","1","0","1","1","0","0","0","1","0","0","1","0","0","1"
"Thurso","GB","58.59271","-3.52594","1","0","0","0","0","0","0","1","0","0","1","0","1","1","0","0","0","1","0","0","1","0","0","1"
"Tickhill","GB","53.43194","-1.10859","0","1","0","0","0","0","0","1","1","0","0","0","1","0","0","1","0","1","0","0","1","0","0","1"
"Tideswell","GB","53.27807","-1.77292","1","0","0","0","0","0","0","1","0","1","0","0","1","0","0","1","0","1","0","0","1","0","0","1"
"Tidworth","GB","51.23142","-1.66324","3","1","0","0","0","0","0","4","0","2","0","0","2","1","1","2","0","4","1","1","2","0","0","4"
"Tilbury","GB","51.46248","0.35856","0","0","0","0","1","0","0","1","0","0","1","0","1","0","0","1","0","1","0","0","1","0","0","1"
"Tillicoultry","GB","56.15251","-3.74015","2","0","0","0","0","0","0","2","0","1","1","0","2","1","0","1","0","2","0","2","0","0","0","2"
"Timperley","GB","53.4","-2.33333","1","0","0","0","0","0","0","1","0","1","0","0","1","0","0","1","0","1","1","0","0","0","0","1"
"Tintagel","GB","50.66317","-4.75047","1","0","0","0","0","0","0","1","0","0","1","0","1","1","0","0","0","1","0","1","0","0","0","1"
"Tipton","GB","36.0594","-119.31206","3","0","0","0","1","0","0","4","0","1","2","0","3","2","0","2","0","4","2","0","2","0","0","4"
"Tipton","GB","34.50285","-99.14091","3","0","0","0","1","0","0","4","0","1","2","0","3","2","0","2","0","4","2","0","2","0","0","4"
"Tipton","GB","38.65558","-92.77992","3","0","0","0","1","0","0","4","0","1","2","0","3","2","0","2","0","4","2","0","2","0","0","4"
"Tipton","GB","41.76974","-91.12793","3","0","0","0","1","0","0","4","0","1","2","0","3","2","0","2","0","4","2","0","2","0","0","4"
"Tipton","GB","40.28226","-86.0411","3","0","0","0","1","0","0","4","0","1","2","0","3","2","0","2","0","4","2","0","2","0","0","4"
"Tipton","GB","40.6359","-78.29585","3","0","0","0","1","0","0","4","0","1","2","0","3","2","0","2","0","4","2","0","2","0","0","4"
"Tipton","GB","52.52956","-2.06773","3","0","0","0","1","0","0","4","0","1","2","0","3","2","0","2","0","4","2","0","2","0","0","4"
"Tiverton","GB","41.62594","-71.21338","1","0","0","1","1","0","0","3","2","1","0","0","3","1","0","2","0","3","0","0","3","0","0","3"
"Tiverton","GB","50.90241","-3.49232","1","0","0","1","1","0","0","3","2","1","0","0","3","1","0","2","0","3","0","0","3","0","0","3"
"Tiverton","GB","53.13333","-2.66667","1","0","0","1","1","0","0","3","2","1","0","0","3","1","0","2","0","3","0","0","3","0","0","3"
"Toddington","GB","51.94922","-0.53277","1","0","0","0","0","0","0","1","0","0","1","0","1","0","0","1","0","1","0","0","1","0","0","1"
"Todmorden","GB","53.71434","-2.09701","4","0","0","0","0","0","0","4","0","0","3","0","3","1","0","3","0","4","0","3","1","0","0","4"
"Tonbridge","GB","51.19532","0.27363","22","1","0","1","2","0","0","26","7","5","12","1","25","7","1","18","0","26","3","9","12","1","1","26"
"Tonypandy","GB","51.62202","-3.45544","4","0","0","0","0","0","2","6","0","3","3","0","6","3","2","1","0","6","5","0","1","0","0","6"
"Tonyrefail","GB","51.58402","-3.43041","5","0","0","0","0","0","0","5","1","1","3","0","5","1","1","3","0","5","1","1","3","0","0","5"
"Torquay","GB","50.46198","-3.52522","12","1","0","0","0","0","0","13","1","7","3","0","11","7","0","6","0","13","4","4","5","0","0","13"
"Torquay","GB","-38.33085","144.32638","12","1","0","0","0","0","0","13","1","7","3","0","11","7","0","6","0","13","4","4","5","0","0","13"
"Torquay","GB","-25.28496","152.87886","12","1","0","0","0","0","0","13","1","7","3","0","11","7","0","6","0","13","4","4","5","0","0","13"
"Totland","GB","50.68466","-1.53688","1","0","0","0","0","0","0","1","1","0","0","0","1","0","0","1","0","1","0","1","0","0","0","1"
"Totnes","GB","50.43107","-3.6843","5","0","0","0","0","0","0","5","1","1","3","0","5","4","0","1","0","5","1","1","3","0","0","5"
"Towcester","GB","52.13359","-0.99057","23","0","0","0","0","0","5","28","5","3","6","0","14","10","4","13","2","29","2","17","10","0","0","29"
"Tredegar","GB","51.77251","-3.24679","1","0","0","0","0","0","0","1","0","1","0","0","1","0","0","1","0","1","0","0","1","0","0","1"
"Treharris","GB","51.66457","-3.30725","2","0","0","0","0","0","0","2","0","2","0","0","2","1","1","0","0","2","2","0","0","0","0","2"
"Treherbert","GB","51.67139","-3.52972","1","0","0","0","0","0","0","1","0","1","0","0","1","1","0","0","0","1","1","0","0","0","0","1"
"Treorchy","GB","51.65958","-3.50587","6","0","0","0","0","0","0","6","0","5","1","0","6","1","2","3","0","6","4","1","1","0","0","6"
"Tring","GB","51.79471","-0.65824","3","0","0","1","1","0","0","5","4","0","1","0","5","2","0","3","0","5","0","2","3","0","0","5"
"Troon","GB","55.54359","-4.66335","3","0","0","0","0","0","1","4","1","0","3","0","4","1","0","3","0","4","0","1","3","0","0","4"
"Trowbridge","GB","51.31889","-2.20861","13","2","0","1","1","0","0","17","6","4","5","0","15","8","2","7","0","17","3","6","6","0","1","16"
"Truro","GB","41.99344","-70.04975","24","0","0","0","3","0","2","29","2","11","9","1","23","13","3","12","1","29","6","6","15","0","2","29"
"Truro","GB","45.36685","-63.26538","24","0","0","0","3","0","2","29","2","11","9","1","23","13","3","12","1","29","6","6","15","0","2","29"
"Truro","GB","50.26526","-5.05436","24","0","0","0","3","0","2","29","2","11","9","1","23","13","3","12","1","29","6","6","15","0","2","29"
"Truro","GB","-34.40869","139.12743","24","0","0","0","3","0","2","29","2","11","9","1","23","13","3","12","1","29","6","6","15","0","2","29"
"Tullibody","GB","56.13364","-3.83835","2","0","0","0","0","0","0","2","0","1","1","0","2","2","0","0","0","2","0","1","1","0","0","2"
"Tuxford","GB","53.23004","-0.89325","1","0","0","0","0","0","0","1","0","0","1","0","1","0","1","0","0","1","0","0","1","0","0","1"
"Twickenham","GB","51.44489","-0.3377","32","3","0","0","2","0","1","38","8","3","14","0","25","13","4","21","0","38","3","10","25","0","0","38"
"Twyford","GB","51.47518","-0.86037","1","0","0","0","0","0","0","1","0","0","0","0","0","1","0","0","0","1","0","0","1","0","0","1"
"Tynemouth","GB","55.01788","-1.42559","5","1","0","0","0","0","0","6","0","1","1","0","2","4","0","2","0","6","1","0","4","0","1","6"
"Uckfield","GB","50.96948","0.09589","5","1","0","0","0","0","0","6","2","1","2","0","5","1","1","4","0","6","1","1","3","0","1","6"
"Ulverston","GB","54.19594","-3.09626","7","0","0","0","1","0","0","8","1","2","3","0","6","3","1","4","0","8","2","2","3","0","1","8"
"Upminster","GB","51.55594","0.2556","9","0","0","0","2","0","2","13","2","4","6","0","12","6","3","4","0","13","0","1","9","1","2","13"
"Upper Hartfield","GB","51.09325","0.09077","1","0","0","0","0","0","0","1","0","0","1","0","1","0","0","1","0","1","0","0","1","0","0","1"
"Upper Heyford","GB","51.93558","-1.25451","1","0","0","0","0","0","0","1","0","1","0","0","1","1","0","0","0","1","0","0","1","0","0","1"
"Uppingham","GB","52.58803","-0.72272","4","1","0","0","1","0","1","7","0","3","4","0","7","3","1","3","0","7","0","3","4","0","0","7"
"Usk","GB","51.70347","-2.90332","1","0","0","0","0","0","0","1","0","1","0","0","1","0","0","1","0","1","1","0","0","0","0","1"
"Uttoxeter","GB","52.89838","-1.86488","2","0","0","0","0","0","1","3","0","1","1","0","2","1","1","1","0","3","1","1","1","0","0","3"
"Uxbridge","GB","44.10012","-79.11628","11","0","0","0","1","0","0","12","1","3","3","0","7","6","1","5","0","12","4","2","6","0","0","12"
"Uxbridge","GB","42.07732","-71.62951","11","0","0","0","1","0","0","12","1","3","3","0","7","6","1","5","0","12","4","2","6","0","0","12"
"Uxbridge","GB","51.5489","-0.48211","11","0","0","0","1","0","0","12","1","3","3","0","7","6","1","5","0","12","4","2","6","0","0","12"
"Ventnor","GB","50.59449","-1.20672","1","0","0","0","0","0","0","1","0","1","0","0","1","1","0","0","0","1","1","0","0","0","0","1"
"Ventnor","GB","-38.46273","145.19497","1","0","0","0","0","0","0","1","0","1","0","0","1","1","0","0","0","1","1","0","0","0","0","1"
"Verwood","GB","50.87575","-1.87023","4","0","0","0","0","0","1","5","0","1","4","0","5","1","0","4","0","5","0","1","4","0","0","5"
"Victoria","GB","48.4359","-123.35155","1","0","0","0","0","0","0","1","0","1","0","0","1","0","0","1","0","1","0","0","1","0","0","1"
"Victoria","GB","21.21183","-100.21545","1","0","0","0","0","0","0","1","0","1","0","0","1","0","0","1","0","1","0","0","1","0","0","1"
"Victoria","GB","38.85279","-99.1476","1","0","0","0","0","0","0","1","0","1","0","0","1","0","0","1","0","1","0","0","1","0","0","1"
"Victoria","GB","18.65469","-97.94141","1","0","0","0","0","0","0","1","0","1","0","0","1","0","0","1","0","1","0","0","1","0","0","1"
"Victoria","GB","28.80527","-97.0036","1","0","0","0","0","0","0","1","0","1","0","0","1","0","0","1","0","1","0","0","1","0","0","1"
"Victoria","GB","44.85857","-93.66163","1","0","0","0","0","0","0","1","0","1","0","0","1","0","0","1","0","1","0","0","1","0","0","1"
"Victoria","GB","13.95","-88.63333","1","0","0","0","0","0","0","1","0","1","0","0","1","0","0","1","0","1","0","0","1","0","0","1"
"Victoria","GB","15.50381","-87.82625","1","0","0","0","0","0","0","1","0","1","0","0","1","0","0","1","0","1","0","0","1","0","0","1"
"Victoria","GB","36.99487","-78.22722","1","0","0","0","0","0","0","1","0","1","0","0","1","0","0","1","0","1","0","0","1","0","0","1"
"Victoria","GB","5.31648","-74.91101","1","0","0","0","0","0","0","1","0","1","0","0","1","0","0","1","0","1","0","0","1","0","0","1"
"Victoria","GB","-38.23291","-72.33292","1","0","0","0","0","0","0","1","0","1","0","0","1","0","0","1","0","1","0","0","1","0","0","1"
"Victoria","GB","12.19021","-61.70677","1","0","0","0","0","0","0","1","0","1","0","0","1","0","0","1","0","1","0","0","1","0","0","1"
"Victoria","GB","-32.61841","-60.15478","1","0","0","0","0","0","0","1","0","1","0","0","1","0","0","1","0","1","0","0","1","0","0","1"
"Victoria","GB","51.75","-3.2","1","0","0","0","0","0","0","1","0","1","0","0","1","0","0","1","0","1","0","0","1","0","0","1"
"Victoria","GB","36.04444","14.23972","1","0","0","0","0","0","0","1","0","1","0","0","1","0","0","1","0","1","0","0","1","0","0","1"
"Victoria","GB","45.72968","24.7028","1","0","0","0","0","0","0","1","0","1","0","0","1","0","0","1","0","1","0","0","1","0","0","1"
"Victoria","GB","47.61018","27.1673","1","0","0","0","0","0","0","1","0","1","0","0","1","0","0","1","0","1","0","0","1","0","0","1"
"Victoria","GB","47.28333","27.58333","1","0","0","0","0","0","0","1","0","1","0","0","1","0","0","1","0","1","0","0","1","0","0","1"
"Victoria","GB","44.81667","27.61667","1","0","0","0","0","0","0","1","0","1","0","0","1","0","0","1","0","1","0","0","1","0","0","1"
"Victoria","GB","-4.62001","55.45501","1","0","0","0","0","0","0","1","0","1","0","0","1","0","0","1","0","1","0","0","1","0","0","1"
"Victoria","GB","15.5775","120.6822","1","0","0","0","0","0","0","1","0","1","0","0","1","0","0","1","0","1","0","0","1","0","0","1"
"Victoria","GB","13.17722","121.27806","1","0","0","0","0","0","0","1","0","1","0","0","1","0","0","1","0","1","0","0","1","0","0","1"
"Victoria","GB","14.2277","121.3292","1","0","0","0","0","0","0","1","0","1","0","0","1","0","0","1","0","1","0","0","1","0","0","1"
"Victoria","GB","12.44722","124.31111","1","0","0","0","0","0","0","1","0","1","0","0","1","0","0","1","0","1","0","0","1","0","0","1"
"Virginia Water","GB","51.40343","-0.56651","1","0","0","0","0","0","1","2","0","0","1","0","1","1","0","1","0","2","0","1","1","0","0","2"
"Wadebridge","GB","50.51734","-4.83633","5","0","0","0","0","0","1","6","3","0","2","0","5","4","0","2","0","6","0","2","4","0","0","6"
"Wadhurst","GB","51.0623","0.33929","1","0","0","0","0","0","0","1","0","1","0","0","1","1","0","0","0","1","0","0","1","0","0","1"
"Wakefield","GB","39.21333","-97.00557","43","2","0","0","3","0","2","50","7","16","19","0","42","18","6","26","0","50","9","10","31","0","1","51"
"Wakefield","GB","42.26917","-96.86504","43","2","0","0","3","0","2","50","7","16","19","0","42","18","6","26","0","50","9","10","31","0","1","51"
"Wakefield","GB","46.47523","-89.93989","43","2","0","0","3","0","2","50","7","16","19","0","42","18","6","26","0","50","9","10","31","0","1","51"
"Wakefield","GB","18.41211","-77.72183","43","2","0","0","3","0","2","50","7","16","19","0","42","18","6","26","0","50","9","10","31","0","1","51"
"Wakefield","GB","36.96821","-76.98968","43","2","0","0","3","0","2","50","7","16","19","0","42","18","6","26","0","50","9","10","31","0","1","51"
"Wakefield","GB","39.77372","-76.17912","43","2","0","0","3","0","2","50","7","16","19","0","42","18","6","26","0","50","9","10","31","0","1","51"
"Wakefield","GB","45.6668","-75.83265","43","2","0","0","3","0","2","50","7","16","19","0","42","18","6","26","0","50","9","10","31","0","1","51"
"Wakefield","GB","40.89788","-73.85236","43","2","0","0","3","0","2","50","7","16","19","0","42","18","6","26","0","50","9","10","31","0","1","51"
"Wakefield","GB","42.50648","-71.07283","43","2","0","0","3","0","2","50","7","16","19","0","42","18","6","26","0","50","9","10","31","0","1","51"
"Wakefield","GB","43.56813","-71.03007","43","2","0","0","3","0","2","50","7","16","19","0","42","18","6","26","0","50","9","10","31","0","1","51"
"Wakefield","GB","53.68331","-1.49768","43","2","0","0","3","0","2","50","7","16","19","0","42","18","6","26","0","50","9","10","31","0","1","51"
"Wakefield","GB","-41.4","173.05","43","2","0","0","3","0","2","50","7","16","19","0","42","18","6","26","0","50","9","10","31","0","1","51"
"Wales","GB","43.00445","-88.37676","14","0","0","0","2","0","0","16","5","5","4","0","14","8","1","7","0","16","4","6","5","1","0","16"
"Wales","GB","42.06954","-72.2223","14","0","0","0","2","0","0","16","5","5","4","0","14","8","1","7","0","16","4","6","5","1","0","16"
"Wales","GB","53.34061","-1.28162","14","0","0","0","2","0","0","16","5","5","4","0","14","8","1","7","0","16","4","6","5","1","0","16"
"Walkden","GB","53.51667","-2.4","1","0","0","0","0","0","0","1","0","0","1","0","1","0","1","0","0","1","0","0","1","0","0","1"
"Wallasey","GB","53.42324","-3.06497","6","0","0","0","0","0","1","7","0","2","3","0","5","2","1","4","0","7","0","2","5","0","0","7"
"Wallingford","GB","43.47192","-72.97823","6","0","0","0","2","0","0","8","2","0","3","0","5","3","0","5","0","8","0","1","7","0","0","8"
"Wallingford","GB","41.45704","-72.82316","6","0","0","0","2","0","0","8","2","0","3","0","5","3","0","5","0","8","0","1","7","0","0","8"
"Wallingford","GB","51.59982","-1.1248","6","0","0","0","2","0","0","8","2","0","3","0","5","3","0","5","0","8","0","1","7","0","0","8"
"Wallsend","GB","54.99111","-1.53397","1","0","0","0","1","0","0","2","0","0","1","0","1","1","1","0","0","2","0","1","1","0","0","2"
"Wallsend","GB","-32.90133","151.66432","1","0","0","0","1","0","0","2","0","0","1","0","1","1","1","0","0","2","0","1","1","0","0","2"
"Walsall","GB","52.58528","-1.98396","27","0","0","0","2","0","3","32","6","11","5","1","23","14","5","13","0","32","7","7","16","2","0","32"
"Waltham Abbey","GB","51.687","-0.00421","2","0","0","0","0","0","0","2","1","0","1","0","2","1","0","1","0","2","0","0","2","0","0","2"
"Waltham Cross","GB","51.68602","-0.03575","2","0","0","1","0","0","0","3","1","1","1","0","3","2","0","1","0","3","0","2","1","0","0","3"
"Walthamstow","GB","51.59067","-0.02077","1","0","0","0","0","0","0","1","1","0","0","0","1","1","0","0","0","1","0","0","1","0","0","1"
"Walton-on-Thames","GB","51.38678","-0.41319","6","1","0","1","2","0","0","10","1","2","6","1","10","2","2","6","0","10","0","3","5","1","1","10"
"Wandsworth","GB","51.4577","-0.20784","4","0","0","0","0","0","0","4","1","0","1","0","2","2","0","2","0","4","0","0","4","0","0","4"
"Wantage","GB","51.58846","-1.42565","6","0","0","0","1","0","1","8","1","4","3","0","8","4","0","4","0","8","0","2","6","0","0","8"
"Ware","GB","42.25981","-72.2398","8","0","0","0","2","0","1","11","2","3","4","0","9","3","2","6","0","11","2","4","5","0","0","11"
"Ware","GB","51.81058","-0.02875","8","0","0","0","2","0","1","11","2","3","4","0","9","3","2","6","0","11","2","4","5","0","0","11"
"Wareham","GB","50.68792","-2.11058","2","0","0","0","1","0","0","3","0","2","0","1","3","0","0","2","1","3","1","0","2","0","0","3"
"Warfield","GB","51.44213","-0.72802","2","0","0","0","0","0","0","2","1","0","1","0","2","0","0","2","0","2","0","0","2","0","0","2"
"Wargrave","GB","51.50068","-0.86577","0","0","0","1","0","0","0","1","1","0","0","0","1","0","0","1","0","1","0","0","1","0","0","1"
"Warlingham","GB","51.30953","-0.05794","0","0","0","0","0","0","1","1","1","0","0","0","1","0","0","1","0","1","0","0","1","0","0","1"
"Warminster","GB","51.20434","-2.17873","1","0","0","0","0","0","0","1","0","1","0","0","1","0","0","1","0","1","1","0","0","0","0","1"
"Warrington","GB","30.38409","-87.27497","71","1","0","1","5","0","3","81","18","21","17","0","56","30","11","39","1","81","15","15","50","0","1","81"
"Warrington","GB","53.39254","-2.58024","71","1","0","1","5","0","3","81","18","21","17","0","56","30","11","39","1","81","15","15","50","0","1","81"
"Warrington","GB","52.18446","-0.68759","71","1","0","1","5","0","3","81","18","21","17","0","56","30","11","39","1","81","15","15","50","0","1","81"
"Warwick","GB","41.25648","-74.35988","18","0","0","0","3","0","4","25","2","8","8","0","18","12","6","7","0","25","4","4","16","0","1","25"
"Warwick","GB","42.68203","-72.33897","18","0","0","0","3","0","4","25","2","8","8","0","18","12","6","7","0","25","4","4","16","0","1","25"
"Warwick","GB","45.95007","-71.9824","18","0","0","0","3","0","4","25","2","8","8","0","18","12","6","7","0","25","4","4","16","0","1","25"
"Warwick","GB","41.7001","-71.41617","18","0","0","0","3","0","4","25","2","8","8","0","18","12","6","7","0","25","4","4","16","0","1","25"
"Warwick","GB","52.28333","-1.58333","18","0","0","0","3","0","4","25","2","8","8","0","18","12","6","7","0","25","4","4","16","0","1","25"
"Warwick","GB","-31.83974","115.80855","18","0","0","0","3","0","4","25","2","8","8","0","18","12","6","7","0","25","4","4","16","0","1","25"
"Warwick","GB","-28.21901","152.03438","18","0","0","0","3","0","4","25","2","8","8","0","18","12","6","7","0","25","4","4","16","0","1","25"
"Washington","GB","37.13054","-113.50829","8","0","0","0","0","0","0","8","1","2","4","0","7","3","2","3","0","8","0","3","5","0","0","8"
"Washington","GB","35.05896","-97.48448","8","0","0","0","0","0","0","8","1","2","4","0","7","3","2","3","0","8","0","3","5","0","0","8"
"Washington","GB","39.81806","-97.05086","8","0","0","0","0","0","0","8","1","2","4","0","7","3","2","3","0","8","0","3","5","0","0","8"
"Washington","GB","30.61631","-92.05706","8","0","0","0","0","0","0","8","1","2","4","0","7","3","2","3","0","8","0","3","5","0","0","8"
"Washington","GB","41.29918","-91.69294","8","0","0","0","0","0","0","8","1","2","4","0","7","3","2","3","0","8","0","3","5","0","0","8"
"Washington","GB","38.55811","-91.01209","8","0","0","0","0","0","0","8","1","2","4","0","7","3","2","3","0","8","0","3","5","0","0","8"
"Washington","GB","40.70365","-89.40731","8","0","0","0","0","0","0","8","1","2","4","0","7","3","2","3","0","8","0","3","5","0","0","8"
"Washington","GB","38.65922","-87.17279","8","0","0","0","0","0","0","8","1","2","4","0","7","3","2","3","0","8","0","3","5","0","0","8"
"Washington","GB","45.3947","-86.93151","8","0","0","0","0","0","0","8","1","2","4","0","7","3","2","3","0","8","0","3","5","0","0","8"
"Washington","GB","33.73679","-82.73931","8","0","0","0","0","0","0","8","1","2","4","0","7","3","2","3","0","8","0","3","5","0","0","8"
"Washington","GB","39.26119","-81.6718","8","0","0","0","0","0","0","8","1","2","4","0","7","3","2","3","0","8","0","3","5","0","0","8"
"Washington","GB","40.17396","-80.24617","8","0","0","0","0","0","0","8","1","2","4","0","7","3","2","3","0","8","0","3","5","0","0","8"
"Washington","GB","38.71345","-78.15944","8","0","0","0","0","0","0","8","1","2","4","0","7","3","2","3","0","8","0","3","5","0","0","8"
"Washington","GB","35.54655","-77.05217","8","0","0","0","0","0","0","8","1","2","4","0","7","3","2","3","0","8","0","3","5","0","0","8"
"Washington","GB","40.75843","-74.97934","8","0","0","0","0","0","0","8","1","2","4","0","7","3","2","3","0","8","0","3","5","0","0","8"
"Washington","GB","41.63148","-73.31067","8","0","0","0","0","0","0","8","1","2","4","0","7","3","2","3","0","8","0","3","5","0","0","8"
"Washington","GB","42.36592","-73.11621","8","0","0","0","0","0","0","8","1","2","4","0","7","3","2","3","0","8","0","3","5","0","0","8"
"Washington","GB","44.10562","-72.4326","8","0","0","0","0","0","0","8","1","2","4","0","7","3","2","3","0","8","0","3","5","0","0","8"
"Washington","GB","43.17591","-72.09675","8","0","0","0","0","0","0","8","1","2","4","0","7","3","2","3","0","8","0","3","5","0","0","8"
"Washington","GB","44.27369","-69.36727","8","0","0","0","0","0","0","8","1","2","4","0","7","3","2","3","0","8","0","3","5","0","0","8"
"Washington","GB","54.9","-1.51667","8","0","0","0","0","0","0","8","1","2","4","0","7","3","2","3","0","8","0","3","5","0","0","8"
"Washington","GB","50.90487","-0.40649","8","0","0","0","0","0","0","8","1","2","4","0","7","3","2","3","0","8","0","3","5","0","0","8"
"Wateringbury","GB","51.25543","0.42317","1","0","0","0","0","0","0","1","0","0","1","0","1","0","0","1","0","1","0","0","1","0","0","1"
"Waterlooville","GB","50.88067","-1.0304","15","1","0","5","5","0","0","26","10","7","7","0","24","6","8","12","0","26","3","6","17","0","0","26"
"Watford","GB","42.95008","-81.88309","28","1","0","5","3","0","4","41","5","11","18","0","34","18","6","17","0","41","5","8","24","3","1","41"
"Watford","GB","51.65531","-0.39602","28","1","0","5","3","0","4","41","5","11","18","0","34","18","6","17","0","41","5","8","24","3","1","41"
"Waverton","GB","53.16667","-2.8","1","0","0","0","0","0","0","1","0","0","0","0","0","1","0","0","0","1","0","0","1","0","0","1"
"Waverton","GB","-33.83863","151.20046","1","0","0","0","0","0","0","1","0","0","0","0","0","1","0","0","0","1","0","0","1","0","0","1"
"Wedmore","GB","51.22727","-2.81152","0","0","0","1","0","0","0","1","1","0","0","0","1","0","0","1","0","1","0","0","1","0","0","1"
"Wednesbury","GB","52.5514","-2.02355","2","2","0","0","1","0","1","6","3","0","1","1","5","2","1","2","1","6","2","3","1","0","0","6"
"Welling","GB","35.87787","-94.90106","5","0","0","0","0","0","1","6","3","1","1","0","5","3","2","1","0","6","1","2","2","1","0","6"
"Welling","GB","51.46246","0.10759","5","0","0","0","0","0","1","6","3","1","1","0","5","3","2","1","0","6","1","2","2","1","0","6"
"Welling","GB","50.33333","7.31667","5","0","0","0","0","0","1","6","3","1","1","0","5","3","2","1","0","6","1","2","2","1","0","6"
"Wellingborough","GB","52.30273","-0.69446","11","0","0","2","0","0","0","13","2","9","1","0","12","1","4","8","0","13","4","3","4","1","1","13"
"Wellington","GB","39.54247","-110.73543","1","0","0","0","0","0","0","1","0","1","0","0","1","0","0","1","0","1","0","0","1","0","0","1"
"Wellington","GB","40.70387","-105.00859","1","0","0","0","0","0","0","1","0","1","0","0","1","0","0","1","0","1","0","0","1","0","0","1"
"Wellington","GB","34.85617","-100.21373","1","0","0","0","0","0","0","1","0","1","0","0","1","0","0","1","0","1","0","0","1","0","0","1"
"Wellington","GB","37.2653","-97.37171","1","0","0","0","0","0","0","1","0","1","0","0","1","0","0","1","0","1","0","0","1","0","0","1"
"Wellington","GB","39.13418","-93.98272","1","0","0","0","0","0","0","1","0","1","0","0","1","0","0","1","0","1","0","0","1","0","0","1"
"Wellington","GB","38.21646","-85.66913","1","0","0","0","0","0","0","1","0","1","0","0","1","0","0","1","0","1","0","0","1","0","0","1"
"Wellington","GB","41.16894","-82.21794","1","0","0","0","0","0","0","1","0","1","0","0","1","0","0","1","0","1","0","0","1","0","0","1"
"Wellington","GB","26.65868","-80.24144","1","0","0","0","0","0","0","1","0","1","0","0","1","0","0","1","0","1","0","0","1","0","0","1"
"Wellington","GB","52.12934","-2.74214","1","0","0","0","0","0","0","1","0","1","0","0","1","0","0","1","0","1","0","0","1","0","0","1"
"Wellington","GB","52.7","-2.51667","1","0","0","0","0","0","0","1","0","1","0","0","1","0","0","1","0","1","0","0","1","0","0","1"
"Wellington","GB","-33.63981","19.0112","1","0","0","0","0","0","0","1","0","1","0","0","1","0","0","1","0","1","0","0","1","0","0","1"
"Wellington","GB","11.36552","76.78442","1","0","0","0","0","0","0","1","0","1","0","0","1","0","0","1","0","1","0","0","1","0","0","1"
"Wellington","GB","-32.55588","148.94508","1","0","0","0","0","0","0","1","0","1","0","0","1","0","0","1","0","1","0","0","1","0","0","1"
"Wellington","GB","-41.28664","174.77557","1","0","0","0","0","0","0","1","0","1","0","0","1","0","0","1","0","1","0","0","1","0","0","1"
"Wells","GB","41.11159","-114.96449","6","0","0","0","0","0","0","6","1","2","1","1","5","3","0","3","0","6","1","1","4","0","0","6"
"Wells","GB","31.48851","-94.93993","6","0","0","0","0","0","0","6","1","2","1","1","5","3","0","3","0","6","1","1","4","0","0","6"
"Wells","GB","43.74607","-93.72884","6","0","0","0","0","0","0","6","1","2","1","1","5","3","0","3","0","6","1","1","4","0","0","6"
"Wells","GB","45.39274","-65.92313","6","0","0","0","0","0","0","6","1","2","1","1","5","3","0","3","0","6","1","1","4","0","0","6"
"Wells","GB","51.20794","-2.64896","6","0","0","0","0","0","0","6","1","2","1","1","5","3","0","3","0","6","1","1","4","0","0","6"
"Welshpool","GB","52.65973","-3.1471","3","0","0","0","1","0","1","5","2","1","1","0","4","3","0","2","0","5","0","0","5","0","0","5"
"Welwyn","GB","51.8331","-0.21359","1","0","0","0","0","0","0","1","0","0","0","0","0","0","0","1","0","1","0","0","0","0","1","1"
"Welwyn Garden City","GB","51.80174","-0.20691","12","1","0","0","2","0","1","16","5","3","3","0","11","6","1","9","0","16","1","2","12","0","1","16"
"Wembley","GB","55.14995","-119.13602","4","0","0","0","0","0","0","4","3","0","0","0","3","1","0","3","0","4","0","1","3","0","0","4"
"Wembley","GB","51.55242","-0.29686","4","0","0","0","0","0","0","4","3","0","0","0","3","1","0","3","0","4","0","1","3","0","0","4"
"Wembley","GB","-31.93308","115.81783","4","0","0","0","0","0","0","4","3","0","0","0","3","1","0","3","0","4","0","1","3","0","0","4"
"Wendover","GB","40.73715","-114.03751","2","0","0","0","0","0","1","3","1","0","1","0","2","1","0","2","0","3","0","1","2","0","0","3"
"Wendover","GB","45.57275","-75.12757","2","0","0","0","0","0","1","3","1","0","1","0","2","1","0","2","0","3","0","1","2","0","0","3"
"Wendover","GB","51.76194","-0.73986","2","0","0","0","0","0","1","3","1","0","1","0","2","1","0","2","0","3","0","1","2","0","0","3"
"West Bridgford","GB","52.92979","-1.12537","3","0","0","0","0","0","0","3","0","1","2","0","3","1","1","1","0","3","0","0","3","0","0","3"
"West Bromwich","GB","52.51868","-1.9945","6","0","0","0","1","0","0","7","0","3","4","0","7","2","2","3","0","7","2","3","2","0","0","7"
"Westbury","GB","40.75566","-73.58763","3","0","0","0","0","0","0","3","0","1","1","1","3","0","1","2","0","3","2","0","1","0","0","3"
"Westbury","GB","52.67856","-2.95433","3","0","0","0","0","0","0","3","0","1","1","1","3","0","1","2","0","3","2","0","1","0","0","3"
"Westbury","GB","51.26","-2.1875","3","0","0","0","0","0","0","3","0","1","1","1","3","0","1","2","0","3","2","0","1","0","0","3"
"Westbury","GB","-41.52914","146.83914","3","0","0","0","0","0","0","3","0","1","1","1","3","0","1","2","0","3","2","0","1","0","0","3"
"West Byfleet","GB","51.33764","-0.50649","0","0","0","0","0","0","1","1","0","0","0","0","0","1","0","0","0","1","0","0","1","0","0","1"
"West Calder","GB","55.85188","-3.56981","1","0","0","0","0","0","0","1","0","1","0","0","1","0","0","1","0","1","1","0","0","0","0","1"
"Westcliff-on-Sea","GB","51.54424","0.69179","4","1","0","0","0","0","1","6","2","0","2","0","4","1","2","3","0","6","1","2","3","0","0","6"
"Westerham","GB","51.26632","0.06892","1","0","0","0","0","0","0","1","0","1","0","0","1","0","0","1","0","1","0","1","0","0","0","1"
"West Haddon","GB","52.34168","-1.07804","1","0","0","0","1","0","0","2","1","1","0","0","2","0","1","1","0","2","0","1","1","0","0","2"
"Westhill","GB","57.47323","-4.14893","1","0","0","0","0","0","0","1","0","1","0","0","1","0","0","1","0","1","0","0","1","0","0","1"
"Westhill","GB","57.15263","-2.27966","1","0","0","0","0","0","0","1","0","1","0","0","1","0","0","1","0","1","0","0","1","0","0","1"
"West Kilbride","GB","55.69004","-4.85771","1","0","0","0","0","0","0","1","0","1","0","0","1","1","0","0","0","1","0","0","1","0","0","1"
"West Kirby","GB","53.37302","-3.18417","5","0","0","0","1","0","0","6","2","1","1","0","4","4","0","2","0","6","0","2","3","1","0","6"
"West Malling","GB","51.29273","0.40907","7","0","0","0","1","0","0","8","3","2","3","0","8","2","1","5","0","8","0","1","7","0","0","8"
"West Molesey","GB","51.39985","-0.37997","2","0","0","0","0","0","0","2","0","0","1","0","1","0","0","2","0","2","0","0","2","0","0","2"
"Weston","GB","45.81374","-118.42469","1","0","0","0","0","0","0","1","0","1","0","0","1","0","0","1","0","1","0","0","1","0","0","1"
"Weston","GB","39.41111","-94.90163","1","0","0","0","0","0","0","1","0","1","0","0","1","0","0","1","0","1","0","0","1","0","0","1"
"Weston","GB","44.8908","-89.54762","1","0","0","0","0","0","0","1","0","1","0","0","1","0","0","1","0","1","0","0","1","0","0","1"
"Weston","GB","41.34477","-83.79716","1","0","0","0","0","0","0","1","0","1","0","0","1","0","0","1","0","1","0","0","1","0","0","1"
"Weston","GB","39.03843","-80.46731","1","0","0","0","0","0","0","1","0","1","0","0","1","0","0","1","0","1","0","0","1","0","0","1"
"Weston","GB","26.10037","-80.39977","1","0","0","0","0","0","0","1","0","1","0","0","1","0","0","1","0","1","0","0","1","0","0","1"
"Weston","GB","40.5351","-74.59071","1","0","0","0","0","0","0","1","0","1","0","0","1","0","0","1","0","1","0","0","1","0","0","1"
"Weston","GB","43.29119","-72.79315","1","0","0","0","0","0","0","1","0","1","0","0","1","0","0","1","0","1","0","0","1","0","0","1"
"Weston","GB","42.36676","-71.30311","1","0","0","0","0","0","0","1","0","1","0","0","1","0","0","1","0","1","0","0","1","0","0","1"
"Weston","GB","53.06667","-2.4","1","0","0","0","0","0","0","1","0","1","0","0","1","0","0","1","0","1","0","0","1","0","0","1"
"Weston","GB","-35.33582","149.05929","1","0","0","0","0","0","0","1","0","1","0","0","1","0","0","1","0","1","0","0","1","0","0","1"
"Weston-super-Mare","GB","51.34603","-2.97665","14","0","0","0","0","0","0","14","4","5","5","0","14","10","2","2","0","14","5","2","7","0","0","14"
"Weston Turville","GB","51.79168","-0.75767","1","0","0","0","0","0","0","1","0","0","1","0","1","0","0","1","0","1","0","0","1","0","0","1"
"West Wickham","GB","51.36667","-0.01667","2","0","0","0","1","0","1","4","1","0","1","1","3","1","1","2","0","4","2","1","1","0","0","4"
"Wetherby","GB","53.92836","-1.38672","3","0","0","0","0","0","0","3","1","0","2","0","3","2","0","1","0","3","0","1","2","0","0","3"
"Wethersfield","GB","41.71427","-72.65259","1","0","0","0","0","0","0","1","0","0","1","0","1","0","0","1","0","1","0","0","1","0","0","1"
"Wethersfield","GB","51.95358","0.48885","1","0","0","0","0","0","0","1","0","0","1","0","1","0","0","1","0","1","0","0","1","0","0","1"
"Weybridge","GB","51.37178","-0.45975","8","0","0","2","0","1","1","12","3","2","5","0","10","2","3","7","0","12","0","1","11","0","0","12"
"Weymouth","GB","42.22093","-70.93977","5","0","0","0","1","0","1","7","0","5","0","0","5","1","3","3","0","7","3","2","1","0","1","7"
"Weymouth","GB","50.61448","-2.45991","5","0","0","0","1","0","1","7","0","5","0","0","5","1","3","3","0","7","3","2","1","0","1","7"
"Whalley","GB","53.82209","-2.40712","1","0","0","0","0","0","0","1","0","0","1","0","1","0","0","1","0","1","0","0","1","0","0","1"
"Wheathampstead","GB","51.81148","-0.29371","1","0","0","0","0","0","0","1","1","0","0","0","1","0","0","1","0","1","0","0","1","0","0","1"
"Wheatley","GB","51.74731","-1.13936","1","0","0","0","0","0","0","1","0","1","0","0","1","1","0","0","0","1","1","0","0","0","0","1"
"Whitburn","GB","55.86667","-3.68333","2","0","0","0","1","0","0","3","1","0","2","0","3","2","0","1","0","3","0","1","2","0","0","3"
"Whitburn","GB","54.95333","-1.36861","2","0","0","0","1","0","0","3","1","0","2","0","3","2","0","1","0","3","0","1","2","0","0","3"
"Whitby","GB","54.48774","-0.61498","2","0","0","0","0","0","1","3","0","1","2","0","3","1","0","2","0","3","0","1","1","0","1","3"
"Whitchurch","GB","52.96667","-2.68333","1","2","0","0","1","0","0","4","1","1","2","0","4","0","1","3","0","4","0","0","4","0","0","4"
"Whitchurch","GB","51.85","-2.65","1","2","0","0","1","0","0","4","1","1","2","0","4","0","1","3","0","4","0","0","4","0","0","4"
"Whitchurch","GB","51.40606","-2.56265","1","2","0","0","1","0","0","4","1","1","2","0","4","0","1","3","0","4","0","0","4","0","0","4"
"Whitchurch","GB","51.8816","-0.83784","1","2","0","0","1","0","0","4","1","1","2","0","4","0","1","3","0","4","0","0","4","0","0","4"
"Whitefield","GB","44.37312","-71.61008","1","0","0","0","0","0","0","1","0","1","0","0","1","1","0","0","0","1","0","1","0","0","0","1"
"Whitefield","GB","44.17007","-69.62532","1","0","0","0","0","0","0","1","0","1","0","0","1","1","0","0","0","1","0","1","0","0","0","1"
"Whitefield","GB","53.55","-2.3","1","0","0","0","0","0","0","1","0","1","0","0","1","1","0","0","0","1","0","1","0","0","0","1"
"Whitehaven","GB","54.54897","-3.58412","3","0","0","1","0","0","0","4","1","0","2","0","3","1","1","2","0","4","1","0","3","0","0","4"
"Whitland","GB","51.81889","-4.61528","4","0","0","0","1","0","0","5","3","0","0","0","3","5","0","0","0","5","2","0","3","0","0","5"
"Whitley Bay","GB","55.03973","-1.44713","14","1","0","0","1","0","1","17","4","2","3","0","9","7","3","7","0","17","4","3","10","0","0","17"
"Whitstable","GB","51.3607","1.0257","9","0","0","0","0","0","1","10","2","2","4","0","8","3","1","6","0","10","1","2","7","0","0","10"
"Whittlesford","GB","52.11345","0.14969","1","0","0","0","0","0","0","1","0","1","0","0","1","1","0","0","0","1","1","0","0","0","0","1"
"Whitton","GB","52.3","-3.06667","1","0","0","0","0","0","0","1","1","0","1","0","2","0","0","2","0","2","0","0","2","0","0","2"
"Whitton","GB","53.7","-0.63333","1","0","0","0","0","0","0","1","1","0","1","0","2","0","0","2","0","2","0","0","2","0","0","2"
"Whyteleafe","GB","51.30808","-0.08429","0","0","0","0","1","0","0","1","0","0","1","0","1","0","0","1","0","1","0","0","1","0","0","1"
"Wick","GB","51.43944","-3.54944","2","0","0","0","0","0","0","2","1","1","0","0","2","0","0","2","0","2","2","0","0","0","0","2"
"Wick","GB","58.43906","-3.09424","2","0","0","0","0","0","0","2","1","1","0","0","2","0","0","2","0","2","2","0","0","0","0","2"
"Wick","GB","51.45306","-2.42361","2","0","0","0","0","0","0","2","1","1","0","0","2","0","0","2","0","2","2","0","0","0","0","2"
"Wickford","GB","51.61101","0.52331","6","0","0","0","0","0","1","7","0","1","4","0","5","0","1","6","0","7","2","4","1","0","0","7"
"Wickham Bishops","GB","51.7783","0.66823","0","0","0","0","0","0","1","1","0","0","1","0","1","0","0","1","0","1","0","0","1","0","0","1"
"Widnes","GB","53.3618","-2.73406","12","0","0","0","1","0","2","15","4","2","4","0","10","3","5","7","0","15","5","4","6","0","0","15"
"Wigan","GB","53.54296","-2.63706","25","1","0","1","3","0","2","32","10","5","11","0","26","11","5","16","0","32","5","10","17","0","0","32"
"Wigston Magna","GB","52.58128","-1.09248","1","0","0","0","0","0","0","1","1","0","0","0","1","0","0","1","0","1","0","1","0","0","0","1"
"Wilberfoss","GB","53.94854","-0.88945","1","0","0","0","0","0","0","1","0","0","0","0","0","1","0","0","0","1","0","0","1","0","0","1"
"Willenhall","GB","52.58514","-2.05934","4","0","0","0","0","0","0","4","1","2","1","0","4","3","0","1","0","4","0","2","1","1","0","4"
"Wilmslow","GB","53.32803","-2.23148","12","0","0","0","1","0","1","14","2","6","4","0","12","4","1","9","0","14","2","3","9","0","0","14"
"Wimborne Minster","GB","50.78333","-1.98333","8","0","0","0","0","0","1","9","2","2","4","0","8","5","1","3","0","9","1","3","5","0","0","9"
"Wincanton","GB","51.05676","-2.40574","2","0","0","0","0","0","0","2","1","1","0","0","2","2","0","0","0","2","0","1","1","0","0","2"
"Winchburgh","GB","55.95795","-3.46464","0","0","0","0","1","0","0","1","0","0","1","0","1","1","0","0","0","1","0","0","1","0","0","1"
"Winchester","GB","33.70697","-117.08447","18","1","0","0","5","0","2","26","6","5","9","0","20","9","2","15","0","26","4","5","16","0","0","25"
"Winchester","GB","36.12997","-115.11889","18","1","0","0","5","0","2","26","6","5","9","0","20","9","2","15","0","26","4","5","16","0","0","25"
"Winchester","GB","35.78621","-95.99222","18","1","0","0","5","0","2","26","6","5","9","0","20","9","2","15","0","26","4","5","16","0","0","25"
"Winchester","GB","39.32222","-95.26692","18","1","0","0","5","0","2","26","6","5","9","0","20","9","2","15","0","26","4","5","16","0","0","25"
"Winchester","GB","38.59033","-90.5279","18","1","0","0","5","0","2","26","6","5","9","0","20","9","2","15","0","26","4","5","16","0","0","25"
"Winchester","GB","39.62977","-90.45624","18","1","0","0","5","0","2","26","6","5","9","0","20","9","2","15","0","26","4","5","16","0","0","25"
"Winchester","GB","44.19859","-88.66483","18","1","0","0","5","0","2","26","6","5","9","0","20","9","2","15","0","26","4","5","16","0","0","25"
"Winchester","GB","35.18592","-86.11221","18","1","0","0","5","0","2","26","6","5","9","0","20","9","2","15","0","26","4","5","16","0","0","25"
"Winchester","GB","40.17199","-84.98135","18","1","0","0","5","0","2","26","6","5","9","0","20","9","2","15","0","26","4","5","16","0","0","25"
"Winchester","GB","37.99008","-84.17965","18","1","0","0","5","0","2","26","6","5","9","0","20","9","2","15","0","26","4","5","16","0","0","25"
"Winchester","GB","38.94174","-83.65075","18","1","0","0","5","0","2","26","6","5","9","0","20","9","2","15","0","26","4","5","16","0","0","25"
"Winchester","GB","39.18566","-78.16333","18","1","0","0","5","0","2","26","6","5","9","0","20","9","2","15","0","26","4","5","16","0","0","25"
"Winchester","GB","45.0834","-75.34933","18","1","0","0","5","0","2","26","6","5","9","0","20","9","2","15","0","26","4","5","16","0","0","25"
"Winchester","GB","42.77342","-72.38314","18","1","0","0","5","0","2","26","6","5","9","0","20","9","2","15","0","26","4","5","16","0","0","25"
"Winchester","GB","42.45232","-71.137","18","1","0","0","5","0","2","26","6","5","9","0","20","9","2","15","0","26","4","5","16","0","0","25"
"Winchester","GB","51.06513","-1.3187","18","1","0","0","5","0","2","26","6","5","9","0","20","9","2","15","0","26","4","5","16","0","0","25"
"Windsor","GB","38.54713","-122.81638","17","0","0","2","1","0","1","21","4","5","7","0","16","8","3","11","0","22","2","7","12","0","1","22"
"Windsor","GB","40.47748","-104.90136","17","0","0","2","1","0","1","21","4","5","7","0","16","8","3","11","0","22","2","7","12","0","1","22"
"Windsor","GB","38.53224","-93.52215","17","0","0","2","1","0","1","21","4","5","7","0","16","8","3","11","0","22","2","7","12","0","1","22"
"Windsor","GB","43.21833","-89.34151","17","0","0","2","1","0","1","21","4","5","7","0","16","8","3","11","0","22","2","7","12","0","1","22"
"Windsor","GB","39.44087","-88.59478","17","0","0","2","1","0","1","21","4","5","7","0","16","8","3","11","0","22","2","7","12","0","1","22"
"Windsor","GB","42.30008","-83.01654","17","0","0","2","1","0","1","21","4","5","7","0","16","8","3","11","0","22","2","7","12","0","1","22"
"Windsor","GB","35.55294","-77.36108","17","0","0","2","1","0","1","21","4","5","7","0","16","8","3","11","0","22","2","7","12","0","1","22"
"Windsor","GB","35.99849","-76.94606","17","0","0","2","1","0","1","21","4","5","7","0","16","8","3","11","0","22","2","7","12","0","1","22"
"Windsor","GB","36.80848","-76.74412","17","0","0","2","1","0","1","21","4","5","7","0","16","8","3","11","0","22","2","7","12","0","1","22"
"Windsor","GB","39.91621","-76.58441","17","0","0","2","1","0","1","21","4","5","7","0","16","8","3","11","0","22","2","7","12","0","1","22"
"Windsor","GB","42.07591","-75.64046","17","0","0","2","1","0","1","21","4","5","7","0","16","8","3","11","0","22","2","7","12","0","1","22"
"Windsor","GB","42.51175","-73.05788","17","0","0","2","1","0","1","21","4","5","7","0","16","8","3","11","0","22","2","7","12","0","1","22"
"Windsor","GB","41.8526","-72.6437","17","0","0","2","1","0","1","21","4","5","7","0","16","8","3","11","0","22","2","7","12","0","1","22"
"Windsor","GB","43.48035","-72.38481","17","0","0","2","1","0","1","21","4","5","7","0","16","8","3","11","0","22","2","7","12","0","1","22"
"Windsor","GB","45.56678","-71.99909","17","0","0","2","1","0","1","21","4","5","7","0","16","8","3","11","0","22","2","7","12","0","1","22"
"Windsor","GB","44.31063","-69.5806","17","0","0","2","1","0","1","21","4","5","7","0","16","8","3","11","0","22","2","7","12","0","1","22"
"Windsor","GB","44.98345","-64.13204","17","0","0","2","1","0","1","21","4","5","7","0","16","8","3","11","0","22","2","7","12","0","1","22"
"Windsor","GB","51.48333","-0.6","17","0","0","2","1","0","1","21","4","5","7","0","16","8","3","11","0","22","2","7","12","0","1","22"
"Windsor","GB","-37.85344","144.99241","17","0","0","2","1","0","1","21","4","5","7","0","16","8","3","11","0","22","2","7","12","0","1","22"
"Windsor","GB","-33.61309","150.81416","17","0","0","2","1","0","1","21","4","5","7","0","16","8","3","11","0","22","2","7","12","0","1","22"
"Windsor","GB","-27.43631","153.02882","17","0","0","2","1","0","1","21","4","5","7","0","16","8","3","11","0","22","2","7","12","0","1","22"
"Winford","GB","51.38333","-2.66111","1","0","0","0","0","0","0","1","0","0","0","0","0","0","0","1","0","1","1","0","0","0","0","1"
"Wing","GB","51.89524","-0.71956","1","0","0","0","0","0","0","1","0","1","0","0","1","0","0","1","0","1","0","1","0","0","0","1"
"Wing","GB","52.61775","-0.6827","1","0","0","0","0","0","0","1","0","1","0","0","1","0","0","1","0","1","0","1","0","0","0","1"
"Winkleigh","GB","50.85581","-3.943","2","0","0","0","0","0","0","2","0","1","0","0","1","1","0","1","0","2","0","0","2","0","0","2"
"Winnersh","GB","51.42747","-0.87994","1","0","0","0","0","0","0","1","0","0","1","0","1","0","0","1","0","1","0","0","1","0","0","1"
"Winscombe","GB","51.3181","-2.83224","1","0","0","0","0","0","0","1","0","0","1","0","1","0","0","1","0","1","0","1","0","0","0","1"
"Winsford","GB","53.19146","-2.52398","1","0","0","0","0","0","1","2","1","0","1","0","2","0","0","2","0","2","0","1","1","0","0","2"
"Winslow","GB","35.02419","-110.69736","2","0","0","0","0","0","0","2","0","1","1","0","2","0","0","2","0","2","1","0","1","0","0","2"
"Winslow","GB","38.38227","-87.21279","2","0","0","0","0","0","0","2","0","1","1","0","2","0","0","2","0","2","1","0","1","0","0","2"
"Winslow","GB","44.54701","-69.62116","2","0","0","0","0","0","0","2","0","1","1","0","2","0","0","2","0","2","1","0","1","0","0","2"
"Winslow","GB","51.94284","-0.88131","2","0","0","0","0","0","0","2","0","1","1","0","2","0","0","2","0","2","1","0","1","0","0","2"
"Winster","GB","53.1418","-1.64258","1","0","0","0","0","0","0","1","0","1","0","0","1","0","1","0","0","1","0","1","0","0","0","1"
"Wisbech","GB","52.66622","0.15938","5","0","0","0","0","0","0","5","0","3","2","0","5","1","1","3","0","5","1","2","2","0","0","5"
"Wishaw","GB","55.76667","-3.91667","5","2","0","0","0","0","0","7","3","4","0","0","7","2","1","4","0","7","2","3","1","0","1","7"
"Witham","GB","51.80007","0.64038","5","0","0","0","0","0","0","5","0","2","3","0","5","2","1","2","0","5","1","2","1","0","1","5"
"Withernsea","GB","53.73115","0.03195","1","0","0","0","0","0","0","1","0","1","0","0","1","0","0","1","0","1","0","0","0","0","1","1"
"Witney","GB","51.7836","-1.4854","7","0","0","0","0","0","2","9","2","3","0","1","6","3","1","5","0","9","4","1","4","0","0","9"
"Wiveliscombe","GB","51.04139","-3.31278","1","0","0","0","0","0","0","1","0","0","1","0","1","1","0","0","0","1","0","0","1","0","0","1"
"Woburn Sands","GB","52.01579","-0.64982","1","0","0","0","0","0","0","1","0","0","0","0","0","0","0","1","0","1","0","0","1","0","0","1"
"Woking","GB","51.31903","-0.55893","32","4","0","2","3","0","4","45","12","8","17","1","38","12","6","27","0","45","2","11","32","0","0","45"
"Wokingham","GB","51.4112","-0.83565","25","2","0","3","1","0","1","32","6","10","11","1","28","8","5","19","0","32","6","11","15","0","0","32"
"Wolverhampton","GB","52.58547","-2.12296","35","2","0","3","1","0","3","44","10","15","10","1","36","16","8","19","1","44","11","8","22","2","1","44"
"Wombourn","GB","52.53333","-2.18333","1","0","0","0","0","0","0","1","1","0","0","0","1","0","0","1","0","1","0","1","0","0","0","1"
"Woodbridge","GB","38.15408","-121.30134","2","0","0","0","1","0","0","3","1","1","0","0","2","1","1","1","0","3","0","0","3","0","0","3"
"Woodbridge","GB","38.65817","-77.2497","2","0","0","0","1","0","0","3","1","1","0","0","2","1","1","1","0","3","0","0","3","0","0","3"
"Woodbridge","GB","40.5576","-74.28459","2","0","0","0","1","0","0","3","1","1","0","0","2","1","1","1","0","3","0","0","3","0","0","3"
"Woodbridge","GB","41.3526","-73.00844","2","0","0","0","1","0","0","3","1","1","0","0","2","1","1","1","0","3","0","0","3","0","0","3"
"Woodbridge","GB","52.09332","1.32042","2","0","0","0","1","0","0","3","1","1","0","0","2","1","1","1","0","3","0","0","3","0","0","3"
"Woodbridge","GB","-31.88695","115.99196","2","0","0","0","1","0","0","3","1","1","0","0","2","1","1","1","0","3","0","0","3","0","0","3"
"Woodford","GB","51.11667","-1.83333","1","0","0","0","0","0","0","1","0","1","0","0","1","0","0","1","0","1","0","0","1","0","0","1"
"Woodford","GB","52.38231","-0.58099","1","0","0","0","0","0","0","1","0","1","0","0","1","0","0","1","0","1","0","0","1","0","0","1"
"Woodford","GB","-33.73333","150.48333","1","0","0","0","0","0","0","1","0","1","0","0","1","0","0","1","0","1","0","0","1","0","0","1"
"Woodford","GB","-26.95291","152.77747","1","0","0","0","0","0","0","1","0","1","0","0","1","0","0","1","0","1","0","0","1","0","0","1"
"Woodford Green","GB","51.60938","0.02329","3","1","0","0","0","0","0","4","0","1","1","0","2","1","1","2","0","4","2","0","2","0","0","4"
"Woodhall Spa","GB","53.15215","-0.21453","2","0","0","0","0","0","0","2","1","1","0","0","2","1","1","0","0","2","0","1","1","0","0","2"
"Woodley","GB","51.45","-0.88333","1","0","0","0","0","0","0","1","0","0","1","0","1","0","0","1","0","1","0","1","0","0","0","1"
"Woodstock","GB","42.31474","-88.4487","1","0","0","0","0","0","0","1","0","0","0","0","0","0","1","0","0","1","0","0","1","0","0","1"
"Woodstock","GB","33.20678","-87.15","1","0","0","0","0","0","0","1","0","0","0","0","0","0","1","0","0","1","0","0","1","0","0","1"
"Woodstock","GB","34.10149","-84.51938","1","0","0","0","0","0","0","1","0","0","0","0","0","0","1","0","0","1","0","0","1","0","0","1"
"Woodstock","GB","43.13339","-80.7497","1","0","0","0","0","0","0","1","0","0","0","0","0","0","1","0","0","1","0","0","1","0","0","1"
"Woodstock","GB","38.88178","-78.50584","1","0","0","0","0","0","0","1","0","0","0","0","0","0","1","0","0","1","0","0","1","0","0","1"
"Woodstock","GB","42.04092","-74.1182","1","0","0","0","0","0","0","1","0","0","0","0","0","0","1","0","0","1","0","0","1","0","0","1"
"Woodstock","GB","43.62424","-72.51843","1","0","0","0","0","0","0","1","0","0","0","0","0","0","1","0","0","1","0","0","1","0","0","1"
"Woodstock","GB","43.97757","-71.68508","1","0","0","0","0","0","0","1","0","0","0","0","0","0","1","0","0","1","0","0","1","0","0","1"
"Woodstock","GB","44.37494","-70.60849","1","0","0","0","0","0","0","1","0","0","0","0","0","0","1","0","0","1","0","0","1","0","0","1"
"Woodstock","GB","51.8485","-1.35132","1","0","0","0","0","0","0","1","0","0","0","0","0","0","1","0","0","1","0","0","1","0","0","1"
"Woodstock","GB","-33.74457","148.84892","1","0","0","0","0","0","0","1","0","0","0","0","0","0","1","0","0","1","0","0","1","0","0","1"
"Woolacombe","GB","51.17296","-4.20689","1","0","0","0","0","0","0","1","0","1","0","0","1","0","0","1","0","1","1","0","0","0","0","1"
"Wooler","GB","55.54755","-2.01186","1","0","0","0","0","0","0","1","0","1","0","0","1","1","0","0","0","1","1","0","0","0","0","1"
"Woolwich","GB","43.91869","-69.80116","3","0","0","0","0","0","1","4","0","0","2","0","2","0","1","3","0","4","0","1","3","0","0","4"
"Woolwich","GB","51.491","0.0648","3","0","0","0","0","0","1","4","0","0","2","0","2","0","1","3","0","4","0","1","3","0","0","4"
"Woolwich","GB","-33.84019","151.16939","3","0","0","0","0","0","1","4","0","0","2","0","2","0","1","3","0","4","0","1","3","0","0","4"
"Woore","GB","52.97701","-2.40235","0","0","0","1","0","0","0","1","1","0","0","0","1","0","0","1","0","1","0","0","1","0","0","1"
"Worcester","GB","42.59146","-74.75043","47","1","0","1","6","0","4","59","11","21","20","1","53","22","4","33","0","59","12","19","27","0","1","59"
"Worcester","GB","42.26259","-71.80229","47","1","0","1","6","0","4","59","11","21","20","1","53","22","4","33","0","59","12","19","27","0","1","59"
"Worcester","GB","52.18935","-2.22001","47","1","0","1","6","0","4","59","11","21","20","1","53","22","4","33","0","59","12","19","27","0","1","59"
"Worcester","GB","-33.64651","19.44852","47","1","0","1","6","0","4","59","11","21","20","1","53","22","4","33","0","59","12","19","27","0","1","59"
"Worcester Park","GB","51.37992","-0.24445","2","1","0","0","1","0","1","5","2","2","1","0","5","2","0","3","0","5","2","0","3","0","0","5"
"Workington","GB","54.6425","-3.54413","5","0","0","1","0","0","0","6","0","2","4","0","6","1","3","2","0","6","2","1","3","0","0","6"
"Worksop","GB","53.30182","-1.12404","12","1","0","0","1","0","1","15","1","7","7","0","15","4","3","8","0","15","4","4","7","0","0","15"
"Worlaby","GB","53.6113","-0.46685","1","0","0","0","0","0","0","1","0","1","0","0","1","0","0","0","0","0","0","0","0","0","0","0"
"Wormley","GB","51.13622","-0.64673","0","1","0","0","0","0","0","1","1","0","0","0","1","1","0","0","0","1","1","0","0","0","0","1"
"Worthing","GB","43.32915","-96.76283","16","1","0","1","6","0","3","27","5","6","9","1","21","10","4","13","0","27","7","4","15","0","1","27"
"Worthing","GB","50.81795","-0.37538","16","1","0","1","6","0","3","27","5","6","9","1","21","10","4","13","0","27","7","4","15","0","1","27"
"Wotton-under-Edge","GB","51.63242","-2.34512","2","0","0","0","1","0","0","3","1","0","0","0","1","0","2","1","0","3","3","0","0","0","0","3"
"Wrea Green","GB","53.77651","-2.91573","1","0","0","0","0","0","0","1","1","0","0","0","1","0","0","1","0","1","0","0","1","0","0","1"
"Wrexham","GB","53.04664","-2.99132","29","0","0","1","5","0","1","36","5","10","17","1","33","11","6","19","0","36","10","10","15","0","1","36"
"Wrington","GB","51.36173","-2.76319","1","0","0","0","0","0","0","1","0","0","1","0","1","0","0","1","0","1","0","0","1","0","0","1"
"Writtle","GB","51.72906","0.42938","1","0","0","0","0","0","0","1","0","1","0","0","1","0","0","1","0","1","1","0","0","0","0","1"
"Wylam","GB","54.97654","-1.82187","3","0","0","0","0","0","0","3","1","1","0","0","2","0","0","2","1","3","1","0","2","0","0","3"
"Yalding","GB","51.22387","0.4292","1","0","0","0","0","0","0","1","0","0","1","0","1","0","0","1","0","1","0","0","1","0","0","1"
"Yarm","GB","54.50364","-1.35793","3","0","0","0","0","0","0","3","0","0","2","0","2","1","0","2","0","3","0","2","1","0","0","3"
"Yate","GB","51.54074","-2.41839","3","0","0","0","0","0","0","3","0","2","0","0","2","0","0","3","0","3","1","0","2","0","0","3"
"Yateley","GB","51.34305","-0.82985","3","0","0","0","0","0","0","3","0","1","2","0","3","1","0","2","0","3","0","1","1","1","0","3"
"Yatton","GB","51.38839","-2.82353","1","0","0","0","0","0","0","1","0","1","0","0","1","0","0","1","0","1","0","0","1","0","0","1"
"Yatton","GB","51.96667","-2.53333","1","0","0","0","0","0","0","1","0","1","0","0","1","0","0","1","0","1","0","0","1","0","0","1"
"Yelverton","GB","50.4929","-4.08382","2","0","0","0","0","0","0","2","0","0","0","0","0","2","0","0","0","2","0","2","0","0","0","2"
"Yeovil","GB","50.94159","-2.63211","9","0","0","0","0","0","0","9","0","6","2","0","8","3","0","6","0","9","3","4","2","0","0","9"
"Y Felinheli","GB","53.18737","-4.20476","1","0","0","0","0","0","0","1","0","0","0","0","0","0","0","1","0","1","0","1","0","0","0","1"
"Ynysybwl","GB","51.63922","-3.36036","0","1","0","0","0","0","0","1","1","0","0","0","1","0","1","0","0","1","0","0","1","0","0","1"
"York","GB","32.89368","-109.20284","56","4","0","7","8","0","3","78","25","17","19","0","61","17","14","46","1","78","9","20","47","1","1","78"
"York","GB","40.86807","-97.592","56","4","0","7","8","0","3","78","25","17","19","0","61","17","14","46","1","78","9","20","47","1","1","78"
"York","GB","32.48625","-88.29642","56","4","0","7","8","0","3","78","25","17","19","0","61","17","14","46","1","78","9","20","47","1","1","78"
"York","GB","34.9943","-81.24202","56","4","0","7","8","0","3","78","25","17","19","0","61","17","14","46","1","78","9","20","47","1","1","78"
"York","GB","39.9626","-76.72774","56","4","0","7","8","0","3","78","25","17","19","0","61","17","14","46","1","78","9","20","47","1","1","78"
"York","GB","53.95763","-1.08271","56","4","0","7","8","0","3","78","25","17","19","0","61","17","14","46","1","78","9","20","47","1","1","78"
"York","GB","-31.88809","116.7678","56","4","0","7","8","0","3","78","25","17","19","0","61","17","14","46","1","78","9","20","47","1","1","78"
"Ystradgynlais","GB","51.76667","-3.76667","0","0","0","1","0","0","0","1","1","0","0","0","1","1","0","0","0","1","0","0","1","0","0","1"
NULL,"GB",NULL,NULL,"5282","229","5","292","520","5","559","6892","1348","1219","1181","192","3940","2272","737","2549","90","5648","1028","1430","2550","75","169","5252"
