"city","point_latitude","point_longitude","covid_status_no_symptoms","covid_status_symptoms","covid_status_test_positive","covid_status_symptoms-2","covid_status_symptoms_not_covid","covid_status_test_positive_recovered","covid_status_total_responses","self_isolation_steps_not_leaving_house","self_isolation_steps_work_and_essentials","self_isolation_steps_essentials","self_isolation_steps_none","self_isolation_steps_total_responses","amount_of_contact_no_large_groups","amount_of_contact_reduced_contact","amount_of_contact_minimal_contact","amount_of_contact_none","amount_of_contact_total_responses","current_work_car","current_work_retired","current_work_wfh","current_work_public_transport","current_work_bike_or_walk","current_work_total_responses"
"10 de Abril","16.82917","-99.74083","1","0","0","0","0","0","1","0","1","0","0","1","0","0","1","0","1","1","0","0","0","0","1"
"12 de Diciembre (Sombreretillo)","24.70833","-103.57361","1","0","0","0","0","0","1","0","0","0","0","0","1","0","0","0","1","1","0","0","0","0","1"
"17 de Octubre","26.79806","-109.70222","1","0","0","0","0","0","1","0","1","0","0","1","0","1","0","0","1","0","0","1","0","0","1"
"1 Decembrie","44.29083","26.05806","1","0","0","0","0","0","1","0","1","0","0","1","0","0","1","0","1","1","0","0","0","0","1"
"23 August","45.52303","22.3993","2","0","0","0","0","0","2","0","0","0","0","0","2","0","0","0","2","0","0","2","0","0","2"
"23 August","43.91667","28.58333","2","0","0","0","0","0","2","0","0","0","0","0","2","0","0","0","2","0","0","2","0","0","2"
"2.Bezirk","46.6251","14.3091","0","1","0","0","1","0","2","0","1","1","0","2","1","0","1","0","2","0","0","1","0","1","2"
"3.Bezirk","46.62263","14.31036","1","0","0","0","0","0","1","0","1","0","0","1","1","0","0","0","1","0","0","1","0","0","1"
"Aach","49.78333","6.6","1","0","0","0","0","0","1","0","0","0","0","0","1","0","0","0","1","1","0","0","0","0","1"
"Aach","47.8424","8.85384","1","0","0","0","0","0","1","0","0","0","0","0","1","0","0","0","1","1","0","0","0","0","1"
"Aachen","50.77664","6.08342","3","0","0","0","0","0","3","0","2","1","0","3","0","1","2","0","3","0","0","2","1","0","3"
"Aagtdorp","52.69","4.70417","2","0","0","0","0","0","2","0","2","0","0","2","2","0","0","0","2","0","1","1","0","0","2"
"Aagtekerke","51.54667","3.50972","1","0","0","0","0","0","1","0","0","1","0","1","0","0","1","0","1","0","0","1","0","0","1"
"Aalborg","57.048","9.9187","3","0","0","0","0","0","3","0","1","0","0","1","2","0","1","0","3","0","2","1","0","0","3"
"Aalburg","51.75482","5.13156","0","1","0","0","0","0","1","0","0","1","0","1","0","0","1","0","1","0","1","0","0","0","1"
"Aaley","33.80528","35.6","3","0","0","0","0","0","3","2","0","1","0","3","0","2","2","0","4","1","0","2","0","0","3"
"Aalst","50.93604","4.0355","1","1","0","0","0","0","2","1","1","0","0","2","0","0","1","1","2","0","0","1","0","1","2"
"Aalst","51.7825","5.12778","1","1","0","0","0","0","2","1","1","0","0","2","0","0","1","1","2","0","0","1","0","1","2"
"Aalst","51.39667","5.47778","1","1","0","0","0","0","2","1","1","0","0","2","0","0","1","1","2","0","0","1","0","1","2"
"Aalter","51.09017","3.44693","2","0","0","0","0","0","2","0","1","0","1","2","2","0","0","0","2","0","0","2","0","0","2"
"Aarau","47.39254","8.04422","2","0","0","0","0","0","2","1","0","0","0","1","0","1","1","0","2","0","1","1","0","0","2"
"Aarberg","47.04439","7.27578","1","0","0","0","0","0","1","0","0","0","0","0","0","0","1","0","1","0","0","1","0","0","1"
"Aaronsburg","40.89979","-77.45332","2","1","0","1","0","0","4","2","1","1","0","4","1","0","2","1","4","0","0","1","1","2","4"
"Aarschot","50.98715","4.83695","1","0","0","0","0","0","1","0","0","1","0","1","0","0","1","0","1","0","1","0","0","0","1"
"Aba","5.10658","7.36667","6","0","0","0","0","0","6","2","0","2","0","4","1","4","1","0","6","2","0","4","0","0","6"
"Aba","47.02907","18.52172","6","0","0","0","0","0","6","2","0","2","0","4","1","4","1","0","6","2","0","4","0","0","6"
"Aba","32.90594","101.70625","6","0","0","0","0","0","6","2","0","2","0","4","1","4","1","0","6","2","0","4","0","0","6"
"Abaca","11.1342","122.7156","8","0","0","0","0","0","8","3","3","0","1","7","6","1","1","0","8","1","0","5","0","2","8"
"Abaca","9.9204","124.5051","8","0","0","0","0","0","8","3","3","0","1","7","6","1","1","0","8","1","0","5","0","2","8"
"Abadan","30.3392","48.3043","1","0","0","0","0","0","1","1","0","0","0","1","1","0","0","0","1","0","0","1","0","0","1"
"Abadan","38.05415","58.19721","1","0","0","0","0","0","1","1","0","0","0","1","1","0","0","0","1","0","0","1","0","0","1"
"Abades","40.91646","-4.26937","1","0","0","0","0","0","1","1","0","0","0","1","0","0","1","0","1","0","0","1","0","0","1"
"Abadou","31.57917","-7.31308","1","0","0","0","0","0","1","1","0","0","0","1","0","0","1","0","1","0","1","0","0","0","1"
"Abádszalók","47.46667","20.6","1","0","0","0","0","0","1","0","1","0","0","1","0","0","1","0","1","0","0","1","0","0","1"
"Abaeté","-19.16","-45.44583","4","0","0","0","0","0","4","0","0","1","1","2","2","1","1","0","4","2","0","2","0","0","4"
"Abagana","6.19031","6.99357","7","0","0","0","0","0","8","2","4","0","0","6","6","2","0","0","8","3","0","3","1","1","8"
"Abaji","8.47372","6.94453","3","0","0","0","0","0","3","1","1","0","1","3","2","0","0","1","3","0","0","2","0","1","3"
"Abak","4.98236","7.78922","1","0","0","0","0","0","1","1","0","0","0","1","1","0","0","0","1","0","0","1","0","0","1"
"Abakaliki","6.32485","8.11368","4","0","0","0","0","0","4","1","2","0","0","3","2","1","0","0","3","1","0","2","0","1","4"
"Abalak","15.4509","6.2793","0","0","0","0","0","0","0","0","0","0","0","0","0","0","1","0","1","1","0","0","0","0","1"
"Abalak","58.12861","68.59444","0","0","0","0","0","0","0","0","0","0","0","0","0","0","1","0","1","1","0","0","0","0","1"
"Abana","41.97858","34.011","2","0","0","0","0","0","2","1","1","0","0","2","1","0","1","0","2","0","0","1","0","1","2"
"Abancay","-13.63389","-72.88139","1","0","0","0","0","0","1","0","0","1","0","1","0","0","1","0","1","0","0","1","0","0","1"
"Abancourt","49.69607","1.76512","0","0","0","0","1","0","1","0","0","0","0","0","0","0","1","0","1","0","1","0","0","0","1"
"Abano Terme","45.35753","11.78725","0","1","0","0","0","0","1","0","0","1","0","1","0","0","1","0","1","0","0","1","0","0","1"
"‘Abasān al Jadīdah","31.34158","34.34592","1","0","0","0","0","0","1","0","0","0","0","0","1","0","0","0","1","1","0","0","0","0","1"
"Abbadia","43.48821","13.53644","2","0","0","0","0","0","2","0","0","1","0","1","0","0","2","0","2","0","0","1","0","1","2"
"Abbaretz","47.55314","-1.532","6","0","0","0","0","0","6","0","2","2","0","4","2","2","2","0","6","0","1","5","0","0","6"
"Abberton","51.83435","0.91084","50","2","0","1","3","0","57","11","9","18","1","39","15","6","34","2","57","9","16","31","1","0","57"
"Abbeville","29.97465","-92.13429","39","3","2","4","4","0","55","17","7","7","2","33","13","13","28","1","55","10","8","35","2","0","55"
"Abbeville","31.57184","-85.25049","39","3","2","4","4","0","55","17","7","7","2","33","13","13","28","1","55","10","8","35","2","0","55"
"Abbeville","31.99212","-83.30682","39","3","2","4","4","0","55","17","7","7","2","33","13","13","28","1","55","10","8","35","2","0","55"
"Abbeville","34.17817","-82.37901","39","3","2","4","4","0","55","17","7","7","2","33","13","13","28","1","55","10","8","35","2","0","55"
"Abbeville","50.10521","1.83547","39","3","2","4","4","0","55","17","7","7","2","33","13","13","28","1","55","10","8","35","2","0","55"
"Abbévillers","47.43205","6.91651","1","0","0","0","0","0","1","0","1","0","0","1","0","0","0","1","1","0","1","0","0","0","1"
"Abbey","-33.66364","115.25635","1","0","0","0","0","0","1","0","1","0","0","1","0","0","1","0","1","0","1","0","0","0","1"
"Abbey Dore","51.96667","-2.9","302","13","1","24","47","0","417","75","136","122","10","343","168","57","186","7","418","73","87","243","4","11","418"
"Abbeyfeale","52.38139","-9.3025","1","0","0","0","1","0","2","0","0","2","0","2","1","1","0","0","2","0","1","1","0","0","2"
"Abbeyleix","52.91331","-7.34456","1","1","0","0","0","0","3","0","2","1","0","3","0","2","1","0","3","1","1","1","0","0","3"
"Abbey Wood","51.48688","0.10747","26","1","0","1","4","0","33","3","7","18","0","28","17","4","13","0","34","6","9","18","0","1","34"
"Abbots Bromley","52.81705","-1.87694","13","0","0","0","1","0","14","2","3","2","0","7","7","1","6","0","14","2","3","9","0","0","14"
"Abbotsbury","-33.8701","150.86119","12","0","0","0","1","0","13","0","10","2","1","13","6","7","0","0","13","9","0","4","0","0","13"
"Abbotsford","49.05798","-122.25257","10","1","0","0","1","0","12","4","3","2","0","9","4","2","6","0","12","3","2","7","0","0","12"
"Abbotsford","44.94636","-90.31597","10","1","0","0","1","0","12","4","3","2","0","9","4","2","6","0","12","3","2","7","0","0","12"
"Abbotsford","-37.8","145","10","1","0","0","1","0","12","4","3","2","0","9","4","2","6","0","12","3","2","7","0","0","12"
"Abbotsford","-33.84889","151.12801","10","1","0","0","1","0","12","4","3","2","0","9","4","2","6","0","12","3","2","7","0","0","12"
"Abbotskerswell","50.50816","-3.61342","4","1","0","0","0","0","5","0","2","2","0","4","2","2","1","0","5","0","0","5","0","0","5"
"Abbots Langley","51.70573","-0.41757","7","0","0","0","2","0","9","2","0","2","3","7","3","1","3","2","9","0","3","6","0","0","9"
"Abbottabad","34.1463","73.21168","20","2","0","0","0","0","23","10","2","4","1","17","12","3","6","1","22","6","4","11","0","2","23"
"Abbotts Ann","51.19016","-1.53234","1","0","0","0","0","0","1","1","0","0","0","1","0","0","1","0","1","0","0","1","0","0","1"
"Āb-e Kamarī","35.08796","63.0678","1","0","0","0","0","0","1","0","0","1","0","1","0","1","0","0","1","0","0","1","0","0","1"
"Abeokuta","7.15571","3.34509","4","0","0","0","1","0","5","0","4","0","1","5","1","3","1","0","5","2","0","1","0","2","5"
"Abepura","-2.5964","140.6324","5","0","0","0","0","0","5","0","3","1","0","4","2","1","2","0","5","2","1","1","1","0","5"
"Aber","53.23333","-4.01667","2","0","0","0","0","0","2","0","0","1","0","1","2","0","0","0","2","0","1","1","0","0","2"
"Abercanaid","51.72361","-3.36611","2","0","0","0","0","0","2","0","1","1","0","2","1","1","0","0","2","1","1","0","0","0","2"
"Abercarn","51.64733","-3.13476","3","0","0","0","0","0","3","1","0","2","0","3","0","1","2","0","3","1","2","0","0","0","3"
"Abercrombie","-33.38867","149.5458","2","0","0","0","0","0","2","0","0","1","0","1","1","0","1","0","2","0","2","0","0","0","2"
"Abercynon","51.64548","-3.32727","1","0","0","0","0","0","2","0","0","1","0","1","0","0","2","0","2","0","0","2","0","0","2"
"Aberdare","51.71438","-3.44918","8","0","0","0","0","0","8","1","6","1","0","8","3","3","2","0","8","3","2","2","1","0","8"
"Aberdare","-32.84112","151.38168","8","0","0","0","0","0","8","1","6","1","0","8","3","3","2","0","8","3","2","2","1","0","8"
"Aberdeen","46.97537","-123.81572","23","0","0","0","3","0","27","7","9","9","0","25","9","6","12","0","27","3","7","16","0","1","27"
"Aberdeen","42.94408","-112.83833","23","0","0","0","3","0","27","7","9","9","0","25","9","6","12","0","27","3","7","16","0","1","27"
"Aberdeen","45.4647","-98.48648","23","0","0","0","3","0","27","7","9","9","0","25","9","6","12","0","27","3","7","16","0","1","27"
"Aberdeen","33.82511","-88.54366","23","0","0","0","3","0","27","7","9","9","0","25","9","6","12","0","27","3","7","16","0","1","27"
"Aberdeen","41.43893","-87.11142","23","0","0","0","3","0","27","7","9","9","0","25","9","6","12","0","27","3","7","16","0","1","27"
"Aberdeen","38.65563","-83.76103","23","0","0","0","3","0","27","7","9","9","0","25","9","6","12","0","27","3","7","16","0","1","27"
"Aberdeen","26.55063","-80.14866","23","0","0","0","3","0","27","7","9","9","0","25","9","6","12","0","27","3","7","16","0","1","27"
"Aberdeen","35.13155","-79.42948","23","0","0","0","3","0","27","7","9","9","0","25","9","6","12","0","27","3","7","16","0","1","27"
"Aberdeen","39.50956","-76.16412","23","0","0","0","3","0","27","7","9","9","0","25","9","6","12","0","27","3","7","16","0","1","27"
"Aberdeen","57.14369","-2.09814","23","0","0","0","3","0","27","7","9","9","0","25","9","6","12","0","27","3","7","16","0","1","27"
"Aberdeen","-32.16588","150.89003","23","0","0","0","3","0","27","7","9","9","0","25","9","6","12","0","27","3","7","16","0","1","27"
"Aberdyfi","52.544","-4.04606","1","0","0","0","0","0","2","0","1","0","0","1","1","1","0","0","2","0","2","0","0","0","2"
"Aberfan","51.68892","-3.34178","0","0","0","0","1","0","1","0","0","1","0","1","0","0","1","0","1","1","0","0","0","0","1"
"Aberfeldy","56.62196","-3.86693","2","0","0","0","0","0","2","0","0","2","0","2","1","0","1","0","2","0","0","2","0","0","2"
"Aberford","53.82604","-1.34231","0","0","0","0","1","0","1","1","0","0","0","1","1","0","0","0","1","0","0","1","0","0","1"
"Abergavenny","51.82098","-3.01743","17","2","0","0","1","0","20","3","7","9","0","19","4","4","12","0","20","7","3","10","0","0","20"
"Abergele","53.28436","-3.5822","1","0","0","0","0","0","1","0","1","0","0","1","0","1","0","0","1","1","0","0","0","0","1"
"Abergwili","51.86593","-4.26969","1","0","0","0","0","0","1","0","1","0","0","1","1","0","0","0","1","1","0","0","0","0","1"
"Abersoch","52.82437","-4.50584","1","0","0","0","0","0","1","0","1","0","0","1","1","0","0","0","1","0","1","0","0","0","1"
"Abertillery","51.72981","-3.13432","3","0","0","0","1","0","4","2","0","2","0","4","0","1","2","1","4","0","2","2","0","0","4"
"Abertridwr","51.59583","-3.26833","0","0","0","0","1","0","1","0","1","0","0","1","0","0","1","0","1","1","0","0","0","0","1"
"Aberystwyth","52.41548","-4.08292","4","0","0","0","1","0","5","2","0","3","0","5","0","1","4","0","5","1","0","4","0","0","5"
"Abha","18.21639","42.50528","4","0","0","0","1","0","5","0","1","1","1","3","2","1","2","0","5","2","1","2","0","0","5"
"Abhaneri","27.00743","76.6076","7","0","0","0","0","0","7","5","0","1","0","6","2","0","4","1","7","0","0","6","0","0","6"
"Abhayāpuri","26.32255","90.68526","61","1","0","1","0","1","65","40","2","13","3","58","22","14","25","4","65","3","6","49","1","6","65"
"Abidjan","5.35444","-4.00167","7","0","0","0","0","0","7","0","1","3","0","4","4","3","0","0","7","2","0","4","1","0","7"
"Abiko","35.86667","140.01667","3","0","0","0","0","0","3","0","0","0","1","1","2","0","0","1","3","1","0","0","1","1","3"
"Abingdon","40.80448","-90.4018","9","1","0","0","1","0","12","1","2","7","0","10","3","3","6","0","12","2","1","9","0","0","12"
"Abingdon","36.70983","-81.97735","9","1","0","0","1","0","12","1","2","7","0","10","3","3","6","0","12","2","1","9","0","0","12"
"Abingdon","51.67109","-1.28278","9","1","0","0","1","0","12","1","2","7","0","10","3","3","6","0","12","2","1","9","0","0","12"
"Abirāmam","9.4423","78.4399","2","0","0","0","0","0","2","2","0","0","0","2","1","0","0","1","2","0","1","1","0","0","2"
"Abnūb","27.26881","31.15232","1","0","0","0","0","0","1","0","0","0","0","0","0","1","0","0","1","1","0","0","0","0","1"
"Aboh","5.54781","6.52588","0","0","0","0","0","0","0","0","0","0","0","0","0","0","0","0","0","0","0","0","0","0","0"
"Aboh","5.47569","7.27161","0","0","0","0","0","0","0","0","0","0","0","0","0","0","0","0","0","0","0","0","0","0","0"
"Abohar","30.14453","74.19552","2","0","0","0","0","0","2","1","0","0","1","2","2","0","0","0","2","0","1","1","0","0","2"
"Abovyan","40.04851","44.54742","1","0","0","0","0","0","1","0","0","1","0","1","0","0","1","0","1","0","0","1","0","0","1"
"Abovyan","40.27368","44.63348","1","0","0","0","0","0","1","0","0","1","0","1","0","0","1","0","1","0","0","1","0","0","1"
"Aboyne","57.07546","-2.78023","1","0","0","0","1","0","2","0","0","2","0","2","0","0","2","0","2","0","1","1","0","0","2"
"Abqaiq","25.93402","49.6688","4","0","0","0","0","0","4","1","1","0","0","2","2","1","1","0","4","1","1","1","1","0","4"
"Abrantes","39.46667","-8.2","1","0","0","0","0","0","1","0","1","0","0","1","1","0","0","0","1","0","0","1","0","0","1"
"Abra Pampa","-22.72049","-65.69697","5","1","0","0","0","0","6","3","1","0","0","4","1","1","3","1","6","2","1","2","1","0","6"
"Abrikosovka","45.27058","33.19125","1","0","0","0","0","0","1","0","1","0","0","1","0","1","0","0","1","0","0","0","0","1","1"
"Abrikosovka","45.10759","35.10139","1","0","0","0","0","0","1","0","1","0","0","1","0","1","0","0","1","0","0","0","0","1","1"
"Abrikosovo","45.69236","34.10156","1","0","0","0","0","0","1","0","1","0","0","1","0","0","1","0","1","0","0","1","0","0","1"
"Abs","16.00295","43.19725","1","0","0","0","0","0","1","0","1","0","0","1","0","0","0","0","0","0","0","0","0","1","1"
"Abua","4.85763","6.64519","1","0","0","0","0","0","1","0","1","0","0","1","1","0","0","0","1","1","0","0","0","0","1"
"Abū al Maţāmīr","30.91018","30.17438","7","0","0","0","1","0","8","1","6","1","0","8","4","2","2","0","8","5","0","2","1","0","8"
"Abū ‘Arīsh","16.96887","42.83251","2","0","0","0","0","0","2","1","1","0","0","2","1","1","0","0","2","0","0","1","0","0","1"
"Abu Dhabi","24.45118","54.39696","26","0","0","0","0","0","26","6","9","0","0","15","13","4","9","0","26","11","2","8","4","2","27"
"Abudu","6.29489","6.02995","1","0","0","0","0","0","1","0","0","0","0","0","0","0","0","0","0","0","0","0","0","1","1"
"Abudula","46.84635","83.27552","0","1","0","0","0","0","1","1","0","0","0","1","0","0","1","0","1","0","0","1","0","0","1"
"Abu Fatira","29.19746","48.10278","1","0","0","0","0","0","1","0","1","0","0","1","0","1","0","0","1","1","0","0","0","0","1"
"Abū Ghurayb","33.30563","44.18477","3","0","0","0","0","0","3","3","0","0","0","3","1","0","2","0","3","0","0","3","0","0","3"
"Abuja","9.05785","7.49508","23","0","0","0","2","0","25","6","13","1","3","23","16","2","7","1","26","13","0","9","1","4","27"
"Abū Kabīr","30.72508","31.67148","3","1","0","1","0","0","5","2","2","0","0","4","2","2","1","0","5","2","1","2","0","0","5"
"Abū Qalqal","36.43806","38.11984","1","0","0","0","0","0","1","0","1","0","0","1","1","0","0","0","1","0","0","1","0","0","1"
"Aburi","5.84802","-0.17449","1","0","0","0","0","0","1","0","1","0","0","1","1","0","0","0","1","1","0","0","0","0","1"
"Abū Tīj","27.04514","31.31845","1","0","0","0","0","0","1","0","0","0","1","1","1","0","0","0","1","0","0","1","0","0","1"
"Åbybro","57.16249","9.72996","1","0","0","0","0","0","1","1","0","0","0","1","0","0","1","0","1","0","1","0","0","0","1"
"Acarí","-15.42393","-74.61361","1","0","0","0","0","0","1","0","0","0","0","0","0","0","1","0","1","0","0","1","0","0","1"
"Acarigua","9.55451","-69.19564","4","0","0","0","0","0","4","1","1","1","0","3","1","2","1","0","4","1","1","1","1","0","4"
"Acarlar","37.82444","27.74667","2","0","0","1","0","0","3","0","1","1","0","2","1","0","2","0","3","0","0","2","0","1","3"
"Acas","-10.45778","-77.32729","0","0","0","0","0","0","1","0","0","0","0","0","0","0","1","0","1","0","1","0","0","0","1"
"Accra","5.55602","-0.1969","34","0","0","0","1","0","35","11","10","2","2","25","17","10","6","1","34","13","1","13","2","6","35"
"Accrington","53.75379","-2.35863","8","0","0","0","0","0","9","2","5","2","0","9","2","1","5","0","8","1","1","7","0","0","9"
"Achacachi","-16.05","-68.68333","1","0","0","0","0","0","1","0","1","0","0","1","0","0","1","0","1","0","0","1","0","0","1"
"Acharávi","39.7936","19.81736","1","0","0","0","0","0","1","0","1","0","0","1","1","0","0","0","1","1","0","0","0","0","1"
"Acharnés","38.08333","23.73333","2","0","0","0","0","0","2","1","1","0","0","2","1","0","1","0","2","1","0","1","0","0","2"
"Achhām","29.05","81.3","2","0","0","0","0","0","2","1","1","0","0","2","0","1","1","0","2","0","0","1","0","1","2"
"Achladochóri","40.83703","22.34227","1","0","0","0","0","0","1","1","0","0","0","1","1","0","0","0","1","0","0","1","0","0","1"
"Achladochóri","41.31976","23.54026","1","0","0","0","0","0","1","1","0","0","0","1","1","0","0","0","1","0","0","1","0","0","1"
"Acıpayam","37.42385","29.34941","1","0","0","0","0","0","1","1","0","0","0","1","0","0","1","0","1","0","0","1","0","0","1"
"A Coruña","43.37135","-8.396","1","0","0","0","0","0","1","1","0","0","0","1","1","0","0","0","1","0","1","0","0","0","1"
"Acoyapa","11.97028","-85.17113","1","0","0","0","0","0","1","0","1","0","0","1","1","0","0","0","1","0","0","1","0","0","1"
"Acre","32.92814","35.07647","1","1","0","0","0","0","2","1","0","0","0","1","2","0","0","0","2","1","0","1","0","0","2"
"Acton","34.46999","-118.19674","1","0","0","0","0","0","1","0","0","0","0","0","1","0","0","0","1","0","0","1","0","0","1"
"Acton","42.48509","-71.43284","1","0","0","0","0","0","1","0","0","0","0","0","1","0","0","0","1","0","0","1","0","0","1"
"Acton","43.53425","-70.90978","1","0","0","0","0","0","1","0","0","0","0","0","1","0","0","0","1","0","0","1","0","0","1"
"Acton","52.45","-3.01667","1","0","0","0","0","0","1","0","0","0","0","0","1","0","0","0","1","0","0","1","0","0","1"
"Acton","51.50901","-0.2762","1","0","0","0","0","0","1","0","0","0","0","0","1","0","0","0","1","0","0","1","0","0","1"
"Acton","-35.27767","149.11829","1","0","0","0","0","0","1","0","0","0","0","0","1","0","0","0","1","0","0","1","0","0","1"
"Acton Vale","45.65007","-72.56582","1","0","0","0","0","0","1","0","1","0","0","1","0","0","1","0","1","0","0","0","1","0","1"
"Acworth","34.06635","-84.67837","1","0","0","0","0","0","1","0","0","0","0","0","1","0","0","0","1","0","0","1","0","0","1"
"Acworth","43.21785","-72.29203","1","0","0","0","0","0","1","0","0","0","0","0","1","0","0","0","1","0","0","1","0","0","1"
"Ada","34.77453","-96.67834","1","0","0","0","1","0","2","1","0","0","0","1","0","2","0","0","2","1","1","0","0","0","2"
"Ada","47.29969","-96.51535","1","0","0","0","1","0","2","1","0","0","0","1","0","2","0","0","2","1","1","0","0","0","2"
"Ada","40.7695","-83.82271","1","0","0","0","1","0","2","1","0","0","0","1","0","2","0","0","2","1","1","0","0","0","2"
"Ada","45.8025","20.12583","1","0","0","0","1","0","2","1","0","0","0","1","0","2","0","0","2","1","1","0","0","0","2"
"Adado","6.13603","46.62761","0","0","0","0","1","0","1","0","0","1","0","1","0","0","0","1","1","0","0","1","0","0","1"
"Adam","46.02868","27.73296","1","0","0","0","0","0","1","0","1","0","0","1","0","1","0","0","1","1","0","0","0","0","1"
"Adam","22.37934","57.52718","1","0","0","0","0","0","1","0","1","0","0","1","0","1","0","0","1","1","0","0","0","0","1"
"Adampur","31.43224","75.71484","1","0","0","0","0","0","1","1","0","0","0","1","0","0","1","0","1","0","0","1","0","0","1"
"Adana","36.98615","35.32531","1","0","0","0","0","0","1","0","0","0","0","0","0","1","0","0","1","0","0","1","0","0","1"
"Adâncata","47.73333","26.3","1","0","0","0","0","0","1","1","0","0","0","1","0","0","1","0","1","0","1","0","0","0","1"
"Adâncata","44.76667","26.43333","1","0","0","0","0","0","1","1","0","0","0","1","0","0","1","0","1","0","1","0","0","0","1"
"Adapazarı","40.78056","30.40333","1","0","0","0","0","0","1","0","0","1","0","1","0","1","0","0","1","0","1","0","0","0","1"
"Adar","30.14111","-8.37221","1","0","0","0","0","0","1","1","0","0","0","1","0","0","0","1","1","0","0","1","0","0","1"
"Adare","52.56194","-8.79556","2","0","0","0","0","0","2","0","2","0","0","2","1","1","0","0","2","2","0","0","0","0","2"
"Adare","-27.51267","152.29537","2","0","0","0","0","0","2","0","2","0","0","2","1","1","0","0","2","2","0","0","0","0","2"
"Adaúfe","41.58732","-8.39817","1","0","0","0","0","0","1","0","0","0","0","0","1","0","0","0","1","0","1","0","0","0","1"
"Ad Dawādimī","24.50772","44.39237","1","0","0","0","0","0","1","0","1","0","0","1","0","1","0","0","1","0","0","1","0","0","1"
"Addingham","53.94452","-1.88424","1","0","0","0","0","0","1","0","1","1","0","2","0","0","2","0","2","0","0","2","0","0","2"
"Addis Ababa","9.02497","38.74689","44","3","0","0","0","0","47","11","18","3","11","43","17","17","8","4","46","18","4","12","9","4","47"
"Ad Dīwānīyah","31.99289","44.92552","6","1","0","0","0","0","7","3","1","1","1","6","2","1","3","1","7","2","0","5","0","0","7"
"Addlestone","51.37135","-0.49353","5","0","0","1","0","0","6","1","2","2","0","5","3","0","3","0","6","1","2","3","0","0","6"
"Adeje","28.12271","-16.726","1","0","0","0","0","0","1","0","0","0","0","0","0","0","1","0","1","0","1","0","0","0","1"
"Adelaide","-32.70747","26.29564","4","0","0","0","0","0","4","0","1","1","0","2","3","0","1","0","4","2","1","1","0","0","4"
"Adelaide","-34.92866","138.59863","4","0","0","0","0","0","4","0","1","1","0","2","3","0","1","0","4","2","1","1","0","0","4"
"Adelaide city centre","-34.92873","138.60334","0","0","0","0","1","0","1","1","0","0","0","1","1","0","0","0","1","0","0","1","0","0","1"
"Aden","12.77944","45.03667","4","0","0","0","0","0","4","0","2","0","1","3","2","2","0","0","4","4","0","0","0","0","4"
"Ādīgrat","14.277","39.462","0","0","0","0","0","0","0","0","0","0","0","0","0","0","0","0","0","0","0","0","0","0","0"
"Ādilābād","19.67203","78.5359","0","1","0","0","0","0","1","1","0","0","0","1","0","1","0","0","1","0","0","1","0","0","1"
"Adil Makmur","5.19843","96.87015","1","0","0","0","0","0","1","0","0","0","1","1","0","0","0","1","1","0","0","0","0","1","1"
"Adilpur","27.93677","69.31941","58","6","0","1","1","0","66","30","21","3","7","61","36","12","16","2","66","12","4","37","4","9","66"
"Adjumani","3.37786","31.7909","2","0","0","0","0","0","2","0","1","0","1","2","1","1","0","0","2","0","0","0","0","2","2"
"Adjuntas","18.16274","-66.72212","1","0","0","0","0","0","1","0","1","0","0","1","0","1","0","0","1","1","0","0","0","0","1"
"Adlington","53.61323","-2.60676","1","0","0","0","0","0","1","0","0","1","0","1","0","0","1","0","1","0","0","1","0","0","1"
"Adlington","53.32042","-2.13658","1","0","0","0","0","0","1","0","0","1","0","1","0","0","1","0","1","0","0","1","0","0","1"
"Ado-Odo","6.59546","2.94176","1","0","0","0","0","0","1","0","0","1","0","1","0","1","0","0","1","0","0","1","0","0","1"
"Adorjan","46.00333","20.04007","2","0","0","0","0","0","2","0","0","1","0","1","0","1","1","0","2","1","1","0","0","0","2"
"Adrar","27.87429","-0.29388","1","0","0","0","0","0","1","0","1","0","0","1","0","1","0","0","1","1","0","0","0","0","1"
"Adraskan","33.64573","62.26959","2","0","0","0","0","0","2","1","0","0","1","2","2","0","0","0","2","0","0","1","0","1","2"
"Adria","45.05445","12.05599","1","0","0","0","0","0","1","0","0","0","0","0","0","0","1","0","1","1","0","0","0","0","1"
"Adwick le Street","53.57077","-1.18454","6","0","0","0","0","0","6","5","1","0","0","6","1","0","5","0","6","1","0","5","0","0","6"
"Adzopé","6.10694","-3.86194","0","0","0","0","0","0","0","0","0","0","1","1","0","0","0","1","1","1","0","0","0","0","1"
"Äetsä","61.28333","22.68333","1","0","0","0","0","0","1","0","1","0","0","1","0","1","0","0","1","0","1","0","0","0","1"
"Afaha Offiong","4.86226","7.90626","1","0","0","0","0","0","1","1","0","0","0","1","0","1","0","0","1","0","0","0","0","0","0"
"Afgooye","2.1381","45.1212","4","0","0","0","0","0","4","1","0","0","1","2","3","0","0","1","4","0","0","3","0","1","4"
"Afidnés","38.20332","23.83982","1","0","0","0","0","0","1","1","0","0","0","1","0","1","0","0","1","1","0","0","0","0","1"
"Aflao","6.11982","1.19012","2","0","0","0","0","0","2","0","1","1","0","2","1","0","1","0","2","0","0","0","1","1","2"
"Aflou","34.11279","2.10228","0","1","0","0","0","0","1","0","1","0","0","1","0","0","1","0","1","0","0","0","1","0","1"
"Afula","32.60907","35.2892","1","0","0","0","0","0","1","1","0","0","0","1","0","0","1","0","1","0","0","1","0","0","1"
"Afyonkarahisar","38.75667","30.54333","2","0","0","0","0","0","2","0","0","0","1","1","1","0","1","0","2","2","0","0","0","0","2"
"Agadez","16.97333","7.99111","5","0","0","0","0","0","5","0","5","0","0","5","0","5","0","0","5","0","0","5","0","0","5"
"Agadir","30.42018","-9.59815","6","1","0","0","0","0","7","3","2","2","0","7","3","1","3","0","7","1","2","2","1","1","7"
"Agawam","42.06954","-72.61481","1","0","0","0","0","0","1","0","1","0","0","1","0","1","0","0","1","0","0","1","0","0","1"
"Agege","6.61563","3.33337","2","0","0","0","0","0","2","0","1","1","0","2","0","1","1","0","2","0","0","0","0","1","1"
"Agen","44.20199","0.62055","1","0","0","0","0","0","1","0","0","1","0","1","0","0","1","0","1","0","1","0","0","0","1"
"Agía Paraskeví","39.09903","20.99108","2","1","0","0","0","0","3","1","1","0","0","2","0","3","0","0","3","2","1","0","0","0","3"
"Agía Paraskeví","40.4815","23.04863","2","1","0","0","0","0","3","1","1","0","0","2","0","3","0","0","3","2","1","0","0","0","3"
"Agía Paraskeví","40.94935","23.45706","2","1","0","0","0","0","3","1","1","0","0","2","0","3","0","0","3","2","1","0","0","0","3"
"Agía Paraskeví","38.01667","23.83333","2","1","0","0","0","0","3","1","1","0","0","2","0","3","0","0","3","2","1","0","0","0","3"
"Agía Paraskeví","39.24792","26.27178","2","1","0","0","0","0","3","1","1","0","0","2","0","3","0","0","3","2","1","0","0","0","3"
"Agios Dimitrios","37.93333","23.73333","1","0","0","0","0","0","1","0","1","0","0","1","0","0","1","0","1","0","0","1","0","0","1"
"Ágios Nikólaos","38.86886","20.80425","0","0","0","0","0","0","0","0","0","0","0","0","0","0","0","0","0","0","0","0","0","0","0"
"Ágios Nikólaos","40.24926","23.69616","0","0","0","0","0","0","0","0","0","0","0","0","0","0","0","0","0","0","0","0","0","0","0"
"Ágios Nikólaos","35.19106","25.71524","0","0","0","0","0","0","0","0","0","0","0","0","0","0","0","0","0","0","0","0","0","0","0"
"Ágios Panteleímonas","40.72398","21.74825","1","0","0","0","0","0","1","0","1","0","0","1","0","0","1","0","1","0","1","0","0","0","1"
"Ágios Pávlos","40.64075","22.96039","1","0","0","0","0","0","1","0","0","1","0","1","0","0","1","0","1","1","0","0","0","0","1"
"Ágios Týchon","34.72606","33.13872","0","0","0","0","0","0","1","0","0","0","1","1","0","0","0","1","1","0","0","0","0","1","1"
"Agra","46.03668","8.76833","4","0","0","0","0","0","4","2","1","0","1","4","1","1","2","0","4","0","0","3","0","1","4"
"Agra","27.18333","78.01667","4","0","0","0","0","0","4","2","1","0","1","4","1","1","2","0","4","0","0","3","0","1","4"
"Ağrı","39.71944","43.05139","1","0","0","0","0","0","1","1","0","0","0","1","0","0","1","0","1","0","0","1","0","0","1"
"Agrigento","37.31065","13.57661","1","0","0","0","0","0","1","0","0","0","0","0","0","0","1","0","1","1","0","0","0","0","1"
"Agua Azul Rancho","14.9","-87.95","1","0","0","0","0","0","1","0","1","0","0","1","1","0","0","0","1","1","0","0","0","0","1"
"Agua Blanca","27.11407","-109.73425","2","0","0","0","0","0","2","1","1","0","0","2","1","1","0","0","2","1","0","1","0","0","2"
"Agua Blanca","25.8763","-108.11623","2","0","0","0","0","0","2","1","1","0","0","2","1","1","0","0","2","1","0","1","0","0","2"
"Agua Blanca","19.22056","-99.47056","2","0","0","0","0","0","2","1","1","0","0","2","1","1","0","0","2","1","0","1","0","0","2"
"Agua Blanca","17.48584","-92.6218","2","0","0","0","0","0","2","1","1","0","0","2","1","1","0","0","2","1","0","1","0","0","2"
"Agua Blanca","14.49805","-89.64961","2","0","0","0","0","0","2","1","1","0","0","2","1","1","0","0","2","1","0","1","0","0","2"
"Agua Blanca","-6.72343","-76.69643","2","0","0","0","0","0","2","1","1","0","0","2","1","1","0","0","2","1","0","1","0","0","2"
"Agua Blanca","9.66205","-69.10677","2","0","0","0","0","0","2","1","1","0","0","2","1","1","0","0","2","1","0","1","0","0","2"
"Aguascalientes","21.88234","-102.28259","3","0","0","0","0","0","3","1","0","0","0","1","1","2","0","0","3","1","1","1","0","0","3"
"Agugliaro","45.3251","11.58496","1","0","0","0","0","0","1","0","1","0","0","1","0","0","1","0","1","0","0","0","0","1","1"
"Aguiar da Beira","40.81726","-7.54431","1","0","0","0","0","0","1","0","1","0","0","1","0","0","1","0","1","1","0","0","0","0","1"
"Ahero","-0.17359","34.9189","2","0","0","0","0","0","2","0","2","0","0","2","0","1","1","0","2","0","0","1","0","1","2"
"Ahmadnagar","19.09457","74.73843","2","0","0","0","0","0","2","1","0","0","1","2","2","0","0","0","2","0","0","2","0","0","2"
"Ahmadpur East","29.14269","71.25771","3","0","0","0","0","0","3","1","1","1","0","3","1","1","1","0","3","0","0","3","0","0","3"
"Ahmadpur Sial","30.67791","71.74344","2","0","0","0","0","0","2","0","1","0","0","1","1","0","1","0","2","1","0","0","1","0","2"
"Ahmedabad","23.02579","72.58727","20","0","0","0","1","0","21","13","6","1","0","20","5","2","13","1","21","0","1","15","0","5","21"
"Ahtopol","42.09768","27.93961","1","0","0","0","0","0","1","0","0","0","1","1","0","0","0","1","1","0","0","0","0","1","1"
"Ahvaz","31.31901","48.6842","1","0","0","0","0","0","1","0","1","0","0","1","1","0","0","0","1","1","0","0","0","0","1"
"Aībak","36.26468","68.01551","1","0","0","0","0","0","1","0","1","0","0","1","0","1","0","0","1","0","0","1","0","0","1"
"Aïn Arnat","36.18683","5.31347","1","0","0","0","0","0","1","0","0","1","0","1","0","0","1","0","1","0","0","1","0","0","1"
"Aïn Beïda","35.79639","7.39278","1","0","0","0","1","0","2","1","0","1","0","2","0","1","1","0","2","0","1","1","0","0","2"
"’Aïn Benian","36.80277","2.92185","1","0","0","0","0","0","1","1","0","0","0","1","0","0","1","0","1","0","0","1","0","0","1"
"’Aïn Deheb","34.84218","1.54697","1","0","0","0","0","0","1","0","1","0","0","1","0","0","1","0","1","0","0","0","1","0","1"
"Aïn Fakroun","35.97108","6.87374","1","0","0","0","0","0","1","1","0","0","0","1","0","0","1","0","1","0","1","0","0","0","1"
"Aïn Touta","35.37675","5.90001","1","0","0","0","0","0","1","1","0","0","0","1","1","0","0","0","1","0","0","1","0","0","1"
"Airdrie","51.30011","-114.03528","5","0","0","0","0","0","5","0","2","3","0","5","1","2","2","0","5","1","3","1","0","0","5"
"Airdrie","55.86602","-3.98025","5","0","0","0","0","0","5","0","2","3","0","5","1","2","2","0","5","1","3","1","0","0","5"
"Airmadidi","1.42804","124.97774","1","0","0","0","0","0","1","0","1","0","0","1","1","0","0","0","1","1","0","0","0","0","1"
"Aix-en-Provence","43.5283","5.44973","1","0","0","1","0","0","2","1","1","0","0","2","0","1","1","0","2","1","0","1","0","0","2"
"Aizawl","23.72894","92.71791","2","1","0","0","0","0","3","1","0","1","0","2","1","2","0","0","3","0","1","1","0","1","3"
"Ajā","30.94162","31.29039","1","0","0","0","0","0","1","0","1","0","0","1","0","1","0","0","1","0","0","1","0","0","1"
"‘Ajlūn","32.33326","35.75279","1","1","0","0","0","0","2","1","1","0","0","2","0","1","1","0","2","1","0","1","0","0","2"
"Ajman City","25.40177","55.47878","2","0","0","0","0","0","2","0","1","0","0","1","0","1","1","0","2","1","0","0","0","1","2"
"Ajmer","26.4521","74.63867","3","0","0","0","1","0","4","3","0","2","0","5","0","0","5","0","5","0","2","3","0","0","5"
"Ajodhya","26.79909","82.2047","2","0","0","0","0","0","2","2","0","0","0","2","0","0","2","0","2","0","0","2","0","0","2"
"Akademija (Kaunas)","54.8964","23.82411","2","0","0","0","0","0","2","0","1","0","0","1","0","1","1","0","2","1","0","0","0","1","2"
"Akaroa","-43.80384","172.96817","1","0","0","0","0","0","1","1","0","0","0","1","0","0","1","0","1","0","1","0","0","0","1"
"Akbarpur","26.38371","79.94926","1","0","0","0","0","0","1","0","0","0","1","1","1","0","0","0","1","0","0","1","0","0","1"
"Akbarpur","26.42953","82.53431","1","0","0","0","0","0","1","0","0","0","1","1","1","0","0","0","1","0","0","1","0","0","1"
"Åkersberga","59.47944","18.29967","1","0","0","0","0","0","1","0","0","1","0","1","0","0","1","0","1","0","0","0","1","0","1"
"Akim Swedru","5.8938","-1.01636","1","0","0","0","0","0","1","0","0","0","0","0","1","0","0","0","1","0","0","0","0","1","1"
"Akko","10.28899","10.9732","1","0","0","0","0","0","1","0","0","0","1","1","0","0","1","0","1","0","0","1","0","0","1"
"Akkol","51.99374","70.94704","0","1","0","0","0","0","1","1","0","0","0","1","0","0","1","0","1","0","0","1","0","0","1"
"Akola","20.70957","76.9981","2","0","0","0","0","0","2","2","0","0","0","2","0","0","2","0","2","0","0","2","0","0","2"
"Akron","40.16054","-103.21438","2","0","0","0","0","0","2","0","0","1","0","1","1","0","1","0","2","1","0","1","0","0","2"
"Akron","42.82888","-96.55948","2","0","0","0","0","0","2","0","0","1","0","1","1","0","1","0","2","1","0","1","0","0","2"
"Akron","41.03838","-86.02805","2","0","0","0","0","0","2","0","0","1","0","1","1","0","1","0","2","1","0","1","0","0","2"
"Akron","41.08144","-81.51901","2","0","0","0","0","0","2","0","0","1","0","1","1","0","1","0","2","1","0","1","0","0","2"
"Akron","43.02089","-78.4953","2","0","0","0","0","0","2","0","0","1","0","1","1","0","1","0","2","1","0","1","0","0","2"
"Akron","40.15676","-76.20217","2","0","0","0","0","0","2","0","0","1","0","1","1","0","1","0","2","1","0","1","0","0","2"
"Akure","7.25256","5.19312","10","0","0","0","0","0","10","0","1","2","5","8","2","2","1","0","5","3","0","7","0","0","10"
"Akureyri","65.68353","-18.0878","1","0","0","0","0","0","1","1","0","0","0","1","1","0","0","0","1","0","0","1","0","0","1"
"Al Abyār","32.19","20.59653","1","0","0","0","0","0","1","0","0","0","0","0","0","0","1","0","1","1","0","0","0","0","1"
"Al Aḩmadī","29.07694","48.08389","3","0","0","0","0","0","3","0","0","2","1","3","1","2","0","0","3","3","0","0","0","0","3"
"Al Ain City","24.19167","55.76056","4","0","0","0","0","0","4","1","2","0","0","3","3","1","0","0","4","2","0","2","0","0","4"
"Alajuela","10.01625","-84.21163","3","0","0","0","0","0","3","1","1","0","0","2","1","1","1","0","3","2","1","0","0","0","3"
"Alanya","36.54375","31.99982","1","0","0","0","0","0","1","0","0","0","0","0","1","0","0","0","1","0","0","1","0","0","1"
"Alappuzha","9.49004","76.3264","3","0","0","0","0","0","3","2","0","0","0","2","0","0","3","0","3","0","0","3","0","0","3"
"Alaverdi","41.09766","44.67316","1","0","0","0","0","0","1","1","0","0","0","1","0","0","1","0","1","0","0","1","0","0","1"
"Al ‘Azīzīyah","32.53194","13.0175","1","0","0","0","0","0","1","0","1","0","0","1","0","1","0","0","1","1","0","0","0","0","1"
"Al ‘Azīzīyah","32.90941","45.06359","1","0","0","0","0","0","1","0","1","0","0","1","0","1","0","0","1","1","0","0","0","0","1"
"Al Azraq ash Shamālī","31.88209","36.83017","1","0","0","0","0","0","1","0","0","0","0","0","0","1","0","0","1","1","0","0","0","0","1"
"Albacete","38.99424","-1.85643","0","0","0","0","0","0","1","0","0","0","0","0","0","0","1","0","1","0","0","0","0","1","1"
"Al Bahah","20.01288","41.46767","5","0","0","0","0","0","5","0","3","0","0","3","4","1","0","0","5","4","0","0","0","1","5"
"Alba Iulia","46.06667","23.58333","1","0","0","0","0","0","1","1","0","0","0","1","0","0","1","0","1","1","0","0","0","0","1"
"Albany","44.63651","-123.10593","1","0","0","0","0","0","1","0","1","0","0","1","1","0","0","0","1","0","0","1","0","0","1"
"Albany","37.88687","-122.29775","1","0","0","0","0","0","1","0","1","0","0","1","1","0","0","0","1","0","0","1","0","0","1"
"Albany","32.72345","-99.2973","1","0","0","0","0","0","1","0","1","0","0","1","1","0","0","0","1","0","0","1","0","0","1"
"Albany","45.62996","-94.57","1","0","0","0","0","0","1","0","1","0","0","1","1","0","0","0","1","0","0","1","0","0","1"
"Albany","40.24861","-94.33107","1","0","0","0","0","0","1","0","1","0","0","1","1","0","0","0","1","0","0","1","0","0","1"
"Albany","39.22334","-94.11328","1","0","0","0","0","0","1","0","1","0","0","1","1","0","0","0","1","0","0","1","0","0","1"
"Albany","30.50436","-90.58231","1","0","0","0","0","0","1","0","1","0","0","1","1","0","0","0","1","0","0","1","0","0","1"
"Albany","41.78947","-90.21929","1","0","0","0","0","0","1","0","1","0","0","1","1","0","0","0","1","0","0","1","0","0","1"
"Albany","42.70778","-89.43706","1","0","0","0","0","0","1","0","1","0","0","1","1","0","0","0","1","0","0","1","0","0","1"
"Albany","40.30088","-85.24191","1","0","0","0","0","0","1","0","1","0","0","1","1","0","0","0","1","0","0","1","0","0","1"
"Albany","36.6909","-85.13468","1","0","0","0","0","0","1","0","1","0","0","1","1","0","0","0","1","0","0","1","0","0","1"
"Albany","31.57851","-84.15574","1","0","0","0","0","0","1","0","1","0","0","1","1","0","0","0","1","0","0","1","0","0","1"
"Albany","39.22757","-82.20237","1","0","0","0","0","0","1","0","1","0","0","1","1","0","0","0","1","0","0","1","0","0","1"
"Albany","42.65258","-73.75623","1","0","0","0","0","0","1","0","1","0","0","1","1","0","0","0","1","0","0","1","0","0","1"
"Albany","43.95785","-71.16757","1","0","0","0","0","0","1","0","1","0","0","1","1","0","0","0","1","0","0","1","0","0","1"
"Albany","-35.02692","117.88369","1","0","0","0","0","0","1","0","1","0","0","1","1","0","0","0","1","0","0","1","0","0","1"
"Al Başrah al Qadīmah","30.50316","47.81507","1","0","0","0","0","0","1","0","0","0","0","0","1","0","0","0","1","1","0","0","0","0","1"
"Al Bayḑā’","32.76272","21.75506","3","0","0","0","0","0","3","0","1","0","0","1","1","1","1","0","3","0","0","2","1","0","3"
"Albersdorf","54.15","9.28333","1","0","0","0","0","0","1","0","0","0","0","0","0","1","0","0","1","0","0","1","0","0","1"
"Albersdorf","50.9033","11.77297","1","0","0","0","0","0","1","0","0","0","0","0","0","1","0","0","1","0","0","1","0","0","1"
"Albersdorf","47.12166","15.69826","1","0","0","0","0","0","1","0","0","0","0","0","0","1","0","0","1","0","0","1","0","0","1"
"Albertina","-34.20544","21.58001","4","0","0","0","0","0","4","1","1","0","0","2","3","0","0","0","3","1","0","2","0","1","4"
"Alberton","46.81685","-64.06542","2","0","0","0","0","0","2","1","1","0","0","2","1","0","1","0","2","1","0","1","0","0","2"
"Alberton","-26.26786","28.12225","2","0","0","0","0","0","2","1","1","0","0","2","1","0","1","0","2","1","0","1","0","0","2"
"Alberton","-34.85925","138.52138","2","0","0","0","0","0","2","1","1","0","0","2","1","0","1","0","2","1","0","1","0","0","2"
"Alberton","-27.7","153.25","2","0","0","0","0","0","2","1","1","0","0","2","1","0","1","0","2","1","0","1","0","0","2"
"Albignasego","45.34705","11.86781","0","1","0","0","0","0","1","1","0","0","0","1","0","0","1","0","1","0","1","0","0","0","1"
"Albrighton","52.6364","-2.27966","1","0","0","0","0","0","1","0","1","0","0","1","0","0","1","0","1","0","0","0","0","1","1"
"Albstadt","48.21644","9.02596","1","0","0","0","0","0","1","0","1","0","0","1","1","0","0","0","1","0","0","1","0","0","1"
"Albufeira","37.08819","-8.2503","1","0","0","0","0","0","1","0","0","0","0","0","0","1","0","0","1","1","0","0","0","0","1"
"Albuquerque","35.08449","-106.65114","0","1","0","0","0","0","1","0","0","1","0","1","1","0","0","0","1","0","0","1","0","0","1"
"Al Burayj","31.43944","34.40306","1","0","0","0","0","0","1","0","0","0","0","0","1","0","0","0","1","0","0","1","0","0","1"
"Alcester","43.02138","-96.63087","0","1","0","0","1","0","4","1","2","1","0","4","0","0","4","0","4","1","1","2","0","0","4"
"Alcester","52.21667","-1.86667","0","1","0","0","1","0","4","1","2","1","0","4","0","0","4","0","4","1","1","2","0","0","4"
"Aldbourne","51.48098","-1.61827","1","0","0","0","0","0","1","0","1","0","0","1","1","0","0","0","1","0","0","1","0","0","1"
"Alderley Edge","53.30393","-2.23773","1","0","0","1","0","0","3","1","1","1","0","3","0","0","3","0","3","1","0","2","0","0","3"
"Aldershot","51.24827","-0.76389","10","0","0","0","1","0","12","2","6","3","0","11","4","4","4","0","12","5","4","3","0","0","12"
"Aldershot","-25.46312","152.66348","10","0","0","0","1","0","12","2","6","3","0","11","4","4","4","0","12","5","4","3","0","0","12"
"Alebtong","2.24472","33.25472","1","0","0","0","0","0","1","0","0","1","0","1","0","0","1","0","1","0","0","1","0","0","1"
"Além Paraíba","-21.88778","-42.70444","1","0","0","0","0","0","1","1","0","0","0","1","0","0","1","0","1","0","1","0","0","0","1"
"Aleppo","36.20124","37.16117","1","0","0","0","1","0","2","0","1","0","1","2","0","2","0","0","2","2","0","0","0","0","2"
"Alessandria","44.90924","8.61007","1","0","0","0","0","0","2","0","0","0","0","0","0","1","1","0","2","2","0","0","0","0","2"
"Ålesund","62.47225","6.15492","1","0","0","0","0","0","1","0","1","0","0","1","0","1","0","0","1","1","0","0","0","0","1"
"Alexandria","43.65359","-97.78285","44","1","0","1","4","0","50","14","11","6","5","36","21","18","11","0","50","13","6","21","6","2","48"
"Alexandria","45.88524","-95.37754","44","1","0","1","4","0","50","14","11","6","5","36","21","18","11","0","50","13","6","21","6","2","48"
"Alexandria","31.31129","-92.44514","44","1","0","1","4","0","50","14","11","6","5","36","21","18","11","0","50","13","6","21","6","2","48"
"Alexandria","36.07756","-86.03332","44","1","0","1","4","0","50","14","11","6","5","36","21","18","11","0","50","13","6","21","6","2","48"
"Alexandria","33.77399","-85.88552","44","1","0","1","4","0","50","14","11","6","5","36","21","18","11","0","50","13","6","21","6","2","48"
"Alexandria","40.26282","-85.67581","44","1","0","1","4","0","50","14","11","6","5","36","21","18","11","0","50","13","6","21","6","2","48"
"Alexandria","38.95951","-84.38799","44","1","0","1","4","0","50","14","11","6","5","36","21","18","11","0","50","13","6","21","6","2","48"
"Alexandria","40.08895","-82.61239","44","1","0","1","4","0","50","14","11","6","5","36","21","18","11","0","50","13","6","21","6","2","48"
"Alexandria","18.30768","-77.35335","44","1","0","1","4","0","50","14","11","6","5","36","21","18","11","0","50","13","6","21","6","2","48"
"Alexandria","38.80484","-77.04692","44","1","0","1","4","0","50","14","11","6","5","36","21","18","11","0","50","13","6","21","6","2","48"
"Alexandria","43.61146","-71.79286","44","1","0","1","4","0","50","14","11","6","5","36","21","18","11","0","50","13","6","21","6","2","48"
"Alexandria","-6.4125","-38.01583","44","1","0","1","4","0","50","14","11","6","5","36","21","18","11","0","50","13","6","21","6","2","48"
"Alexandria","55.99379","-4.5864","44","1","0","1","4","0","50","14","11","6","5","36","21","18","11","0","50","13","6","21","6","2","48"
"Alexandria","43.98333","25.33333","44","1","0","1","4","0","50","14","11","6","5","36","21","18","11","0","50","13","6","21","6","2","48"
"Alexandria","31.20176","29.91582","44","1","0","1","4","0","50","14","11","6","5","36","21","18","11","0","50","13","6","21","6","2","48"
"Alexandria","-33.89989","151.19951","44","1","0","1","4","0","50","14","11","6","5","36","21","18","11","0","50","13","6","21","6","2","48"
"Al Fallūjah","33.34913","43.78599","2","0","0","0","0","0","2","1","1","0","0","2","0","2","0","0","2","1","0","1","0","0","2"
"Al Fandaqūmīyah","32.3206","35.20329","1","0","0","0","0","0","1","0","0","0","1","1","1","0","0","0","1","0","0","1","0","0","1"
"Al Farwānīyah","29.2775","47.95861","9","2","0","0","0","0","11","2","7","0","1","10","6","2","2","1","11","8","2","1","0","0","11"
"Al Fashn","28.82431","30.89948","1","0","0","0","0","0","1","1","0","0","0","1","0","0","1","0","1","0","0","1","0","0","1"
"Al Fayyūm","29.30995","30.8418","2","0","0","0","0","0","3","2","1","0","0","3","1","1","1","0","3","0","0","2","1","0","3"
"Al Finţās","29.17389","48.12111","2","0","0","0","0","0","2","0","2","0","0","2","1","0","1","0","2","1","0","1","0","0","2"
"Alfredo Baquerizo Moreno","-1.91667","-79.51667","3","1","0","0","0","0","4","0","2","0","0","2","0","4","0","0","4","1","2","1","0","0","4"
"Alfredo Chaves","-20.635","-40.74972","1","0","0","0","0","0","1","0","0","1","0","1","0","0","1","0","1","0","0","1","0","0","1"
"Alfreton","53.09766","-1.38376","9","0","0","1","1","0","11","1","7","1","0","9","3","1","7","0","11","5","3","3","0","0","11"
"Al Fujairah City","25.11641","56.34141","3","0","0","0","0","0","3","0","1","0","0","1","1","1","0","1","3","2","0","0","0","1","3"
"Algeciras","2.52385","-75.31733","1","0","0","0","0","0","1","0","0","0","1","1","0","0","0","1","1","0","0","1","0","0","1"
"Algeciras","36.13326","-5.45051","1","0","0","0","0","0","1","0","0","0","1","1","0","0","0","1","1","0","0","1","0","0","1"
"Algeciras","11.4154","120.8168","1","0","0","0","0","0","1","0","0","0","1","1","0","0","0","1","1","0","0","1","0","0","1"
"Al Ghuwayrīyah","25.82882","51.24567","1","0","0","0","0","0","1","0","0","0","0","0","1","0","0","0","1","1","0","0","0","0","1"
"Algiers","36.73225","3.08746","31","2","0","0","0","0","33","12","10","8","1","31","14","4","15","0","33","9","10","13","1","0","33"
"Al Hadā","21.35903","40.2803","1","0","0","0","0","0","1","0","1","0","0","1","0","0","1","0","1","1","0","0","0","0","1"
"Al Ḩadd","26.24556","50.65417","1","0","0","0","0","0","1","1","0","0","0","1","1","0","0","0","1","0","0","1","0","0","1"
"Al Ḩaqlānīyah","34.08599","42.36174","1","0","0","0","0","0","1","0","1","0","0","1","0","1","0","0","1","1","0","0","0","0","1"
"Al Hārithah","30.58481","47.76114","1","0","0","0","0","0","1","1","0","0","0","1","1","0","0","0","1","0","0","0","0","0","0"
"Al Hāshimīyah","32.46392","35.21938","0","0","0","0","0","0","0","0","0","0","0","0","0","0","0","0","0","0","0","0","0","0","0"
"Al Hāshimīyah","32.12901","36.1213","0","0","0","0","0","0","0","0","0","0","0","0","0","0","0","0","0","0","0","0","0","0","0"
"Al Hāshimīyah","32.36351","44.66011","0","0","0","0","0","0","0","0","0","0","0","0","0","0","0","0","0","0","0","0","0","0","0"
"Al Ḩillah","32.46367","44.41963","8","0","0","1","0","0","9","3","2","4","0","9","4","1","4","0","9","2","1","6","0","0","9"
"Al Hufūf","25.36467","49.58764","10","0","0","0","0","0","10","0","2","2","2","6","5","4","0","1","10","6","0","3","0","1","10"
"Aliabad","41.4829","46.63483","3","0","0","0","0","0","3","0","3","0","0","3","0","2","1","0","3","0","0","0","0","3","3"
"Aliabad","36.52115","68.89985","3","0","0","0","0","0","3","0","3","0","0","3","0","2","1","0","3","0","0","0","0","3","3"
"Aliabad","36.30703","74.61545","3","0","0","0","0","0","3","0","3","0","0","3","0","2","1","0","3","0","0","0","0","3","3"
"Al Ibrāhīmīyah","30.71877","31.56299","2","0","0","0","0","0","2","2","0","0","0","2","1","0","1","0","2","0","0","2","0","0","2"
"Alicante","38.34517","-0.48149","1","0","0","0","0","0","1","0","0","0","0","0","1","0","0","0","1","0","0","0","0","1","1"
"Alicante","10.89704","123.0185","1","0","0","0","0","0","1","0","0","0","0","0","1","0","0","0","1","0","0","0","0","1","1"
"Alīgarh","27.88145","78.07464","2","0","0","0","0","0","2","2","0","0","0","2","1","0","1","0","2","0","0","2","0","0","2"
"Aliko","39.85861","20.07917","0","1","0","0","0","0","1","0","0","0","0","0","0","1","0","0","1","1","0","0","0","0","1"
"Alipur","29.38242","70.91106","0","1","0","0","0","0","1","1","0","0","0","1","0","1","0","0","1","0","0","1","0","0","1"
"'Ali Sabieh","11.15583","42.7125","1","0","0","0","0","0","1","1","0","0","0","1","1","0","0","0","1","0","0","1","0","0","1"
"Alizai","33.53613","70.34607","2","0","0","0","0","0","2","1","1","0","0","2","1","1","0","0","2","1","0","0","0","0","1"
"Al Jabāyish","30.96588","47.00196","5","0","0","0","0","0","5","0","0","5","0","5","5","0","0","0","5","0","0","5","0","0","5"
"Al Jahrā’","29.3375","47.65806","2","0","0","0","0","0","2","1","0","0","0","1","2","0","0","0","2","1","0","1","0","0","2"
"Al Jammālīyah","31.18065","31.86497","1","0","0","0","0","0","1","1","0","0","0","1","1","0","0","0","1","0","0","1","0","0","1"
"Aljmaš","45.52889","18.95056","1","0","0","0","0","0","1","0","0","0","0","0","1","0","0","0","1","0","0","0","0","1","1"
"Al Jubayhah","32.01071","35.89802","1","0","0","0","0","0","1","1","0","0","0","1","0","0","1","0","1","1","0","0","0","0","1"
"Al Jubayl","27.0174","49.62251","1","0","0","0","0","0","1","0","0","0","0","0","1","0","0","0","1","0","0","1","0","0","1"
"Al Jubayl","25.4","49.65","1","0","0","0","0","0","1","0","0","0","0","0","1","0","0","0","1","0","0","1","0","0","1"
"Al Khafjī","28.43905","48.49132","3","0","0","0","0","0","3","0","3","0","0","3","1","2","0","0","3","1","0","1","0","1","3"
"Al Khāliş","33.85118","44.52047","2","0","0","0","0","0","2","2","0","0","0","2","0","0","0","2","2","0","2","0","0","0","2"
"Al Khānkah","30.21035","31.36812","6","0","0","0","0","0","6","6","0","0","0","6","0","0","6","0","6","0","0","6","0","0","6"
"Al Khawr","25.68389","51.50583","1","0","0","0","0","0","1","0","0","0","0","0","0","1","0","0","1","0","0","0","0","1","1"
"Al Khums","32.64861","14.26191","1","0","0","0","0","0","1","0","1","0","0","1","0","0","0","1","1","0","0","1","0","0","1"
"Allahābād","25.44478","81.84322","1","0","0","0","0","0","1","1","0","0","0","1","0","0","1","0","1","0","0","1","0","0","1"
"Allanton","55.79945","-3.83492","0","0","0","0","0","0","2","0","0","1","1","2","1","0","1","0","2","1","1","0","0","0","2"
"Allanton","55.78333","-2.21667","0","0","0","0","0","0","2","0","0","1","1","2","1","0","1","0","2","1","1","0","0","0","2"
"Allkaj","40.8575","19.75528","2","0","0","0","0","0","2","1","0","1","0","2","1","0","1","0","2","0","0","2","0","0","2"
"Alloa","56.11586","-3.78997","2","0","0","0","1","0","3","1","0","2","0","3","1","1","1","0","3","0","0","3","0","0","3"
"Almada","38.67902","-9.1569","3","0","0","0","0","0","3","1","0","0","1","2","0","1","2","0","3","0","0","2","0","1","3"
"Al Madīnah","30.96324","47.26998","2","0","0","0","0","0","2","2","0","0","0","2","0","0","2","0","2","0","0","2","0","0","2"
"Al Maḩallah al Kubrá","30.97063","31.1669","4","0","0","0","1","0","5","1","1","1","0","3","3","2","0","0","5","1","1","1","1","1","5"
"Al Maḩāwīl","32.66138","44.40854","1","0","0","0","0","0","1","1","0","0","0","1","0","0","1","0","1","0","0","0","0","0","0"
"Al Majāridah","19.12361","41.91111","1","0","0","0","0","0","1","0","1","0","0","1","0","0","0","0","0","1","0","0","0","0","1"
"Al Majd","31.48095","34.95063","1","0","0","0","0","0","1","0","1","0","0","1","1","0","0","0","1","0","0","1","0","0","1"
"Al Manqaf","29.09611","48.13278","1","0","0","0","0","0","1","0","1","0","0","1","0","0","1","0","1","1","0","0","0","0","1"
"Al Manşūrah","31.03637","31.38069","10","0","0","0","0","0","10","2","4","2","0","8","2","4","4","0","10","5","1","3","0","1","10"
"Al Manşūrah","35.83917","38.74288","10","0","0","0","0","0","10","2","4","2","0","8","2","4","4","0","10","5","1","3","0","1","10"
"Al Manşūrah","12.86019","44.98166","10","0","0","0","0","0","10","2","4","2","0","8","2","4","4","0","10","5","1","3","0","1","10"
"Al Marsá","36.87818","10.32466","2","0","0","0","0","0","3","1","0","0","0","1","0","1","2","0","3","1","0","2","0","0","3"
"Almaty","43.25667","76.92861","2","0","0","0","0","0","2","0","0","0","0","0","0","1","1","0","2","0","0","2","0","0","2"
"Al Mawşil al Jadīdah","36.33271","43.10555","1","1","0","0","0","0","2","0","0","2","0","2","1","1","0","0","2","0","0","0","1","1","2"
"Al Mazra‘ah","32.78398","36.47695","1","0","0","0","0","0","1","1","0","0","0","1","0","0","1","0","1","0","0","1","0","0","1"
"Almere Stad","52.37025","5.21413","0","1","0","0","0","0","1","1","0","0","0","1","0","0","1","0","1","0","0","1","0","0","1"
"Al Minyā","28.09193","30.75813","3","0","0","0","0","0","3","1","0","1","1","3","1","0","1","1","3","1","0","2","0","0","3"
"Al Muharraq","26.25722","50.61194","2","0","0","0","1","0","3","0","1","0","1","2","3","0","0","0","3","2","0","1","0","0","3"
"Al Musayyib","32.77872","44.29005","3","1","0","0","0","0","4","2","1","1","0","4","1","2","1","0","4","2","0","1","0","0","3"
"Al Muzayrīb","32.71084","36.02751","0","1","0","0","0","0","1","0","1","0","0","1","0","1","0","0","1","1","0","0","0","0","1"
"Alness","57.69596","-4.2551","2","0","0","0","0","0","2","1","0","1","0","2","2","0","0","0","2","0","2","0","0","0","2"
"Alnmouth","55.4","-1.6","7","0","0","0","0","0","7","2","2","3","0","7","0","1","6","0","7","1","3","3","0","0","7"
"Alnwick","55.41318","-1.70563","7","0","0","0","0","0","8","3","1","2","0","6","1","2","5","0","8","0","4","3","0","1","8"
"Alor Gajah","2.3804","102.2089","3","0","0","0","0","0","3","1","0","2","0","3","2","0","1","0","3","1","0","2","0","0","3"
"Alor Setar","6.12104","100.36014","7","0","0","1","0","0","8","4","2","0","0","6","3","3","2","0","8","5","1","2","0","0","8"
"Alpharetta","34.07538","-84.29409","1","0","0","0","0","0","1","0","1","0","0","1","0","0","1","0","1","0","0","1","0","0","1"
"Alpington","52.56728","1.38229","7","0","0","0","2","0","11","1","2","4","2","9","4","2","5","0","11","4","5","2","0","0","11"
"Alpurai","34.92039","72.63265","1","1","0","0","0","0","2","2","0","0","0","2","2","0","0","0","2","0","0","2","0","0","2"
"Al Qanāţir al Khayrīyah","30.19327","31.13703","8","1","0","1","0","0","10","1","5","2","0","8","3","4","2","1","10","2","1","5","0","2","10"
"Al Qaţan","15.84056","48.45556","1","0","0","0","0","0","1","0","0","0","0","0","0","0","0","0","0","1","0","0","0","0","1"
"Al Qurayn","30.61618","31.73514","1","0","0","0","0","0","1","0","0","0","1","1","1","0","0","0","1","0","0","1","0","0","1"
"Al Qurayn","25.48333","49.6","1","0","0","0","0","0","1","0","0","0","1","1","1","0","0","0","1","0","0","1","0","0","1"
"Al Quşayr","26.10611","34.27716","1","0","0","0","0","0","1","1","0","0","0","1","1","0","0","0","1","0","0","0","0","1","1"
"Al Quşayr","34.5078","36.58029","1","0","0","0","0","0","1","1","0","0","0","1","1","0","0","0","1","0","0","0","0","1","1"
"Alresford","51.85389","1.00203","4","1","0","1","0","0","6","2","2","1","0","5","0","0","6","0","6","0","3","2","0","1","6"
"Alrewas","52.73278","-1.74968","2","0","0","0","0","0","2","0","1","1","0","2","1","0","1","0","2","0","2","0","0","0","2"
"Alsager","53.09617","-2.30649","2","0","0","0","0","0","2","0","0","2","0","2","0","0","2","0","2","0","2","0","0","0","2"
"Altamira","23.38173","-102.98674","1","1","0","0","0","0","2","2","0","0","0","2","1","0","1","0","2","0","0","2","0","0","2"
"Altamira","22.39215","-97.93867","1","1","0","0","0","0","2","2","0","0","0","2","1","0","1","0","2","0","0","2","0","0","2"
"Altamira","2.06278","-75.78722","1","1","0","0","0","0","2","2","0","0","0","2","1","0","1","0","2","0","0","2","0","0","2"
"Altamira","19.6773","-70.84428","1","1","0","0","0","0","2","2","0","0","0","2","1","0","1","0","2","0","0","2","0","0","2"
"Altamira","8.82359","-70.50244","1","1","0","0","0","0","2","2","0","0","0","2","1","0","1","0","2","0","0","2","0","0","2"
"Altamira","-3.20333","-52.20639","1","1","0","0","0","0","2","2","0","0","0","2","1","0","1","0","2","0","0","2","0","0","2"
"Altamonte Springs","28.66111","-81.36562","1","0","0","0","0","0","1","0","1","0","0","1","0","1","0","0","1","1","0","0","0","0","1"
"Altenbeken","51.76455","8.94201","1","0","0","0","0","0","1","0","0","1","0","1","0","1","0","0","1","0","0","1","0","0","1"
"Althorne","51.65722","0.76085","2","0","0","0","0","0","2","0","0","2","0","2","1","0","1","0","2","0","2","0","0","0","2"
"Alton","26.28729","-98.31335","8","0","0","0","0","0","8","2","1","3","0","6","2","0","6","0","8","0","5","3","0","0","8"
"Alton","42.98749","-96.01057","8","0","0","0","0","0","8","2","1","3","0","6","2","0","6","0","8","0","5","3","0","0","8"
"Alton","36.69423","-91.3993","8","0","0","0","0","0","8","2","1","3","0","6","2","0","6","0","8","0","5","3","0","0","8"
"Alton","38.8906","-90.18428","8","0","0","0","0","0","8","2","1","3","0","6","2","0","6","0","8","0","5","3","0","0","8"
"Alton","43.4523","-71.21757","8","0","0","0","0","0","8","2","1","3","0","6","2","0","6","0","8","0","5","3","0","0","8"
"Alton","45.03145","-68.72865","8","0","0","0","0","0","8","2","1","3","0","6","2","0","6","0","8","0","5","3","0","0","8"
"Alton","51.14931","-0.97469","8","0","0","0","0","0","8","2","1","3","0","6","2","0","6","0","8","0","5","3","0","0","8"
"Altrincham","53.38752","-2.34848","8","3","0","1","0","0","14","8","1","2","0","11","7","1","6","0","14","0","2","12","0","0","14"
"Alvechurch","52.35173","-1.96531","2","0","0","0","0","0","2","0","1","1","0","2","1","0","1","0","2","1","0","1","0","0","2"
"Alvor","37.12994","-8.59174","0","0","0","0","0","0","1","0","1","0","0","1","1","0","0","0","1","0","1","0","0","0","1"
"Al Wakrah","25.17151","51.60337","1","0","0","0","0","0","1","0","1","0","0","1","1","0","0","0","1","0","0","1","0","0","1"
"Alwar","27.56246","76.625","2","0","0","0","0","0","2","1","0","1","0","2","1","0","0","1","2","0","0","2","0","0","2"
"Al Wāsiţah","29.33778","31.20556","1","0","0","0","0","0","1","0","0","0","1","1","0","1","0","0","1","0","0","0","0","1","1"
"Amadora","38.75382","-9.23083","2","0","0","0","0","0","2","1","0","0","0","1","1","1","0","0","2","1","1","0","0","0","2"
"Amanalco de Becerra","19.25374","-100.0198","0","0","0","0","1","0","1","0","0","1","0","1","1","0","0","0","1","1","0","0","0","0","1"
"Amanalco de Becerra","19.31667","-100.01667","0","0","0","0","1","0","1","0","0","1","0","1","1","0","0","0","1","1","0","0","0","0","1"
"Amarpur","25.03967","86.90247","1","0","0","0","0","0","1","1","0","0","0","1","0","0","0","1","1","0","0","1","0","0","1"
"Amarpur","23.5257","91.65879","1","0","0","0","0","0","1","1","0","0","0","1","0","0","0","1","1","0","0","1","0","0","1"
"Amaury","-20.13083","57.65917","1","0","0","0","0","0","1","1","0","0","0","1","1","0","0","0","1","0","0","1","0","0","1"
"Ambājogāi","18.73312","76.38616","2","0","0","0","0","0","2","2","0","0","0","2","1","0","1","0","2","0","0","2","0","0","2"
"Ambato","-1.24908","-78.61675","1","0","0","0","0","0","1","0","1","0","0","1","1","0","0","0","1","1","0","0","0","0","1"
"Ambattūr","13.09818","80.16152","1","0","0","0","0","0","1","1","0","0","0","1","0","0","1","0","1","1","0","0","0","0","1"
"Ambikāpur","23.11892","83.19537","1","0","0","0","0","0","1","1","0","0","0","1","0","1","0","0","1","0","1","0","0","0","1"
"Ambleside","54.43261","-2.96167","2","0","0","0","0","0","2","0","1","0","0","1","0","1","1","0","2","1","1","0","0","0","2"
"Ambleside","-41.20316","146.37225","2","0","0","0","0","0","2","0","1","0","0","1","0","1","1","0","2","1","1","0","0","0","2"
"Amersham","51.66667","-0.61667","4","0","0","0","0","0","5","1","1","2","0","4","2","1","2","0","5","0","1","4","0","0","5"
"Amersham on the Hill","51.67468","-0.60742","3","0","0","0","0","0","4","0","1","2","0","3","1","0","3","0","4","0","0","4","0","0","4"
"Ames","31.52099","-97.77947","1","0","0","0","0","0","1","0","0","0","0","0","0","1","0","0","1","0","0","1","0","0","1"
"Ames","30.05383","-94.74353","1","0","0","0","0","0","1","0","0","0","0","0","0","1","0","0","1","0","0","1","0","0","1"
"Ames","42.03471","-93.61994","1","0","0","0","0","0","1","0","0","0","0","0","0","1","0","0","1","0","0","1","0","0","1"
"Ames","50.54079","2.41512","1","0","0","0","0","0","1","0","0","0","0","0","0","1","0","0","1","0","0","1","0","0","1"
"Amesbury","42.85842","-70.93005","1","0","0","0","0","0","1","0","1","0","0","1","0","0","1","0","1","0","0","1","0","0","1"
"Amesbury","51.17509","-1.78064","1","0","0","0","0","0","1","0","1","0","0","1","0","0","1","0","1","0","0","1","0","0","1"
"Amioûn","34.3","35.80889","1","0","0","0","0","0","1","0","0","0","0","0","0","0","1","0","1","1","0","0","0","0","1"
"Amlwch","53.40986","-4.34712","1","0","0","0","0","0","1","0","0","1","0","1","0","0","1","0","1","0","0","1","0","0","1"
"Amman","31.95522","35.94503","48","1","0","0","0","0","49","28","4","11","1","44","13","13","22","1","49","13","13","20","0","3","49"
"Ammanford","51.79279","-3.98833","5","1","0","0","0","0","7","1","4","2","0","7","4","0","3","0","7","1","3","3","0","0","7"
"Ampang","3.15","101.76667","3","0","0","0","0","0","3","2","1","0","0","3","2","0","1","0","3","0","0","3","0","0","3"
"Ampara","7.29754","81.68202","9","0","0","0","0","0","9","7","0","0","0","7","3","3","3","1","10","0","1","7","0","1","9"
"Ampelókipoi","40.46582","21.31001","1","0","0","0","0","0","1","0","1","0","0","1","0","0","1","0","1","0","0","0","0","1","1"
"Ampelókipoi","40.65304","22.92624","1","0","0","0","0","0","1","0","1","0","0","1","0","0","1","0","1","0","0","0","0","1","1"
"Ampleforth","54.19956","-1.10691","1","0","0","0","0","0","1","0","0","1","0","1","0","0","1","0","1","0","0","1","0","0","1"
"Ampthill","52.02694","-0.49567","5","0","0","0","1","0","6","1","1","4","0","6","3","2","1","0","6","0","0","6","0","0","6"
"Amrāvati","20.93333","77.75","1","0","0","0","0","0","1","1","0","0","0","1","1","0","0","0","1","0","0","1","0","0","1"
"Amritsar","31.62234","74.87534","5","0","0","0","1","0","6","5","0","0","1","6","2","0","3","1","6","0","0","6","0","0","6"
"Amsterdam","39.95757","-82.37821","12","1","1","1","0","0","17","2","1","7","1","11","2","7","7","1","17","2","3","9","0","8","22"
"Amsterdam","42.93869","-74.18819","12","1","1","1","0","0","17","2","1","7","1","11","2","7","7","1","17","2","3","9","0","8","22"
"Amsterdam","52.37403","4.88969","12","1","1","1","0","0","17","2","1","7","1","11","2","7","7","1","17","2","3","9","0","8","22"
"Amsterdam-Zuidoost","52.3075","4.97222","0","0","0","0","0","0","1","1","0","0","0","1","0","1","0","0","1","0","0","1","0","0","1"
"Anand","22.55251","72.9552","1","1","0","0","0","0","2","2","0","0","0","2","0","1","0","1","2","0","0","1","1","0","2"
"Anantapur","14.67784","77.60813","3","0","0","0","0","0","3","3","0","0","0","3","1","0","2","0","3","0","0","3","0","0","3"
"Anantnag","33.73068","75.15418","2","0","0","0","0","0","2","2","0","0","0","2","1","0","1","0","2","0","1","1","0","0","2"
"Anchau","10.96245","8.39233","1","0","0","0","0","0","1","0","1","0","0","1","0","0","0","0","0","0","0","0","0","0","0"
"Ancón","8.96015","-79.5514","1","0","0","0","0","0","1","0","1","0","0","1","1","0","0","0","1","1","0","0","0","0","1"
"Andong","30.26823","121.21582","0","0","0","0","0","0","1","0","0","0","1","1","0","1","0","0","1","1","0","0","0","0","1"
"Andong","36.56636","128.72275","0","0","0","0","0","0","1","0","0","0","1","1","0","1","0","0","1","1","0","0","0","0","1"
"Andorra la Vella","42.50779","1.52109","1","0","0","0","0","0","1","0","1","0","0","1","0","0","1","0","1","0","0","1","0","0","1"
"Andoung Meas","13.86724","107.29682","2","0","0","0","0","0","2","1","0","0","0","1","1","1","0","0","2","1","0","1","0","0","2"
"Andover","37.7139","-97.13643","7","0","0","2","1","0","12","4","1","4","0","9","5","0","7","0","12","0","2","9","0","1","12"
"Andover","45.2333","-93.29134","7","0","0","2","1","0","12","4","1","4","0","9","5","0","7","0","12","0","2","9","0","1","12"
"Andover","41.29392","-90.29207","7","0","0","2","1","0","12","4","1","4","0","9","5","0","7","0","12","0","2","9","0","1","12"
"Andover","41.60672","-80.5723","7","0","0","2","1","0","12","4","1","4","0","9","5","0","7","0","12","0","2","9","0","1","12"
"Andover","25.96843","-80.21283","7","0","0","2","1","0","12","4","1","4","0","9","5","0","7","0","12","0","2","9","0","1","12"
"Andover","42.15646","-77.79555","7","0","0","2","1","0","12","4","1","4","0","9","5","0","7","0","12","0","2","9","0","1","12"
"Andover","40.98593","-74.74211","7","0","0","2","1","0","12","4","1","4","0","9","5","0","7","0","12","0","2","9","0","1","12"
"Andover","43.43702","-71.82341","7","0","0","2","1","0","12","4","1","4","0","9","5","0","7","0","12","0","2","9","0","1","12"
"Andover","42.65843","-71.137","7","0","0","2","1","0","12","4","1","4","0","9","5","0","7","0","12","0","2","9","0","1","12"
"Andover","44.63562","-70.75118","7","0","0","2","1","0","12","4","1","4","0","9","5","0","7","0","12","0","2","9","0","1","12"
"Andover","51.21135","-1.49393","7","0","0","2","1","0","12","4","1","4","0","9","5","0","7","0","12","0","2","9","0","1","12"
"An Dương","20.86382","106.6133","1","0","0","0","0","0","1","0","1","0","0","1","1","0","0","0","1","0","0","0","0","1","1"
"Angarsk","52.53667","103.88639","1","0","0","0","0","0","1","1","0","0","0","1","0","0","1","0","1","0","1","0","0","0","1"
"Angeles City","15.15","120.58333","2","0","0","0","0","0","2","1","0","1","0","2","1","0","1","0","2","0","1","1","0","0","2"
"Ängelholm","56.2428","12.86219","1","0","0","0","0","0","1","0","1","0","0","1","0","0","0","0","0","0","0","1","0","0","1"
"Angol","-37.79519","-72.71636","1","0","0","0","0","0","1","0","0","0","0","0","0","1","0","0","1","1","0","0","0","0","1"
"Angri","40.73815","14.5707","1","0","0","0","0","0","1","1","0","0","0","1","0","0","1","0","1","0","0","1","0","0","1"
"Angul","20.84089","85.10192","1","0","0","0","0","0","1","0","0","1","0","1","1","0","0","0","1","0","1","0","0","0","1"
"Ankara","39.91987","32.85427","29","0","0","0","1","0","31","12","9","3","0","24","11","6","13","1","31","10","3","14","3","1","31"
"Ankeny","41.72971","-93.60577","1","0","0","0","0","0","1","0","0","0","0","0","0","0","1","0","1","0","0","1","0","0","1"
"Annaba","36.9","7.76667","5","0","0","0","0","0","6","3","1","1","0","5","0","2","4","0","6","1","1","3","0","1","6"
"Annacotty","52.66768","-8.53121","1","0","0","0","0","0","1","0","1","0","0","1","0","0","1","0","1","0","0","1","0","0","1"
"An Najd","14.42152","45.29596","1","0","0","0","0","0","1","0","1","0","0","1","0","1","0","0","1","0","0","0","1","0","1"
"Annandale","45.26274","-94.12443","1","0","0","0","0","0","1","0","0","1","0","1","0","0","1","0","1","0","0","1","0","0","1"
"Annandale","38.83039","-77.19637","1","0","0","0","0","0","1","0","0","1","0","1","0","0","1","0","1","0","0","1","0","0","1"
"Annandale","40.64093","-74.88128","1","0","0","0","0","0","1","0","0","1","0","1","0","0","1","0","1","0","0","1","0","0","1"
"Annandale","-19.31503","146.79069","1","0","0","0","0","0","1","0","0","1","0","1","0","0","1","0","1","0","0","1","0","0","1"
"Annandale","-33.88333","151.16667","1","0","0","0","0","0","1","0","0","1","0","1","0","0","1","0","1","0","0","1","0","0","1"
"Annapolis","38.97859","-76.49184","1","0","0","0","0","0","1","0","0","0","0","0","0","0","1","0","1","0","1","0","0","0","1"
"Ann Arbor","42.27756","-83.74088","2","0","0","0","0","0","2","0","0","1","0","1","0","0","2","0","2","1","0","1","0","0","2"
"An Naşr","31.28137","34.30253","1","0","0","0","0","0","1","0","1","0","0","1","1","0","0","0","1","0","1","0","0","0","1"
"Annemasse","46.19439","6.23775","1","0","0","0","0","0","1","0","1","0","0","1","0","1","0","0","1","1","0","0","0","0","1"
"Anoixi","38.13267","23.85874","0","2","0","0","0","0","2","0","2","0","0","2","2","0","0","0","2","2","0","0","0","0","2"
"Antakya","36.20655","36.15722","1","0","0","0","0","0","1","1","0","0","0","1","0","1","0","0","1","0","1","0","0","0","1"
"Antalya","36.90812","30.69556","4","0","0","0","1","0","5","2","1","1","0","4","1","0","4","0","5","2","1","2","0","0","5"
"Antananarivo","-18.91368","47.53613","1","1","0","0","0","0","2","0","0","2","0","2","1","0","1","0","2","0","1","1","0","0","2"
"Antipolo","14.62578","121.12251","1","0","0","0","0","0","1","1","0","0","0","1","0","0","1","0","1","0","0","1","0","0","1"
"Antipolo","15.6181","121.19","1","0","0","0","0","0","1","1","0","0","0","1","0","0","1","0","1","0","0","1","0","0","1"
"Antipolo","10.3565","122.9646","1","0","0","0","0","0","1","1","0","0","0","1","0","0","1","0","1","0","0","1","0","0","1"
"Antipolo","13.5286","123.1622","1","0","0","0","0","0","1","1","0","0","0","1","0","0","1","0","1","0","0","1","0","0","1"
"Antipolo","13.3927","123.5231","1","0","0","0","0","0","1","1","0","0","0","1","0","0","1","0","1","0","0","1","0","0","1"
"Antipolo","11.16667","123.95","1","0","0","0","0","0","1","1","0","0","0","1","0","0","1","0","1","0","0","1","0","0","1"
"Antofagasta","-23.65236","-70.3954","2","0","0","0","0","0","2","1","0","1","0","2","1","0","1","0","2","1","0","1","0","0","2"
"Antoniny","49.80974","26.87714","1","0","0","0","0","0","1","1","0","0","0","1","0","0","1","0","1","0","0","1","0","0","1"
"Antrim","43.03091","-71.93897","3","0","0","0","0","0","3","0","2","1","0","3","3","0","0","0","3","1","1","1","0","0","3"
"Antrim","54.7","-6.2","3","0","0","0","0","0","3","0","2","1","0","3","3","0","0","0","3","1","1","1","0","0","3"
"Antwerpen","51.22047","4.40026","2","0","0","0","0","0","2","0","0","1","0","1","1","0","1","0","2","0","1","1","0","0","2"
"Apalachin","42.06952","-76.15465","1","0","0","0","0","0","1","0","0","0","0","0","0","0","1","0","1","0","1","0","0","0","1"
"Apalit","14.95333","120.77","1","0","0","0","0","0","1","1","0","0","0","1","0","0","1","0","1","0","0","1","0","0","1"
"Apeldoorn","52.21","5.96944","1","0","0","0","0","0","2","0","0","0","0","0","1","0","1","0","2","1","1","0","0","0","2"
"Apopa","13.80722","-89.17917","1","0","0","0","0","0","1","0","1","0","0","1","1","0","0","0","1","0","0","0","1","0","1"
"Apple Valley","34.50083","-117.18588","0","0","0","0","0","0","1","1","0","0","0","1","1","0","0","0","1","0","0","1","0","0","1"
"Apple Valley","37.08971","-113.12439","0","0","0","0","0","0","1","1","0","0","0","1","1","0","0","0","1","0","0","1","0","0","1"
"Apple Valley","44.73191","-93.21772","0","0","0","0","0","0","1","1","0","0","0","1","1","0","0","0","1","0","0","1","0","0","1"
"Apple Valley","40.4389","-82.35391","0","0","0","0","0","0","1","1","0","0","0","1","1","0","0","0","1","0","0","1","0","0","1"
"Appomattox","37.35709","-78.82529","1","0","0","0","0","0","1","0","0","0","0","0","1","0","0","0","1","1","0","0","0","0","1"
"Aprilia","41.59452","12.65419","1","0","0","0","0","0","1","0","0","0","0","0","0","1","0","0","1","1","0","0","0","0","1"
"Aqaba","29.52667","35.00778","2","0","0","0","0","0","2","1","0","1","0","2","0","1","1","0","2","1","1","0","0","0","2"
"Aquin","18.27974","-73.39433","1","0","0","0","0","0","1","0","0","0","0","0","0","1","0","0","1","1","0","0","0","0","1"
"Arad","46.18333","21.31667","2","0","0","1","0","0","3","1","2","0","0","3","2","0","0","1","3","1","0","2","0","0","3"
"Arad","31.25882","35.21282","2","0","0","1","0","0","3","1","2","0","0","3","2","0","0","1","3","1","0","2","0","0","3"
"Araguari","-18.64722","-48.18722","1","0","0","0","0","0","1","0","1","0","0","1","0","1","0","0","1","1","0","0","0","0","1"
"Aramango","-5.41639","-78.43583","1","0","0","0","0","0","1","1","0","0","0","1","1","0","0","0","1","0","0","1","0","0","1"
"Aranitas","40.59444","19.80667","1","0","0","0","0","0","1","0","1","0","0","1","0","1","0","0","1","0","0","0","0","1","1"
"Aranos","-24.13333","19.11667","1","0","0","0","0","0","1","0","1","0","0","1","1","0","0","0","1","0","0","1","0","0","1"
"Arar","30.97531","41.03808","2","0","0","0","0","0","2","0","2","0","0","2","1","1","0","0","2","2","0","0","0","0","2"
"Arba Minch","6.03333","37.55","0","0","0","0","0","0","0","0","0","0","0","0","0","0","0","0","0","0","0","0","0","0","0"
"Arbroath","56.56317","-2.58736","2","0","0","0","0","0","2","0","1","1","0","2","1","0","1","0","2","1","0","1","0","0","2"
"Ardee","53.85972","-6.54056","1","0","0","0","0","0","1","0","0","1","0","1","0","0","1","0","1","0","0","1","0","0","1"
"Arecibo","18.47245","-66.71573","1","0","0","0","0","0","1","0","0","0","0","0","0","0","1","0","1","1","0","0","0","0","1"
"Arendonk","51.32267","5.08289","1","0","0","0","0","0","1","1","0","0","0","1","0","0","1","0","1","0","0","1","0","0","1"
"Arequipa","-16.39889","-71.535","2","0","0","0","0","0","2","0","0","0","0","0","0","0","2","0","2","1","0","1","0","0","2"
"Århus","56.15674","10.21076","1","0","0","0","1","0","2","0","0","1","0","1","0","2","0","0","2","0","0","2","0","0","2"
"Ariana","36.86012","10.19337","2","1","0","1","1","0","5","2","1","1","0","4","0","2","2","1","5","1","2","2","0","0","5"
"Arifwala","30.29058","73.06574","2","0","0","0","0","0","2","1","0","0","1","2","2","0","0","0","2","0","0","1","0","1","2"
"Arima","10.63737","-61.28228","2","0","0","0","0","0","2","0","2","0","0","2","0","2","0","0","2","2","0","0","0","0","2"
"Arish","31.13159","33.79844","3","0","0","0","0","0","3","1","2","0","0","3","1","2","0","0","3","0","0","1","2","0","3"
"Arles","42.45654","2.63457","1","0","0","0","0","0","1","1","0","0","0","1","0","0","1","0","1","0","1","0","0","0","1"
"Arles","43.67681","4.63031","1","0","0","0","0","0","1","1","0","0","0","1","0","0","1","0","1","0","1","0","0","0","1"
"Arlesey","52.00713","-0.26565","0","0","0","0","0","0","1","0","0","1","0","1","0","1","0","0","1","0","1","0","0","0","1"
"Arlington","48.19871","-122.12514","2","0","0","0","0","0","2","0","0","2","0","2","0","1","1","0","2","0","1","1","0","0","2"
"Arlington","45.7168","-120.20088","2","0","0","0","0","0","2","0","0","2","0","2","0","1","1","0","2","0","1","1","0","0","2"
"Arlington","44.36441","-97.13312","2","0","0","0","0","0","2","0","0","2","0","2","0","1","1","0","2","0","1","1","0","0","2"
"Arlington","32.73569","-97.10807","2","0","0","0","0","0","2","0","0","2","0","2","0","1","1","0","2","0","1","1","0","0","2"
"Arlington","41.4525","-96.35113","2","0","0","0","0","0","2","0","0","2","0","2","0","1","1","0","2","0","1","1","0","0","2"
"Arlington","44.6083","-94.08053","2","0","0","0","0","0","2","0","0","2","0","2","0","1","1","0","2","0","1","1","0","0","2"
"Arlington","35.2962","-89.66147","2","0","0","0","0","0","2","0","0","2","0","2","0","1","1","0","2","0","1","1","0","0","2"
"Arlington","43.33804","-89.3804","2","0","0","0","0","0","2","0","0","2","0","2","0","1","1","0","2","0","1","1","0","0","2"
"Arlington","31.4399","-84.72492","2","0","0","0","0","0","2","0","0","2","0","2","0","1","1","0","2","0","1","1","0","0","2"
"Arlington","40.89366","-83.65021","2","0","0","0","0","0","2","0","0","2","0","2","0","1","1","0","2","0","1","1","0","0","2"
"Arlington","36.22736","-80.8334","2","0","0","0","0","0","2","0","0","2","0","2","0","1","1","0","2","0","1","1","0","0","2"
"Arlington","38.88101","-77.10428","2","0","0","0","0","0","2","0","0","2","0","2","0","1","1","0","2","0","1","1","0","0","2"
"Arlington","39.34857","-76.68324","2","0","0","0","0","0","2","0","0","2","0","2","0","1","1","0","2","0","1","1","0","0","2"
"Arlington","41.69593","-73.8968","2","0","0","0","0","0","2","0","0","2","0","2","0","1","1","0","2","0","1","1","0","0","2"
"Arlington","43.0748","-73.154","2","0","0","0","0","0","2","0","0","2","0","2","0","1","1","0","2","0","1","1","0","0","2"
"Arlington","42.41537","-71.15644","2","0","0","0","0","0","2","0","0","2","0","2","0","1","1","0","2","0","1","1","0","0","2"
"Arlington","51.75884","-1.83604","2","0","0","0","0","0","2","0","0","2","0","2","0","1","1","0","2","0","1","1","0","0","2"
"Arluno","45.50344","8.94222","1","0","0","0","0","0","1","0","1","0","0","1","0","0","1","0","1","0","0","1","0","0","1"
"Armagh","54.35","-6.66667","2","1","0","0","0","0","4","1","1","2","0","4","0","2","2","0","4","0","2","2","0","0","4"
"Ar Ramthā","32.55873","36.00816","1","0","0","0","0","0","1","0","0","0","1","1","0","0","1","0","1","1","0","0","0","0","1"
"Ar Rass","25.86944","43.4973","0","1","0","0","0","0","1","0","0","1","0","1","0","0","1","0","1","0","0","1","0","0","1"
"Ar Rayyān","25.29194","51.42444","3","1","0","0","1","0","5","2","3","0","0","5","0","2","3","0","5","3","1","0","1","0","5"
"Ar Rifā‘","26.13","50.555","1","0","0","0","1","0","2","1","0","0","1","2","0","2","0","0","2","1","0","1","0","0","2"
"Arris","35.25881","6.34706","1","0","0","0","0","0","1","0","0","0","0","0","0","0","1","0","1","1","0","0","0","0","1"
"Ar Rumaythah","31.52845","45.20377","1","0","0","0","0","0","1","1","0","0","0","1","0","1","0","0","1","1","0","0","0","0","1"
"Arua","3.02013","30.91105","1","0","0","0","0","0","1","1","0","0","0","1","0","0","1","0","1","0","0","1","0","1","2"
"Arundel","43.38259","-70.47783","5","0","0","0","0","0","5","2","0","1","0","3","3","0","2","0","5","1","3","1","0","0","5"
"Arundel","50.85423","-0.55393","5","0","0","0","0","0","5","2","0","1","0","3","3","0","2","0","5","1","3","1","0","0","5"
"Arundel","-27.93768","153.36302","5","0","0","0","0","0","5","2","0","1","0","3","3","0","2","0","5","1","3","1","0","0","5"
"Arusha","-3.36667","36.68333","8","3","0","0","0","0","11","3","4","0","3","10","8","1","0","0","9","2","0","3","1","5","11"
"Asaba","6.19824","6.73187","2","0","0","0","0","0","2","0","0","0","0","0","2","0","0","0","2","1","0","0","0","1","2"
"Ascot","51.41082","-0.6748","8","0","0","0","0","0","11","2","5","2","0","9","5","1","5","0","11","0","3","7","0","1","11"
"Ascot","-31.93818","115.92258","8","0","0","0","0","0","11","2","5","2","0","9","5","1","5","0","11","0","3","7","0","1","11"
"Ascot","-36.7","144.33333","8","0","0","0","0","0","11","2","5","2","0","9","5","1","5","0","11","0","3","7","0","1","11"
"Ascot","-27.43154","153.058","8","0","0","0","0","0","11","2","5","2","0","9","5","1","5","0","11","0","3","7","0","1","11"
"Asenovgrad","42.01667","24.86667","1","0","0","0","0","0","1","0","1","0","0","1","1","0","0","0","1","1","0","0","0","0","1"
"Ashbourne","53.51163","-6.39821","7","0","0","0","0","0","8","1","6","0","0","7","7","0","1","0","8","7","0","1","0","0","8"
"Ashbourne","53.01667","-1.73333","7","0","0","0","0","0","8","1","6","0","0","7","7","0","1","0","8","7","0","1","0","0","8"
"Ashby-de-la-Zouch","52.74632","-1.4732","1","0","0","0","0","0","1","0","0","1","0","1","0","0","1","0","1","0","0","1","0","0","1"
"Asheville","35.60095","-82.55402","0","0","0","0","0","0","1","0","1","0","0","1","1","0","0","0","1","0","0","1","0","0","1"
"Ashford","43.58694","-88.37066","27","2","0","2","1","0","33","5","13","15","0","33","11","5","16","1","33","6","11","15","0","1","33"
"Ashford","31.18296","-85.23632","27","2","0","2","1","0","33","5","13","15","0","33","11","5","16","1","33","6","11","15","0","1","33"
"Ashford","53.00833","-6.11139","27","2","0","2","1","0","33","5","13","15","0","33","11","5","16","1","33","6","11","15","0","1","33"
"Ashford","51.43173","-0.45761","27","2","0","2","1","0","33","5","13","15","0","33","11","5","16","1","33","6","11","15","0","1","33"
"Ashford","51.14648","0.87376","27","2","0","2","1","0","33","5","13","15","0","33","11","5","16","1","33","6","11","15","0","1","33"
"Ashford","-34.94859","138.57457","27","2","0","2","1","0","33","5","13","15","0","33","11","5","16","1","33","6","11","15","0","1","33"
"Ashford","-29.32191","151.09308","27","2","0","2","1","0","33","5","13","15","0","33","11","5","16","1","33","6","11","15","0","1","33"
"Ashington","55.17719","-1.56412","5","0","0","0","2","0","7","1","3","0","0","4","4","0","3","0","7","1","2","3","0","1","7"
"Ashington","50.93312","-0.39087","5","0","0","0","2","0","7","1","3","0","0","4","4","0","3","0","7","1","2","3","0","1","7"
"Ashmūn","30.29735","30.97641","3","0","0","0","0","0","3","0","0","0","0","0","1","1","1","0","3","0","0","1","1","1","3"
"Ash Shafā","21.07268","40.31842","1","0","0","0","0","0","1","1","0","0","0","1","1","0","0","0","1","0","1","0","0","0","1"
"Ashtarak","40.2991","44.36204","1","0","0","0","0","0","1","0","1","0","0","1","1","0","0","0","1","0","0","1","0","0","1"
"Ashtead","51.30873","-0.29972","4","1","0","0","0","0","5","1","1","2","0","4","1","0","4","0","5","0","1","3","0","1","5"
"Ashton-under-Lyne","53.48876","-2.0989","2","0","0","0","0","0","2","0","0","1","0","1","1","1","0","0","2","0","0","2","0","0","2"
"Askøy","60.4","5.18333","1","0","0","0","0","0","1","0","1","0","0","1","1","0","0","0","1","1","0","0","0","0","1"
"Asnières-sur-Seine","48.91667","2.28333","1","0","0","0","0","0","1","1","0","0","0","1","0","0","1","0","1","0","0","1","0","0","1"
"Aş Şaff","29.56472","31.28111","0","0","0","0","1","0","1","1","0","0","0","1","0","1","0","0","1","0","0","0","0","1","1"
"As Sālimīyah","29.33389","48.07611","2","0","0","0","0","0","2","0","1","0","0","1","0","1","0","0","1","2","0","0","0","0","2"
"As Sulaymānīyah","35.56496","45.4329","13","1","0","0","0","0","14","8","3","2","0","13","5","2","7","0","14","3","2","9","0","0","14"
"As Sulayyil","20.46067","45.57792","1","0","0","0","0","0","1","0","1","0","0","1","1","0","0","0","1","1","0","0","0","0","1"
"As Suwayq","23.84944","57.43861","0","0","0","0","0","0","0","0","0","0","0","0","0","0","0","0","0","0","0","0","0","0","0"
"Astley","52.76667","-2.7","1","0","0","0","0","0","1","1","0","0","0","1","1","0","0","0","1","0","0","1","0","0","1"
"Aston Clinton","51.8002","-0.7254","1","0","0","0","0","0","1","0","1","0","0","1","1","0","0","0","1","0","0","1","0","0","1"
"Astoria","46.18788","-123.83125","2","0","0","0","0","0","2","0","0","1","0","1","0","0","2","0","2","0","1","1","0","0","2"
"Astoria","40.22754","-90.35957","2","0","0","0","0","0","2","0","0","1","0","1","0","0","2","0","2","0","1","1","0","0","2"
"Astoria","40.77205","-73.93014","2","0","0","0","0","0","2","0","0","1","0","1","0","0","2","0","2","0","1","1","0","0","2"
"Asunción","-25.28646","-57.647","2","1","0","0","0","0","3","1","2","0","0","3","3","0","0","0","3","1","0","2","0","0","3"
"Aswan","24.09082","32.89942","5","1","0","0","2","0","8","1","3","2","0","6","1","7","0","0","8","3","2","2","0","1","8"
"Asyūţ","27.18096","31.18368","8","0","0","0","0","0","8","1","4","0","2","7","3","2","2","1","8","2","1","3","0","2","8"
"Athens","32.20487","-95.85552","56","3","0","0","2","0","62","10","17","10","1","38","14","19","28","1","62","25","9","23","3","2","62"
"Athens","45.03302","-90.07402","56","3","0","0","2","0","62","10","17","10","1","38","14","19","28","1","62","25","9","23","3","2","62"
"Athens","39.96088","-89.72399","56","3","0","0","2","0","62","10","17","10","1","38","14","19","28","1","62","25","9","23","3","2","62"
"Athens","34.80243","-86.97219","56","3","0","0","2","0","62","10","17","10","1","38","14","19","28","1","62","25","9","23","3","2","62"
"Athens","42.08866","-85.23471","56","3","0","0","2","0","62","10","17","10","1","38","14","19","28","1","62","25","9","23","3","2","62"
"Athens","35.44285","-84.59299","56","3","0","0","2","0","62","10","17","10","1","38","14","19","28","1","62","25","9","23","3","2","62"
"Athens","33.96095","-83.37794","56","3","0","0","2","0","62","10","17","10","1","38","14","19","28","1","62","25","9","23","3","2","62"
"Athens","39.32924","-82.10126","56","3","0","0","2","0","62","10","17","10","1","38","14","19","28","1","62","25","9","23","3","2","62"
"Athens","37.42234","-81.0162","56","3","0","0","2","0","62","10","17","10","1","38","14","19","28","1","62","25","9","23","3","2","62"
"Athens","41.9573","-76.518","56","3","0","0","2","0","62","10","17","10","1","38","14","19","28","1","62","25","9","23","3","2","62"
"Athens","44.63341","-75.94936","56","3","0","0","2","0","62","10","17","10","1","38","14","19","28","1","62","25","9","23","3","2","62"
"Athens","42.26036","-73.80957","56","3","0","0","2","0","62","10","17","10","1","38","14","19","28","1","62","25","9","23","3","2","62"
"Athens","44.92311","-69.67283","56","3","0","0","2","0","62","10","17","10","1","38","14","19","28","1","62","25","9","23","3","2","62"
"Athens","37.98376","23.72784","56","3","0","0","2","0","62","10","17","10","1","38","14","19","28","1","62","25","9","23","3","2","62"
"Atherstone","52.57536","-1.54693","2","1","0","0","0","0","3","2","1","0","0","3","2","1","0","0","3","0","1","2","0","0","3"
"Athíenou","35.06183","33.54166","1","0","0","0","0","0","1","0","1","0","0","1","1","0","0","0","1","0","0","1","0","0","1"
"Athi River","-1.4563","36.97826","3","0","0","0","0","0","3","1","1","0","0","2","2","0","1","0","3","0","0","1","1","1","3"
"Athy","52.99139","-6.98028","1","0","0","0","0","0","1","1","0","0","0","1","1","0","0","0","1","0","0","1","0","0","1"
"Atlanta","33.11374","-94.16435","5","0","0","1","0","0","6","3","0","0","0","3","2","1","3","0","6","2","0","4","0","0","6"
"Atlanta","40.25948","-89.23342","5","0","0","1","0","0","6","3","0","0","0","3","2","1","3","0","6","2","0","4","0","0","6"
"Atlanta","40.21532","-86.02637","5","0","0","1","0","0","6","3","0","0","0","3","2","1","3","0","6","2","0","4","0","0","6"
"Atlanta","33.749","-84.38798","5","0","0","1","0","0","6","3","0","0","0","3","2","1","3","0","6","2","0","4","0","0","6"
"Atlanta","45.00473","-84.14389","5","0","0","1","0","0","6","3","0","0","0","3","2","1","3","0","6","2","0","4","0","0","6"
"Attock City","33.76671","72.35977","4","0","0","0","0","0","4","4","0","0","0","4","0","2","2","0","4","1","1","2","0","0","4"
"Atworth","51.39234","-2.19297","1","0","0","0","0","0","1","0","1","0","0","1","0","0","1","0","1","1","0","0","0","0","1"
"Auchinleck","55.47157","-4.29337","1","0","0","0","0","0","1","0","1","0","0","1","0","1","0","0","1","0","0","1","0","0","1"
"Auchterarder","56.29612","-3.70692","0","0","0","0","1","0","1","0","1","0","0","1","0","0","1","0","1","0","0","1","0","0","1"
"Auckland","-36.84853","174.76349","18","2","0","0","1","0","21","9","6","6","0","21","3","2","14","2","21","2","2","16","0","1","21"
"Audlem","52.98956","-2.50706","1","0","0","0","0","0","1","0","0","0","0","0","0","0","1","0","1","0","0","1","0","0","1"
"Augsburg","48.37154","10.89851","2","0","0","0","0","0","2","0","0","1","0","1","0","1","1","0","2","1","0","0","0","1","2"
"Augusta","37.68668","-96.9767","1","0","0","0","0","0","1","0","0","0","0","0","0","0","1","0","1","1","0","0","0","0","1"
"Augusta","35.28231","-91.36541","1","0","0","0","0","0","1","0","0","0","0","0","0","0","1","0","1","1","0","0","0","0","1"
"Augusta","44.68024","-91.11988","1","0","0","0","0","0","1","0","0","0","0","0","0","0","1","0","1","1","0","0","0","0","1"
"Augusta","40.23005","-90.95013","1","0","0","0","0","0","1","0","0","0","0","0","0","0","1","0","1","1","0","0","0","0","1"
"Augusta","42.33643","-85.35222","1","0","0","0","0","0","1","0","0","0","0","0","0","0","1","0","1","1","0","0","0","0","1"
"Augusta","38.77174","-84.00576","1","0","0","0","0","0","1","0","0","0","0","0","0","0","1","0","1","1","0","0","0","0","1"
"Augusta","33.47097","-81.97484","1","0","0","0","0","0","1","0","0","0","0","0","0","0","1","0","1","1","0","0","0","0","1"
"Augusta","42.97479","-75.50129","1","0","0","0","0","0","1","0","0","0","0","0","0","0","1","0","1","1","0","0","0","0","1"
"Augusta","44.31062","-69.77949","1","0","0","0","0","0","1","0","0","0","0","0","0","0","1","0","1","1","0","0","0","0","1"
"Augusta","37.24065","15.22121","1","0","0","0","0","0","1","0","0","0","0","0","0","0","1","0","1","1","0","0","0","0","1"
"Augusta","-34.31566","115.15922","1","0","0","0","0","0","1","0","0","0","0","0","0","0","1","0","1","1","0","0","0","0","1"
"Aurangabad","19.87757","75.34226","6","0","0","0","0","0","6","4","0","0","1","5","2","2","2","0","6","0","0","5","0","0","5"
"Aurora","45.23095","-122.75593","1","0","0","0","0","0","1","1","0","0","0","1","0","0","1","0","1","0","0","1","0","0","1"
"Aurora","38.92219","-111.93409","1","0","0","0","0","0","1","1","0","0","0","1","0","0","1","0","1","0","0","1","0","0","1"
"Aurora","39.72943","-104.83192","1","0","0","0","0","0","1","1","0","0","0","1","0","0","1","0","1","0","0","1","0","0","1"
"Aurora","40.86723","-98.00422","1","0","0","0","0","0","1","1","0","0","0","1","0","0","1","0","1","0","0","1","0","0","1"
"Aurora","33.06068","-97.50336","1","0","0","0","0","0","1","1","0","0","0","1","0","0","1","0","1","0","0","1","0","0","1"
"Aurora","44.28413","-96.68561","1","0","0","0","0","0","1","1","0","0","0","1","0","0","1","0","1","0","0","1","0","0","1"
"Aurora","36.97089","-93.71798","1","0","0","0","0","0","1","1","0","0","0","1","0","0","1","0","1","0","0","1","0","0","1"
"Aurora","47.52993","-92.23712","1","0","0","0","0","0","1","1","0","0","0","1","0","0","1","0","1","0","0","1","0","0","1"
"Aurora","41.76058","-88.32007","1","0","0","0","0","0","1","1","0","0","0","1","0","0","1","0","1","0","0","1","0","0","1"
"Aurora","39.057","-84.90134","1","0","0","0","0","0","1","1","0","0","0","1","0","0","1","0","1","0","0","1","0","0","1"
"Aurora","41.31755","-81.34539","1","0","0","0","0","0","1","1","0","0","0","1","0","0","1","0","1","0","0","1","0","0","1"
"Aurora","44.00011","-79.46632","1","0","0","0","0","0","1","1","0","0","0","1","0","0","1","0","1","0","0","1","0","0","1"
"Aurora","35.30545","-76.78854","1","0","0","0","0","0","1","1","0","0","0","1","0","0","1","0","1","0","0","1","0","0","1"
"Aurora","42.75396","-76.70245","1","0","0","0","0","0","1","1","0","0","0","1","0","0","1","0","1","0","0","1","0","0","1"
"Aurora","-6.9425","-38.9675","1","0","0","0","0","0","1","1","0","0","0","1","0","0","1","0","1","0","0","1","0","0","1"
"Aurora","44.19285","22.93916","1","0","0","0","0","0","1","1","0","0","0","1","0","0","1","0","1","0","0","1","0","0","1"
"Aurora","13.2322","121.1203","1","0","0","0","0","0","1","1","0","0","0","1","0","0","1","0","1","0","0","1","0","0","1"
"Aurora","16.99065","121.63664","1","0","0","0","0","0","1","1","0","0","0","1","0","0","1","0","1","0","0","1","0","0","1"
"Aurora","13.3476","122.5195","1","0","0","0","0","0","1","1","0","0","0","1","0","0","1","0","1","0","0","1","0","0","1"
"Aurora","7.9506","123.5826","1","0","0","0","0","0","1","1","0","0","0","1","0","0","1","0","1","0","0","1","0","0","1"
"Aurora","8.59306","125.8375","1","0","0","0","0","0","1","1","0","0","0","1","0","0","1","0","1","0","0","1","0","0","1"
"Austell","33.81261","-84.63438","1","0","0","0","0","0","1","0","1","0","0","1","0","0","1","0","1","1","0","0","0","0","1"
"Austin","30.26715","-97.74306","5","0","0","0","0","0","7","2","2","1","0","5","3","2","2","0","7","1","2","4","0","0","7"
"Austin","43.66663","-92.97464","5","0","0","0","0","0","7","2","2","1","0","5","3","2","2","0","7","1","2","4","0","0","7"
"Austin","34.99842","-91.98376","5","0","0","0","0","0","7","2","2","1","0","5","3","2","2","0","7","1","2","4","0","0","7"
"Austin","38.75839","-85.80803","5","0","0","0","0","0","7","2","2","1","0","5","3","2","2","0","7","1","2","4","0","0","7"
"Austin","41.63118","-78.09139","5","0","0","0","0","0","7","2","2","1","0","5","3","2","2","0","7","1","2","4","0","0","7"
"Avdiyivka","51.7766","32.79988","1","0","0","0","0","0","1","0","1","0","0","1","0","0","1","0","1","1","0","0","0","0","1"
"Avdiyivka","48.13989","37.74255","1","0","0","0","0","0","1","0","1","0","0","1","0","0","1","0","1","1","0","0","0","0","1"
"Aventura","25.95648","-80.13921","1","0","0","0","0","0","1","0","0","0","0","0","1","0","0","0","1","1","0","0","0","0","1"
"Avignon","43.94834","4.80892","1","0","0","0","0","0","1","0","1","0","0","1","0","1","0","0","1","0","0","0","0","1","1"
"Avilés","43.55473","-5.92483","1","0","0","0","0","0","1","1","0","0","0","1","0","0","1","0","1","0","0","1","0","0","1"
"Avoch","57.56898","-4.17675","0","0","0","0","1","0","1","0","0","1","0","1","1","0","0","0","1","1","0","0","0","0","1"
"Avon","39.63137","-106.52225","1","0","0","0","0","0","1","0","1","0","0","1","1","0","0","0","1","1","0","0","0","0","1"
"Avon","43.005","-98.0598","1","0","0","0","0","0","1","0","1","0","0","1","1","0","0","0","1","1","0","0","0","0","1"
"Avon","45.60913","-94.45167","1","0","0","0","0","0","1","0","1","0","0","1","1","0","0","0","1","1","0","0","0","0","1"
"Avon","40.66421","-90.43485","1","0","0","0","0","0","1","0","1","0","0","1","1","0","0","0","1","1","0","0","0","0","1"
"Avon","39.76282","-86.39972","1","0","0","0","0","0","1","0","1","0","0","1","1","0","0","0","1","1","0","0","0","0","1"
"Avon","31.18934","-85.28604","1","0","0","0","0","0","1","0","1","0","0","1","1","0","0","0","1","1","0","0","0","0","1"
"Avon","41.45171","-82.03542","1","0","0","0","0","0","1","0","1","0","0","1","1","0","0","0","1","1","0","0","0","0","1"
"Avon","42.91201","-77.74556","1","0","0","0","0","0","1","0","1","0","0","1","1","0","0","0","1","1","0","0","0","0","1"
"Avon","40.34565","-76.38996","1","0","0","0","0","0","1","0","1","0","0","1","1","0","0","0","1","1","0","0","0","0","1"
"Avon","35.35212","-75.51043","1","0","0","0","0","0","1","0","1","0","0","1","1","0","0","0","1","1","0","0","0","0","1"
"Avon","42.13066","-71.04116","1","0","0","0","0","0","1","0","1","0","0","1","1","0","0","0","1","1","0","0","0","0","1"
"Avon","44.80617","-70.27118","1","0","0","0","0","0","1","0","1","0","0","1","1","0","0","0","1","1","0","0","0","0","1"
"Avon","48.40219","2.72022","1","0","0","0","0","0","1","0","1","0","0","1","1","0","0","0","1","1","0","0","0","0","1"
"Avtury","43.16345","46.00152","1","0","0","0","0","0","1","0","0","0","1","1","0","0","0","1","1","0","1","0","0","0","1"
"Aweil","8.76194","27.39194","1","0","0","0","0","0","1","0","1","0","0","1","0","0","0","1","1","1","0","0","0","0","1"
"Awka","6.21269","7.07199","3","0","0","0","0","0","3","0","0","2","0","2","0","1","2","0","3","2","0","0","1","0","3"
"Axim","4.86641","-2.24181","3","0","0","0","0","0","3","0","3","0","0","3","1","0","0","1","2","0","0","2","0","1","3"
"Axminster","50.78259","-2.99787","4","0","0","0","0","0","4","1","0","0","0","1","2","0","2","0","4","0","2","2","0","0","4"
"Axum","14.12109","38.72337","3","0","0","0","0","0","3","1","0","1","0","2","1","1","1","0","3","0","0","1","0","2","3"
"Aydın","37.84501","27.83963","1","0","0","0","0","0","1","0","0","0","0","0","0","0","1","0","1","1","0","0","0","0","1"
"Ayia Napa","34.98213","34.00183","1","0","0","0","0","0","1","0","1","0","0","1","0","0","1","0","1","1","0","0","0","0","1"
"Aying","47.9701","11.77752","1","0","0","0","0","0","1","0","0","1","0","1","0","0","1","0","1","0","0","1","0","0","1"
"Aylburton","51.71506","-2.55312","1","0","0","0","0","0","1","0","0","1","0","1","0","0","1","0","1","0","1","0","0","0","1"
"Aylesbury","51.81665","-0.81458","18","2","0","1","2","0","25","5","11","5","0","21","11","0","12","1","24","5","12","7","0","1","25"
"Aylesford","51.30374","0.47936","2","0","0","0","0","0","2","0","2","0","0","2","1","0","1","0","2","1","0","1","0","0","2"
"Ayr","55.46273","-4.63393","2","1","0","0","0","0","4","0","0","4","0","4","3","0","1","0","4","0","2","2","0","0","4"
"Ayr","-19.57393","147.40666","2","1","0","0","0","0","4","0","0","4","0","4","3","0","1","0","4","0","2","2","0","0","4"
"Azamgarh","26.06832","83.18358","1","0","0","0","0","0","1","1","0","0","0","1","1","0","0","0","1","0","0","1","0","0","1"
"Azazga","36.74472","4.37222","2","0","0","0","0","0","2","0","0","2","0","2","2","0","0","0","2","0","1","1","0","0","2"
"Azimpur","23.7298","90.3854","2","0","0","0","0","0","2","0","1","0","1","2","1","0","0","1","2","0","0","2","0","0","2"
"Az Zāwīyah","32.7571","12.72764","2","0","0","0","0","0","2","1","0","0","1","2","0","0","1","1","2","0","1","1","0","0","2"
"Ba","-10.4771","121.9882","3","0","0","0","0","0","3","0","2","0","0","2","2","1","0","0","3","0","0","1","0","2","3"
"Ba","-17.5343","177.67407","3","0","0","0","0","0","3","0","2","0","0","2","2","1","0","0","3","0","0","1","0","2","3"
"Baabda","33.83389","35.54417","4","0","0","0","0","0","4","1","1","0","0","2","1","3","0","0","4","1","0","2","0","1","4"
"Baalbek","34.00583","36.21806","3","0","0","0","0","0","3","0","0","0","0","0","1","2","0","0","3","1","0","2","0","0","3"
"Baardheere","2.34464","42.27644","1","0","0","0","0","0","1","0","0","0","1","1","1","0","0","0","1","0","0","1","0","0","1"
"Baarle-Nassau","51.4475","4.92917","1","0","0","0","0","0","1","1","0","0","0","1","0","0","1","0","1","0","0","1","0","0","1"
"Baarn","52.21167","5.2875","1","0","0","0","0","0","1","0","0","0","0","0","0","1","0","0","1","0","1","0","0","0","1"
"Babati","-4.21667","35.75","1","0","0","0","0","0","1","0","0","0","1","1","1","0","0","0","1","0","0","0","0","0","0"
"Baboucar Toumbou","14.10898","-16.71909","1","0","0","0","0","0","1","0","1","0","0","1","1","0","0","0","1","0","0","1","0","0","1"
"Babworth","53.31799","-0.97583","1","0","0","0","0","0","1","0","0","0","0","0","0","0","1","0","1","0","0","1","0","0","1"
"Bacău","46.56718","26.91384","2","0","0","0","0","0","2","1","1","0","0","2","0","1","1","0","2","0","0","1","0","1","2"
"Bacolod City","10.66667","122.95","1","0","0","0","0","0","1","1","0","0","0","1","0","1","0","0","1","0","0","1","0","0","1"
"Bacoor","14.45896","120.93851","1","0","0","0","0","0","1","0","0","1","0","1","0","0","1","0","1","0","1","0","0","0","1"
"Bacup","53.70336","-2.2007","2","0","0","0","0","0","2","0","0","1","0","1","0","0","2","0","2","0","1","1","0","0","2"
"Badarganj","25.67419","89.05377","23","0","0","0","1","1","25","6","12","1","1","20","13","7","5","0","25","6","0","10","0","9","25"
"Bad Dürkheim","49.4618","8.17236","0","0","0","0","0","0","1","0","0","0","0","0","1","0","0","0","1","0","0","1","0","0","1"
"Badin","35.40597","-80.11672","3","0","0","0","0","0","3","2","0","0","0","2","2","1","0","0","3","0","1","2","0","0","3"
"Badin","24.656","68.837","3","0","0","0","0","0","3","2","0","0","0","2","2","1","0","0","3","0","1","2","0","0","3"
"Badlapur","19.15516","73.26553","1","0","0","0","0","0","1","1","0","0","0","1","0","0","1","0","1","0","0","1","0","0","1"
"Bad Segeberg","53.94313","10.30215","1","0","0","0","0","0","1","1","0","0","0","1","0","0","1","0","1","0","0","0","1","0","1"
"Badulla","6.9802","81.0577","2","0","0","0","0","0","2","1","1","0","0","2","1","0","0","1","2","0","0","1","0","1","2"
"Bafoussam","5.47775","10.41759","3","0","0","0","0","0","3","1","2","0","0","3","3","0","0","0","3","0","0","3","0","0","3"
"Bagamoyo","-6.44222","38.90422","3","0","0","0","0","0","3","0","0","1","0","1","0","1","1","0","2","0","0","3","0","0","3"
"Bagerhat","22.65657","89.79123","1","0","0","0","0","0","1","0","0","0","0","0","0","0","1","0","1","0","0","1","0","0","1"
"Bagh","33.98111","73.77608","1","0","0","0","0","0","1","0","1","0","0","1","0","1","0","0","1","0","0","0","0","1","1"
"Baghdad","33.34058","44.40088","63","1","0","1","1","0","67","28","16","9","0","53","24","18","21","4","67","25","9","30","0","3","67"
"Bāgh-e Maīdān","35.22156","69.21397","1","0","0","0","0","0","1","1","0","0","0","1","1","0","0","0","1","0","0","0","0","0","0"
"Bāglung","28.27189","83.58975","19","1","0","0","2","0","22","14","2","2","0","18","7","6","8","0","21","2","1","11","1","7","22"
"Bagneux","48.79565","2.30796","2","0","0","0","0","0","2","1","0","1","0","2","0","1","1","0","2","0","0","2","0","0","2"
"Bago","17.33521","96.48135","1","0","0","0","0","0","1","0","0","0","0","0","1","0","0","0","1","0","0","1","0","0","1"
"Bago","-8.0684","111.9091","1","0","0","0","0","0","1","0","0","0","0","0","1","0","0","0","1","0","0","1","0","0","1"
"Bagshot","51.36069","-0.68802","4","0","0","0","0","0","4","0","1","1","0","2","0","0","4","0","4","0","2","1","0","1","4"
"Baguio","16.41639","120.59306","3","0","0","0","0","0","3","1","1","1","0","3","1","1","1","0","3","0","1","2","0","0","3"
"Bahau","2.8079","102.4049","1","0","0","0","0","0","1","0","0","0","0","0","1","0","0","0","1","0","0","0","1","0","1"
"Bahawalnagar","29.99835","73.25272","2","0","0","0","0","0","2","0","0","1","1","2","2","0","0","0","2","0","0","1","0","1","2"
"Bahawalnagar","30.55083","73.39083","2","0","0","0","0","0","2","0","0","1","1","2","2","0","0","0","2","0","0","1","0","1","2"
"Bahawalpur","29.39779","71.6752","17","1","0","0","2","0","20","8","7","0","0","15","11","3","6","0","20","5","1","9","0","5","20"
"Bahçelievler","41.00231","28.8598","1","0","0","0","0","0","1","1","0","0","0","1","0","1","0","0","1","0","1","0","0","0","1"
"Bahía Blanca","-38.71959","-62.27243","1","0","0","0","0","0","1","0","1","0","0","1","0","0","1","0","1","0","0","1","0","0","1"
"Bahir Dar","11.59364","37.39077","4","0","0","0","0","0","4","1","0","1","3","5","2","0","2","1","5","2","0","1","0","1","4"
"Bahlā’","22.97886","57.3047","1","0","0","0","0","0","1","0","1","0","0","1","0","1","0","0","1","1","0","0","0","0","1"
"Baia Mare","47.65729","23.56808","2","0","0","0","0","0","2","0","0","1","0","1","2","0","0","0","2","0","0","2","0","0","2"
"Bairnsdale","-37.82289","147.61041","1","0","0","0","0","0","1","0","1","0","0","1","1","0","0","0","1","1","0","0","0","0","1"
"Bājitpur","24.21623","90.95002","1","0","0","0","0","0","1","1","0","0","0","1","0","1","0","0","1","0","0","1","0","0","1"
"Bakau","13.47806","-16.68194","1","0","0","0","0","0","1","0","0","1","0","1","1","0","0","0","1","0","0","1","0","0","1"
"Bakau","-2.4105","116.2387","1","0","0","0","0","0","1","0","0","1","0","1","1","0","0","0","1","0","0","1","0","0","1"
"Bakersfield","35.37329","-119.01871","0","0","0","0","0","0","1","0","1","0","0","1","1","0","0","0","1","1","0","0","0","0","1"
"Bakewell","53.21338","-1.67481","3","0","0","0","0","0","3","1","2","0","0","3","0","0","3","0","3","0","2","1","0","0","3"
"Bakewell","-12.49684","130.99344","3","0","0","0","0","0","3","1","2","0","0","3","0","0","3","0","3","0","2","1","0","0","3"
"Baku","40.37767","49.89201","7","0","0","1","0","0","8","1","2","0","2","5","2","1","4","1","8","3","3","1","0","1","8"
"Balad","34.01485","44.14574","1","0","0","0","1","0","2","0","1","0","0","1","0","2","0","0","2","1","0","1","0","0","2"
"Balakhani","40.46344","49.91893","1","0","0","0","0","0","1","1","0","0","0","1","0","0","1","0","1","0","0","1","0","0","1"
"Baldock","51.98781","-0.18835","5","0","0","1","0","0","6","1","2","2","0","5","2","1","3","0","6","2","1","3","0","0","6"
"Baldone","56.74451","24.40078","1","0","0","0","0","0","1","0","0","0","0","0","0","0","1","0","1","1","0","0","0","0","1"
"Baldoyle","53.39972","-6.12583","0","0","0","0","1","0","1","0","0","1","0","1","1","0","0","0","1","0","0","1","0","0","1"
"Balıkesir","39.64917","27.88611","1","0","0","0","0","0","1","0","1","0","0","1","0","0","1","0","1","1","0","0","0","0","1"
"Balikpapan","-1.26753","116.82887","1","0","0","0","0","0","1","0","0","0","0","0","0","0","1","0","1","0","0","1","0","0","1"
"Balkh","36.75635","66.8972","2","0","0","0","0","0","2","0","1","1","0","2","0","0","1","1","2","0","0","2","0","0","2"
"Ballater","57.05011","-3.03798","1","0","0","0","0","0","1","0","1","0","0","1","1","0","0","0","1","1","0","0","0","0","1"
"Ballerup","55.73165","12.36328","0","0","0","0","0","0","1","1","0","0","0","1","1","0","0","0","1","1","0","0","0","0","1"
"Ballina","54.11667","-9.16667","1","0","0","0","0","0","1","0","0","1","0","1","1","0","0","0","1","0","0","1","0","0","1"
"Ballina","52.80778","-8.43556","1","0","0","0","0","0","1","0","0","1","0","1","1","0","0","0","1","0","0","1","0","0","1"
"Ballina","-28.86414","153.56541","1","0","0","0","0","0","1","0","0","1","0","1","1","0","0","0","1","0","0","1","0","0","1"
"Ballingry","56.16392","-3.32841","1","0","0","0","0","0","1","0","1","0","0","1","1","0","0","0","1","1","0","0","0","0","1"
"Ballinrobe","53.63333","-9.23333","1","0","0","0","0","0","1","0","0","1","0","1","0","0","1","0","1","0","0","1","0","0","1"
"Ballito","-29.53897","31.21439","0","0","0","0","0","0","0","0","0","0","0","0","0","0","0","0","0","0","0","0","0","0","0"
"Ballsh","40.59889","19.73472","1","0","0","0","0","0","1","1","0","0","0","1","1","0","0","0","1","0","0","1","0","0","1"
"Ballyfermot","53.34283","-6.3548","1","0","0","0","0","0","1","0","0","1","0","1","0","0","1","0","1","0","0","1","0","0","1"
"Ballymena","54.86357","-6.27628","3","0","0","0","0","0","4","1","0","3","0","4","1","0","3","0","4","0","2","2","0","0","4"
"Ballymoney","55.0708","-6.51009","7","0","0","0","1","0","8","1","0","7","0","8","0","8","0","0","8","0","2","6","0","0","8"
"Baltimore","39.84534","-82.60072","5","0","0","0","0","0","5","0","1","2","1","4","2","0","3","0","5","3","0","2","0","0","5"
"Baltimore","39.29038","-76.61219","5","0","0","0","0","0","5","0","1","2","1","4","2","0","3","0","5","3","0","2","0","0","5"
"Baltimore Highlands","39.23316","-76.63663","1","0","0","0","0","0","1","0","0","0","0","0","0","0","1","0","1","1","0","0","0","0","1"
"Bamako","12.65","-8","1","0","0","0","0","0","1","1","0","0","0","1","0","0","0","1","1","0","0","0","0","1","1"
"Bamberg","33.2971","-81.03482","1","0","0","0","0","0","1","0","1","0","0","1","1","0","0","0","1","1","0","0","0","0","1"
"Bamberg","49.89873","10.90067","1","0","0","0","0","0","1","0","1","0","0","1","1","0","0","0","1","1","0","0","0","0","1"
"Bamenda","5.9597","10.14597","6","0","0","0","0","0","6","2","3","0","1","6","4","1","0","1","6","0","1","2","0","3","6"
"Bampton","51.72634","-1.54547","1","0","0","0","0","0","2","1","1","0","0","2","1","0","1","0","2","1","0","1","0","0","2"
"Banbridge","54.35","-6.28333","2","0","0","0","1","0","3","0","0","2","0","2","1","0","2","0","3","2","0","1","0","0","3"
"Banbury","52.0632","-1.34222","18","0","0","0","3","0","23","2","9","9","0","20","9","3","10","0","22","5","7","11","0","0","23"
"Banchory","57.05168","-2.48824","1","0","0","0","0","0","1","0","0","1","0","1","0","0","1","0","1","0","0","1","0","0","1"
"Bandar Seri Begawan","4.89035","114.94006","3","0","0","0","0","0","3","0","0","0","1","1","1","0","1","1","3","2","0","1","0","0","3"
"Banderilla","19.58893","-96.93727","1","0","0","0","0","0","1","1","0","0","0","1","0","0","1","0","1","0","1","0","0","0","1"
"Bandipura","34.41728","74.64308","3","0","0","0","0","0","3","2","1","0","0","3","2","0","1","0","3","0","1","2","0","0","3"
"Banepā","27.63245","85.52192","2","0","0","0","0","0","2","2","0","0","0","2","1","1","0","0","2","0","0","2","0","0","2"
"Banfora","10.63333","-4.76667","1","0","0","0","0","0","1","0","1","0","0","1","2","1","0","0","3","0","0","2","0","1","3"
"Bang Bua Thong","13.91783","100.42403","0","1","0","0","0","0","1","1","0","0","0","1","0","0","1","0","1","0","1","0","0","0","1"
"Bangkok","13.75398","100.50144","7","0","0","0","0","0","7","2","2","1","0","5","3","2","2","0","7","0","2","5","0","0","7"
"Bangkok Yai","13.72319","100.476","1","0","0","0","0","0","1","0","0","1","0","1","1","0","0","0","1","0","0","1","0","0","1"
"Bangor","39.3885","-121.40524","11","0","0","1","1","0","13","1","5","6","0","12","4","3","6","0","13","3","2","8","0","0","13"
"Bangor","43.89302","-90.99041","11","0","0","1","1","0","13","1","5","6","0","12","4","3","6","0","13","3","2","8","0","0","13"
"Bangor","42.31254","-86.11308","11","0","0","1","1","0","13","1","5","6","0","12","4","3","6","0","13","3","2","8","0","0","13"
"Bangor","40.86565","-75.20657","11","0","0","1","1","0","13","1","5","6","0","12","4","3","6","0","13","3","2","8","0","0","13"
"Bangor","44.80118","-68.77781","11","0","0","1","1","0","13","1","5","6","0","12","4","3","6","0","13","3","2","8","0","0","13"
"Bangor","54.65338","-5.66895","11","0","0","1","1","0","13","1","5","6","0","12","4","3","6","0","13","3","2","8","0","0","13"
"Bangor","53.22752","-4.12936","11","0","0","1","1","0","13","1","5","6","0","12","4","3","6","0","13","3","2","8","0","0","13"
"Bangor","47.31557","-3.1894","11","0","0","1","1","0","13","1","5","6","0","12","4","3","6","0","13","3","2","8","0","0","13"
"Bangor","-34.01667","151.03333","11","0","0","1","1","0","13","1","5","6","0","12","4","3","6","0","13","3","2","8","0","0","13"
"Banhā","30.45977","31.1842","8","1","0","0","0","0","9","4","0","3","0","7","1","5","3","0","9","0","0","8","1","0","9"
"Banī Mazār","28.5036","30.8004","5","0","0","0","0","0","5","0","0","5","0","5","5","0","0","0","5","0","0","5","0","0","5"
"Banī Suwayf","29.07441","31.09785","4","0","0","0","0","0","4","2","1","0","1","4","1","0","2","1","4","2","0","2","0","0","4"
"Banja Luka","44.77842","17.19386","15","1","0","0","0","0","16","1","2","1","0","4","7","8","1","0","16","15","1","0","0","0","16"
"Banjul","13.45274","-16.57803","1","1","0","0","0","0","2","1","1","0","0","2","1","1","0","0","2","1","0","0","0","1","2"
"Bannu","32.98527","70.60403","1","0","0","0","0","0","1","0","1","0","0","1","0","1","0","0","1","0","0","0","0","1","1"
"Banská Bystrica","48.73946","19.15349","1","1","0","0","1","0","3","0","0","0","0","0","0","1","2","0","3","0","0","2","0","1","3"
"Bansko","41.8383","23.48851","1","0","0","0","0","0","1","1","0","0","0","1","0","0","1","0","1","0","0","1","0","0","1"
"Banstead","51.32233","-0.20685","4","1","0","0","1","0","7","2","3","1","0","6","1","1","5","0","7","2","1","4","0","0","7"
"Banting","2.8136","101.50185","1","0","0","0","0","0","1","0","1","0","0","1","0","0","1","0","1","0","0","1","0","0","1"
"Baoma","7.99344","-11.71468","0","0","0","0","1","0","1","0","0","0","0","0","1","0","0","0","1","0","1","0","0","0","1"
"Baqubah","33.75403","44.60518","3","1","0","0","0","0","4","3","0","0","0","3","2","0","2","0","4","0","0","3","0","1","4"
"Bar","42.0937","19.09841","1","0","0","0","0","0","1","0","0","0","1","1","1","0","0","0","1","0","1","0","0","0","1"
"Bar","49.07717","27.68256","1","0","0","0","0","0","1","0","0","0","1","1","1","0","0","0","1","0","1","0","0","0","1"
"Barcelona","10.13625","-64.68618","15","1","0","1","1","0","18","7","1","0","0","8","2","3","13","0","18","2","2","12","1","1","18"
"Barcelona","41.38879","2.15899","15","1","0","1","1","0","18","7","1","0","0","8","2","3","13","0","18","2","2","12","1","1","18"
"Barcelona","13.7715","123.0485","15","1","0","1","1","0","18","7","1","0","0","8","2","3","13","0","18","2","2","12","1","1","18"
"Barcelona","8.5275","123.4587","15","1","0","1","1","0","18","7","1","0","0","8","2","3","13","0","18","2","2","12","1","1","18"
"Barcelona","12.8683","124.1419","15","1","0","1","1","0","18","7","1","0","0","8","2","3","13","0","18","2","2","12","1","1","18"
"Barcelona","8.15917","126.43417","15","1","0","1","1","0","18","7","1","0","0","8","2","3","13","0","18","2","2","12","1","1","18"
"Barddhamān","23.25572","87.85691","3","0","0","0","1","0","4","1","1","0","0","2","1","2","1","0","4","1","0","2","0","1","4"
"Bardiyā","28.30058","81.3536","1","0","0","0","0","0","2","2","0","0","0","2","1","0","1","0","2","0","0","2","0","0","2"
"Bareilly","28.36678","79.43167","1","2","0","0","0","0","3","0","1","2","0","3","1","2","0","0","3","0","0","3","0","0","3"
"Bargaal","11.28636","51.0773","0","0","0","0","0","0","1","1","0","0","0","1","0","0","1","0","1","0","0","1","0","0","1"
"Bargoed","51.68333","-3.23333","1","1","0","0","1","0","4","1","1","2","0","4","2","2","0","0","4","2","1","1","0","0","4"
"Bari","41.12066","16.86982","2","0","0","0","0","0","2","0","0","0","0","0","0","1","1","0","2","1","0","0","0","1","2"
"Bari","-8.3518","120.1822","2","0","0","0","0","0","2","0","0","0","0","0","0","1","1","0","2","1","0","0","0","1","2"
"Bariadi","-2.8","33.98333","1","0","0","0","0","0","1","0","1","0","0","1","1","0","0","0","1","0","0","0","0","0","0"
"Barika","35.38901","5.36584","1","0","0","0","0","0","1","0","0","0","1","1","0","1","0","0","1","0","0","0","0","1","1"
"Baringo","0.46667","35.96667","4","0","0","0","0","0","4","0","3","1","0","4","2","0","2","0","4","0","1","2","1","0","4"
"Barisāl","22.70497","90.37013","5","0","0","0","0","0","5","3","1","0","1","5","5","0","0","0","5","0","3","2","0","0","5"
"Barking","51.53333","0.08333","1","0","0","0","0","0","1","0","0","1","0","1","0","0","1","0","1","0","0","0","1","0","1"
"Barmstedt","53.79209","9.76739","2","0","0","0","0","0","2","0","2","0","0","2","2","0","0","0","2","2","0","0","0","0","2"
"Barnard Castle","54.5415","-1.919","4","0","0","0","0","0","4","1","1","2","0","4","3","0","1","0","4","0","0","3","0","1","4"
"Barnet","51.65","-0.2","15","0","0","2","2","0","19","8","0","4","0","12","3","6","10","0","19","0","10","9","0","0","19"
"Barnoldswick","53.91711","-2.18705","4","0","0","0","1","0","5","1","3","1","0","5","1","1","3","0","5","2","1","2","0","0","5"
"Barnsley","53.55","-1.48333","13","1","0","0","0","0","14","2","6","3","0","11","4","3","6","1","14","4","6","4","0","0","14"
"Barnsley","-32.93333","151.58333","13","1","0","0","0","0","14","2","6","3","0","11","4","3","6","1","14","4","6","4","0","0","14"
"Barnstaple","51.08022","-4.05808","6","0","0","0","1","0","7","1","3","3","0","7","4","0","3","0","7","1","0","5","0","1","7"
"Barranquilla","10.96854","-74.78132","4","0","0","0","1","0","5","3","1","0","0","4","0","3","2","0","5","1","0","4","0","0","5"
"Barrow in Furness","54.11094","-3.22758","14","0","0","1","0","0","16","3","9","3","0","15","7","5","4","0","16","6","2","8","0","0","16"
"Barrow upon Soar","52.75178","-1.14601","0","0","0","0","1","0","1","1","0","0","0","1","0","0","1","0","1","0","0","1","0","0","1"
"Barry","39.69421","-91.03902","13","0","0","0","0","0","16","4","6","5","1","16","6","2","8","0","16","6","4","6","0","0","16"
"Barry","51.39979","-3.2838","13","0","0","0","0","0","16","4","6","5","1","16","6","2","8","0","16","6","4","6","0","0","16"
"Bartley Green","52.43532","-1.99707","0","0","0","0","0","0","1","1","0","0","0","1","1","0","0","0","1","0","0","1","0","0","1"
"Bartow","27.89641","-81.84314","0","0","0","0","0","0","1","0","1","0","0","1","1","0","0","0","1","1","0","0","0","0","1"
"Bartow","53.81664","13.34582","0","0","0","0","0","0","1","0","1","0","0","1","1","0","0","0","1","1","0","0","0","0","1"
"Barueri","-23.51056","-46.87611","1","0","0","0","0","0","1","0","1","0","0","1","1","0","0","0","1","0","0","1","0","0","1"
"Baruta","10.43424","-66.87558","1","0","0","0","0","0","1","0","1","0","0","1","0","0","1","0","1","1","0","0","0","0","1"
"Baschurch","52.78848","-2.85284","1","0","0","0","0","0","1","0","1","0","0","1","0","0","1","0","1","0","0","1","0","0","1"
"Basel","47.55839","7.57327","1","0","0","0","0","0","1","0","1","0","0","1","0","0","1","0","1","0","0","0","1","0","1"
"Basildon","51.56844","0.45782","11","0","0","0","1","0","12","0","6","4","0","10","5","3","4","0","12","4","2","5","0","1","12"
"Basingstoke","51.26249","-1.08708","51","2","1","3","2","0","62","18","10","22","0","50","20","16","30","0","66","7","16","40","2","1","66"
"Basrah","30.50852","47.7804","5","0","0","0","0","0","5","1","3","0","0","4","0","2","3","0","5","2","1","2","0","0","5"
"Basse Santa Su","13.30995","-14.21373","1","0","0","0","0","0","1","0","1","0","0","1","1","0","0","0","1","0","0","1","0","0","1"
"Basyūn","30.93976","30.81338","1","0","0","0","0","0","1","0","0","0","0","0","0","1","0","0","1","0","0","1","0","0","1"
"Batam","1.14937","104.02491","0","0","0","0","0","0","0","0","1","0","0","1","0","0","1","0","1","1","0","0","0","0","1"
"Batang","29.83537","106.29271","1","0","0","0","0","0","1","0","1","0","0","1","1","0","0","0","1","1","0","0","0","0","1"
"Batang","-6.90778","109.73028","1","0","0","0","0","0","1","0","1","0","0","1","1","0","0","0","1","1","0","0","0","0","1"
"Batang","-6.4846","110.7083","1","0","0","0","0","0","1","0","1","0","0","1","1","0","0","0","1","1","0","0","0","0","1"
"Batang","-9.5923","118.9871","1","0","0","0","0","0","1","0","1","0","0","1","1","0","0","0","1","1","0","0","0","0","1"
"Batavia","40.99418","-92.1674","1","0","0","0","0","0","1","0","0","0","0","0","0","1","0","0","1","1","0","0","0","0","1"
"Batavia","41.85003","-88.31257","1","0","0","0","0","0","1","0","0","0","0","0","0","1","0","0","1","1","0","0","0","0","1"
"Batavia","39.07701","-84.17688","1","0","0","0","0","0","1","0","0","0","0","0","0","1","0","0","1","1","0","0","0","0","1"
"Batavia","42.99812","-78.18752","1","0","0","0","0","0","1","0","0","0","0","0","0","1","0","0","1","1","0","0","0","0","1"
"Bath","42.81864","-84.44859","58","0","0","2","4","0","69","12","17","17","0","46","25","7","36","0","68","6","9","53","0","1","69"
"Bath","42.33702","-77.31776","58","0","0","2","4","0","69","12","17","17","0","46","25","7","36","0","68","6","9","53","0","1","69"
"Bath","44.18342","-76.78273","58","0","0","2","4","0","69","12","17","17","0","46","25","7","36","0","68","6","9","53","0","1","69"
"Bath","17.9482","-76.34916","58","0","0","2","4","0","69","12","17","17","0","46","25","7","36","0","68","6","9","53","0","1","69"
"Bath","40.72565","-75.39407","58","0","0","2","4","0","69","12","17","17","0","46","25","7","36","0","68","6","9","53","0","1","69"
"Bath","44.16701","-71.9662","58","0","0","2","4","0","69","12","17","17","0","46","25","7","36","0","68","6","9","53","0","1","69"
"Bath","43.91064","-69.8206","58","0","0","2","4","0","69","12","17","17","0","46","25","7","36","0","68","6","9","53","0","1","69"
"Bath","51.3751","-2.36172","58","0","0","2","4","0","69","12","17","17","0","46","25","7","36","0","68","6","9","53","0","1","69"
"Bathgate","55.90204","-3.64398","11","0","0","1","0","0","13","2","0","10","0","12","3","1","9","0","13","0","6","7","0","0","13"
"Bathinda","30.20747","74.93893","2","0","1","0","0","0","3","1","0","1","1","3","1","0","1","1","3","0","0","1","1","1","3"
"Bathurst","47.61814","-65.65112","1","0","0","0","0","0","1","0","1","0","0","1","1","0","0","0","1","1","0","0","0","0","1"
"Bathurst","-33.41665","149.5806","1","0","0","0","0","0","1","0","1","0","0","1","1","0","0","0","1","1","0","0","0","0","1"
"Bat Khela","34.6178","71.97247","3","0","0","0","0","0","3","2","0","1","0","3","0","0","3","0","3","0","0","3","0","0","3"
"Batley","53.70291","-1.6337","2","0","0","0","1","0","3","0","0","3","0","3","1","0","2","0","3","0","1","2","0","0","3"
"Batna","35.55597","6.17414","3","0","0","1","1","0","5","2","0","3","0","5","2","3","0","0","5","1","3","0","0","1","5"
"Batticaloa","7.7102","81.6924","6","0","0","0","0","0","6","2","0","1","0","3","2","2","2","0","6","1","0","4","0","1","6"
"Battle","50.91732","0.48417","6","0","0","1","3","0","10","5","2","3","0","10","1","1","8","0","10","4","4","2","0","0","10"
"Batu Berendam","2.2487","102.246","1","0","0","0","0","0","1","1","0","0","0","1","1","0","0","0","1","0","0","1","0","0","1"
"Batumi","41.64228","41.63392","1","0","0","0","0","0","1","0","0","1","0","1","0","0","1","0","1","0","0","1","0","0","1"
"Bauchi","10.31032","9.84388","3","1","0","0","0","0","4","1","3","0","0","4","4","0","0","0","4","1","1","2","0","0","4"
"Bawshar","23.57769","58.39982","1","0","0","0","0","0","1","0","0","0","0","0","1","0","0","0","1","0","0","1","0","0","1"
"Bayamon","18.17774","-66.11322","1","0","0","0","0","0","1","0","1","0","0","1","0","1","0","0","1","1","0","0","0","0","1"
"Bay Saint Louis","30.30881","-89.33005","1","0","0","0","0","0","1","0","1","0","0","1","1","0","0","0","1","1","0","0","0","0","1"
"Beaconsfield","45.43341","-73.86586","5","0","0","0","1","0","7","2","0","2","0","4","3","2","6","0","11","0","6","5","0","0","11"
"Beaconsfield","51.61219","-0.64732","5","0","0","0","1","0","7","2","0","2","0","4","3","2","6","0","11","0","6","5","0","0","11"
"Beaconsfield","-32.06748","115.76401","5","0","0","0","1","0","7","2","0","2","0","4","3","2","6","0","11","0","6","5","0","0","11"
"Beaconsfield","-38.05","145.36667","5","0","0","0","1","0","7","2","0","2","0","4","3","2","6","0","11","0","6","5","0","0","11"
"Beaconsfield","-41.20227","146.81723","5","0","0","0","1","0","7","2","0","2","0","4","3","2","6","0","11","0","6","5","0","0","11"
"Beaconsfield","-21.09121","149.16544","5","0","0","0","1","0","7","2","0","2","0","4","3","2","6","0","11","0","6","5","0","0","11"
"Beaconsfield","-33.91147","151.20038","5","0","0","0","1","0","7","2","0","2","0","4","3","2","6","0","11","0","6","5","0","0","11"
"Beaminster","50.809","-2.7391","1","0","0","1","2","0","4","1","0","2","0","3","2","0","2","0","4","2","0","2","0","0","4"
"Beau Bassin-Rose Hill","-20.23325","57.46609","4","0","0","0","0","0","4","2","0","0","0","2","1","1","2","0","4","0","2","2","0","0","4"
"Beauly","57.48345","-4.46144","1","0","0","0","0","0","1","1","0","0","0","1","0","0","1","0","1","0","1","0","0","0","1"
"Bebington","53.35","-3.01667","3","2","0","0","0","0","5","3","0","2","0","5","0","0","5","0","5","1","1","3","0","0","5"
"Beccles","52.45936","1.56465","2","0","0","1","2","0","5","2","0","3","0","5","2","1","2","0","5","0","2","3","0","0","5"
"Béchar","31.61667","-2.21667","0","0","0","0","1","0","1","0","0","1","0","1","1","0","0","0","1","1","0","0","0","0","1"
"Beckenham","51.40878","-0.02526","9","0","0","0","1","0","10","3","3","2","0","8","4","1","5","0","10","0","3","7","0","0","10"
"Beckenham","-32.02481","115.95989","9","0","0","0","1","0","10","3","3","2","0","8","4","1","5","0","10","0","3","7","0","0","10"
"Beckington","51.26444","-2.28722","3","0","0","0","0","0","3","0","2","0","0","2","2","1","0","0","3","0","3","0","0","0","3"
"Bedale","54.28811","-1.59181","2","0","0","0","1","0","3","0","2","1","0","3","2","0","1","0","3","1","1","1","0","0","3"
"Beddau","51.55398","-3.35814","3","0","0","0","0","0","3","0","0","0","0","0","2","0","1","0","3","0","0","3","0","0","3"
"Bedekovčina","46.04111","15.99639","2","0","0","0","0","0","2","1","0","0","0","1","0","0","2","0","2","0","0","2","0","0","2"
"Bedford","32.84402","-97.14307","36","1","0","2","2","0","44","7","11","18","2","38","11","4","27","2","44","10","8","25","1","0","44"
"Bedford","40.66693","-94.72136","36","1","0","2","2","0","44","7","11","18","2","38","11","4","27","2","44","10","8","25","1","0","44"
"Bedford","38.86116","-86.48721","36","1","0","2","2","0","44","7","11","18","2","38","11","4","27","2","44","10","8","25","1","0","44"
"Bedford","38.59256","-85.31773","36","1","0","2","2","0","44","7","11","18","2","38","11","4","27","2","44","10","8","25","1","0","44"
"Bedford","41.39311","-81.53651","36","1","0","2","2","0","44","7","11","18","2","38","11","4","27","2","44","10","8","25","1","0","44"
"Bedford","37.33431","-79.52309","36","1","0","2","2","0","44","7","11","18","2","38","11","4","27","2","44","10","8","25","1","0","44"
"Bedford","40.01869","-78.50391","36","1","0","2","2","0","44","7","11","18","2","38","11","4","27","2","44","10","8","25","1","0","44"
"Bedford","41.20426","-73.64374","36","1","0","2","2","0","44","7","11","18","2","38","11","4","27","2","44","10","8","25","1","0","44"
"Bedford","45.11678","-72.98244","36","1","0","2","2","0","44","7","11","18","2","38","11","4","27","2","44","10","8","25","1","0","44"
"Bedford","42.94647","-71.5159","36","1","0","2","2","0","44","7","11","18","2","38","11","4","27","2","44","10","8","25","1","0","44"
"Bedford","42.49065","-71.27617","36","1","0","2","2","0","44","7","11","18","2","38","11","4","27","2","44","10","8","25","1","0","44"
"Bedford","52.13459","-0.46632","36","1","0","2","2","0","44","7","11","18","2","38","11","4","27","2","44","10","8","25","1","0","44"
"Bedford","-31.91132","115.8892","36","1","0","2","2","0","44","7","11","18","2","38","11","4","27","2","44","10","8","25","1","0","44"
"Bedlington","55.13061","-1.59319","8","0","0","0","1","0","10","2","3","1","0","6","1","3","6","0","10","5","1","5","0","0","11"
"Bedlinog","51.70432","-3.31306","1","0","0","0","0","0","1","0","0","1","0","1","0","0","1","0","1","0","1","0","0","0","1"
"Bedworth","52.4791","-1.46909","3","0","0","1","0","0","4","1","2","0","0","3","0","0","4","0","4","2","1","1","0","0","4"
"Beed","18.98921","75.75634","4","0","0","0","0","0","4","3","0","0","1","4","1","0","2","1","4","0","0","3","0","0","3"
"Beersheba","31.25181","34.7913","4","0","0","0","0","0","4","0","1","0","1","2","2","1","1","0","4","1","0","2","1","0","4"
"Beerwah","-26.85881","152.96144","1","0","0","0","0","0","1","0","1","0","0","1","0","1","0","0","1","0","0","1","0","0","1"
"Beeston","53.11667","-2.68333","2","1","0","0","0","0","3","2","1","0","0","3","2","1","0","0","3","1","0","2","0","0","3"
"Beeston","52.7","0.81667","2","1","0","0","0","0","3","2","1","0","0","3","2","1","0","0","3","1","0","2","0","0","3"
"Beheira","30.51478","30.34355","1","0","0","0","0","0","2","0","0","0","1","1","1","0","0","1","2","1","0","0","0","1","2"
"Beijing","39.9075","116.39723","2","0","0","0","0","0","2","0","1","0","0","1","1","1","0","0","2","1","0","0","0","1","2"
"Beira","-19.84361","34.83889","3","1","0","1","1","0","6","1","1","2","0","4","2","3","1","0","6","1","0","4","1","0","6"
"Beirut","33.89332","35.50157","20","1","0","0","0","0","21","6","5","2","2","15","8","6","5","2","21","11","3","5","1","1","21"
"Beït ed Dîne","33.69417","35.58083","1","0","0","0","0","0","1","0","1","0","0","1","1","0","0","0","1","0","0","0","1","0","1"
"Beith","55.74923","-4.6368","0","0","0","0","0","0","0","0","0","0","0","0","0","0","0","0","0","0","0","1","0","0","1"
"Béja","36.72564","9.18169","1","0","0","0","0","0","1","0","0","1","0","1","0","0","1","0","1","0","1","0","0","0","1"
"Bejaïa","36.75587","5.08433","3","2","0","0","0","0","5","1","1","1","0","3","0","2","3","0","5","1","2","1","0","1","5"
"Bekasi","-6.2349","106.9896","1","0","0","0","0","0","1","1","0","0","0","1","1","0","0","0","1","1","0","0","0","0","1"
"Bekwai","6.45195","-1.57866","0","1","0","0","0","0","1","0","1","0","0","1","0","1","0","0","1","0","0","0","0","1","1"
"Belding","43.09781","-85.22891","1","0","0","0","0","0","1","0","0","1","0","1","0","0","1","0","1","1","0","0","0","0","1"
"Beledweyne","4.73583","45.20361","1","0","0","0","0","0","1","0","1","0","0","1","0","0","0","1","1","0","0","0","0","1","1"
"Belém","-1.45583","-48.50444","2","0","0","0","0","0","2","0","1","0","0","1","2","0","0","0","2","1","0","1","0","0","2"
"Belém","-6.69167","-35.53333","2","0","0","0","0","0","2","0","1","0","0","1","2","0","0","0","2","1","0","1","0","0","2"
"Belén","20.3675","-100.52278","1","0","0","0","0","0","1","0","1","0","0","1","0","1","0","0","1","1","0","0","0","0","1"
"Belén","17.78907","-92.61137","1","0","0","0","0","0","1","0","1","0","0","1","0","1","0","0","1","1","0","0","0","0","1"
"Belén","11.50299","-85.88935","1","0","0","0","0","0","1","0","1","0","0","1","0","1","0","0","1","1","0","0","0","0","1"
"Belén","10.40789","-85.58836","1","0","0","0","0","0","1","0","1","0","0","1","0","1","0","0","1","1","0","0","0","0","1"
"Belén","1.59477","-77.05408","1","0","0","0","0","0","1","0","1","0","0","1","0","1","0","0","1","1","0","0","0","0","1"
"Belén","5.98892","-72.91254","1","0","0","0","0","0","1","0","1","0","0","1","0","1","0","0","1","1","0","0","0","0","1"
"Belén","-27.65103","-67.02869","1","0","0","0","0","0","1","0","1","0","0","1","0","1","0","0","1","1","0","0","0","0","1"
"Belén","-30.78716","-57.77577","1","0","0","0","0","0","1","0","1","0","0","1","0","1","0","0","1","1","0","0","0","0","1"
"Belén","-23.46611","-57.26194","1","0","0","0","0","0","1","0","1","0","0","1","0","1","0","0","1","1","0","0","0","0","1"
"Belfast","42.34284","-78.1114","53","1","0","2","2","0","63","13","17","19","2","51","26","7","29","1","63","17","13","28","1","3","62"
"Belfast","40.78065","-75.27796","53","1","0","2","2","0","63","13","17","19","2","51","26","7","29","1","63","17","13","28","1","3","62"
"Belfast","44.42591","-69.00642","53","1","0","2","2","0","63","13","17","19","2","51","26","7","29","1","63","17","13","28","1","3","62"
"Belfast","46.08341","-62.88197","53","1","0","2","2","0","63","13","17","19","2","51","26","7","29","1","63","17","13","28","1","3","62"
"Belfast","54.59682","-5.92541","53","1","0","2","2","0","63","13","17","19","2","51","26","7","29","1","63","17","13","28","1","3","62"
"Belfast","-25.68991","30.03504","53","1","0","2","2","0","63","13","17","19","2","51","26","7","29","1","63","17","13","28","1","3","62"
"Belgaum","15.85212","74.50447","3","0","0","0","0","0","3","3","0","0","0","3","1","0","2","0","3","0","0","3","0","0","3"
"Belgrade","45.77604","-111.1769","37","1","0","0","1","0","40","10","7","0","2","19","7","12","17","4","40","20","5","9","3","3","40"
"Belgrade","45.45302","-95.00446","37","1","0","0","1","0","40","10","7","0","2","19","7","12","17","4","40","20","5","9","3","3","40"
"Belgrade","44.44729","-69.83255","37","1","0","0","1","0","40","10","7","0","2","19","7","12","17","4","40","20","5","9","3","3","40"
"Belgrade","44.80401","20.46513","37","1","0","0","1","0","40","10","7","0","2","19","7","12","17","4","40","20","5","9","3","3","40"
"Belize City","17.49952","-88.19756","1","0","0","0","1","0","2","1","1","0","0","2","2","0","0","0","2","0","0","1","0","1","2"
"Bellary","15.14205","76.92398","1","0","0","0","0","0","1","0","0","1","0","1","0","0","1","0","1","0","0","1","0","0","1"
"Bella Vista","40.64071","-122.2325","1","0","0","0","0","0","1","0","1","0","0","1","1","0","0","0","1","1","0","0","0","0","1"
"Bella Vista","36.4807","-94.27134","1","0","0","0","0","0","1","0","1","0","0","1","1","0","0","0","1","1","0","0","0","0","1"
"Bella Vista","15.58359","-92.24683","1","0","0","0","0","0","1","0","1","0","0","1","1","0","0","0","1","1","0","0","0","0","1"
"Bella Vista","8.20617","-81.62123","1","0","0","0","0","0","1","0","1","0","0","1","1","0","0","0","1","1","0","0","0","0","1"
"Bella Vista","8.54263","-80.40679","1","0","0","0","0","0","1","0","1","0","0","1","1","0","0","0","1","1","0","0","0","0","1"
"Bella Vista","7.75","-80.23333","1","0","0","0","0","0","1","0","1","0","0","1","1","0","0","0","1","1","0","0","0","0","1"
"Bella Vista","18.45539","-69.9454","1","0","0","0","0","0","1","0","1","0","0","1","1","0","0","0","1","1","0","0","0","0","1"
"Bella Vista","-27.03424","-65.30196","1","0","0","0","0","0","1","0","1","0","0","1","1","0","0","0","1","1","0","0","0","0","1"
"Bella Vista","-28.50752","-59.04149","1","0","0","0","0","0","1","0","1","0","0","1","1","0","0","0","1","1","0","0","0","0","1"
"Bella Vista","-22.13333","-56.51667","1","0","0","0","0","0","1","0","1","0","0","1","1","0","0","0","1","1","0","0","0","0","1"
"Bella Vista","-27.05","-55.55","1","0","0","0","0","0","1","0","1","0","0","1","1","0","0","0","1","1","0","0","0","0","1"
"Bella Vista","-33.74127","150.95456","1","0","0","0","0","0","1","0","1","0","0","1","1","0","0","0","1","1","0","0","0","0","1"
"Bellevue","47.61038","-122.20068","1","0","0","0","0","0","1","0","0","1","0","1","0","0","1","0","1","0","0","1","0","0","1"
"Bellevue","43.46352","-114.2606","1","0","0","0","0","0","1","0","0","1","0","1","0","0","1","0","1","0","0","1","0","0","1"
"Bellevue","41.13667","-95.89084","1","0","0","0","0","0","1","0","0","1","0","1","0","0","1","0","1","0","0","1","0","0","1"
"Bellevue","42.25863","-90.42291","1","0","0","0","0","0","1","0","0","1","0","1","0","0","1","0","1","0","0","1","0","0","1"
"Bellevue","40.68448","-89.6801","1","0","0","0","0","0","1","0","0","1","0","1","0","0","1","0","1","0","0","1","0","0","1"
"Bellevue","44.44416","-87.9201","1","0","0","0","0","0","1","0","0","1","0","1","0","0","1","0","1","0","0","1","0","0","1"
"Bellevue","42.44337","-85.01805","1","0","0","0","0","0","1","0","0","1","0","1","0","0","1","0","1","0","0","1","0","0","1"
"Bellevue","39.10645","-84.47883","1","0","0","0","0","0","1","0","0","1","0","1","0","0","1","0","1","0","0","1","0","0","1"
"Bellevue","41.27366","-82.84158","1","0","0","0","0","0","1","0","0","1","0","1","0","0","1","0","1","0","0","1","0","0","1"
"Bellevue","40.49396","-80.05172","1","0","0","0","0","0","1","0","0","1","0","1","0","0","1","0","1","0","0","1","0","0","1"
"Bellevue","46.25739","6.15475","1","0","0","0","0","0","1","0","0","1","0","1","0","0","1","0","1","0","0","1","0","0","1"
"Bellevue","-31.90116","116.02762","1","0","0","0","0","0","1","0","0","1","0","1","0","0","1","0","1","0","0","1","0","0","1"
"Bellevue Hill","-33.87899","151.25101","1","0","0","0","0","0","1","0","0","1","0","1","1","0","0","0","1","0","0","1","0","0","1"
"Bellshill","55.81667","-4.01667","3","0","0","0","0","0","3","0","2","1","0","3","0","2","1","0","3","0","1","1","0","1","3"
"Belluno","46.14262","12.2156","1","0","0","0","0","0","1","0","1","0","0","1","0","0","1","0","1","0","0","0","0","1","1"
"Belo","6.13333","10.25","1","0","0","0","0","0","1","0","0","0","0","0","1","0","0","0","1","0","0","0","0","1","1"
"Belo Horizonte","-19.92083","-43.93778","1","0","0","0","0","0","2","1","1","0","0","2","2","0","0","0","2","0","0","2","0","0","2"
"Belper","53.0233","-1.48119","6","0","0","0","1","0","8","0","4","0","0","4","4","3","1","0","8","2","1","5","0","0","8"
"Belvaux","49.51014","5.92414","1","0","0","0","0","0","1","0","0","1","0","1","1","0","0","0","1","0","0","1","0","0","1"
"Bembridge","50.68634","-1.08275","1","0","0","0","0","0","1","1","0","0","0","1","0","0","1","0","1","0","0","1","0","0","1"
"Ben Arous","36.75452","10.22167","4","0","0","0","0","0","4","2","1","1","0","4","1","0","3","0","4","2","0","2","0","0","4"
"Benbecula","57.44737","-7.34273","1","0","0","0","0","0","1","1","0","0","0","1","1","0","0","0","1","0","1","0","0","0","1"
"Bend","40.25516","-122.20861","1","0","0","0","0","0","1","0","0","0","0","0","0","0","1","0","1","0","0","1","0","0","1"
"Bend","44.05817","-121.31531","1","0","0","0","0","0","1","0","0","0","0","0","0","0","1","0","1","0","0","1","0","0","1"
"Benevento","41.1307","14.77816","1","0","0","0","0","0","1","0","1","0","0","1","0","1","0","0","1","1","0","0","0","0","1"
"Bengaluru","12.97194","77.59369","19","1","0","0","1","0","21","15","0","2","2","19","11","2","8","0","21","2","2","15","0","2","21"
"Benghazi","32.11486","20.06859","26","0","0","0","0","0","26","11","6","2","2","21","7","7","12","0","26","13","7","7","0","0","27"
"Bengkulu","-3.80044","102.26554","1","0","0","0","0","0","1","1","0","0","0","1","0","0","1","0","1","0","0","1","0","0","1"
"Beni Hassane","35.5672","10.80869","1","0","0","0","0","0","1","1","0","0","0","1","0","1","0","0","1","0","0","1","0","0","1"
"Beni Khalled","36.65038","10.59004","0","0","0","1","0","0","1","1","0","0","0","1","0","0","1","0","1","0","0","1","0","0","1"
"Beni Mellal","32.33725","-6.34983","1","0","0","0","0","0","1","0","0","0","0","0","0","1","0","0","1","1","0","0","0","0","1"
"Benin City","6.33815","5.62575","5","0","0","0","0","0","5","0","2","1","1","4","4","1","0","0","5","4","0","0","1","0","5"
"Benoni","-26.18848","28.32078","4","0","0","0","1","0","5","0","3","0","1","4","2","3","0","0","5","4","0","1","0","0","5"
"Benson","41.78743","-111.93022","1","0","0","0","0","0","1","0","0","1","0","1","0","0","1","0","1","0","0","1","0","0","1"
"Benson","31.96786","-110.29452","1","0","0","0","0","0","1","0","0","1","0","1","0","0","1","0","1","0","0","1","0","0","1"
"Benson","45.315","-95.6025","1","0","0","0","0","0","1","0","0","1","0","1","0","0","1","0","1","0","0","1","0","0","1"
"Benson","35.38211","-78.54862","1","0","0","0","0","0","1","0","0","1","0","1","0","0","1","0","1","0","0","1","0","0","1"
"Benson","51.62073","-1.10979","1","0","0","0","0","0","1","0","0","1","0","1","0","0","1","0","1","0","0","1","0","0","1"
"Bensonville","6.44716","-10.61283","1","0","0","0","0","0","1","0","1","0","0","1","1","0","0","0","1","1","0","0","0","0","1"
"Bent Jbaïl","33.11944","35.43333","1","0","0","0","0","0","1","0","1","0","0","1","0","0","1","0","1","1","0","0","0","0","1"
"Bentonville","36.37285","-94.20882","1","0","0","0","0","0","1","0","1","0","0","1","1","0","0","0","1","1","0","0","0","0","1"
"Berat","40.70583","19.95222","1","1","0","0","0","0","2","0","0","1","0","1","1","1","0","0","2","0","1","0","0","1","2"
"Bergen","43.08534","-77.94223","1","0","0","0","0","0","2","1","0","1","0","2","1","1","0","0","2","0","0","2","0","0","2"
"Bergen","52.66917","4.70417","1","0","0","0","0","0","2","1","0","1","0","2","1","1","0","0","2","0","0","2","0","0","2"
"Bergen","60.39299","5.32415","1","0","0","0","0","0","2","1","0","1","0","2","1","1","0","0","2","0","0","2","0","0","2"
"Bergen","49.78333","7.41667","1","0","0","0","0","0","2","1","0","1","0","2","1","1","0","0","2","0","0","2","0","0","2"
"Bergen","52.80837","9.96374","1","0","0","0","0","0","2","1","0","1","0","2","1","1","0","0","2","0","0","2","0","0","2"
"Bergen","49.07347","11.114","1","0","0","0","0","0","2","1","0","1","0","2","1","1","0","0","2","0","0","2","0","0","2"
"Bergen","50.471","12.27448","1","0","0","0","0","0","2","1","0","1","0","2","1","1","0","0","2","0","0","2","0","0","2"
"Bergen","47.80837","12.58982","1","0","0","0","0","0","2","1","0","1","0","2","1","1","0","0","2","0","0","2","0","0","2"
"Berkane","34.92","-2.32","1","0","0","0","0","0","1","1","0","0","0","1","0","0","1","0","1","0","0","1","0","0","1"
"Berkeley","37.87159","-122.27275","1","0","0","0","0","0","3","3","0","0","0","3","1","0","2","0","3","0","0","3","0","0","3"
"Berkeley","38.7545","-90.33123","1","0","0","0","0","0","3","3","0","0","0","3","1","0","2","0","3","0","0","3","0","0","3"
"Berkeley","41.88892","-87.9034","1","0","0","0","0","0","3","3","0","0","0","3","1","0","2","0","3","0","0","3","0","0","3"
"Berkeley","51.69111","-2.45917","1","0","0","0","0","0","3","3","0","0","0","3","1","0","2","0","3","0","0","3","0","0","3"
"Berkeley","-34.48333","150.85","1","0","0","0","0","0","3","3","0","0","0","3","1","0","2","0","3","0","0","3","0","0","3"
"Berkeley Heights","40.68343","-74.44265","1","0","0","0","0","0","1","0","0","0","0","0","0","0","1","0","1","0","0","1","0","0","1"
"Berkhamsted","51.7604","-0.56528","7","1","0","1","2","0","12","3","2","4","1","10","5","2","5","0","12","1","2","9","0","0","12"
"Berlin","43.96804","-88.94345","13","0","0","0","2","0","17","2","5","5","0","12","3","4","10","0","17","3","0","13","1","0","17"
"Berlin","31.06824","-83.62378","13","0","0","0","2","0","17","2","5","5","0","12","3","4","10","0","17","3","0","13","1","0","17"
"Berlin","40.56117","-81.7943","13","0","0","0","2","0","17","2","5","5","0","12","3","4","10","0","17","3","0","13","1","0","17"
"Berlin","39.92064","-78.9578","13","0","0","0","2","0","17","2","5","5","0","12","3","4","10","0","17","3","0","13","1","0","17"
"Berlin","38.32262","-75.21769","13","0","0","0","2","0","17","2","5","5","0","12","3","4","10","0","17","3","0","13","1","0","17"
"Berlin","39.79123","-74.92905","13","0","0","0","2","0","17","2","5","5","0","12","3","4","10","0","17","3","0","13","1","0","17"
"Berlin","42.3812","-71.63701","13","0","0","0","2","0","17","2","5","5","0","12","3","4","10","0","17","3","0","13","1","0","17"
"Berlin","44.46867","-71.18508","13","0","0","0","2","0","17","2","5","5","0","12","3","4","10","0","17","3","0","13","1","0","17"
"Berlin","52.52437","13.41053","13","0","0","0","2","0","17","2","5","5","0","12","3","4","10","0","17","3","0","13","1","0","17"
"Berlin","54.00603","61.19308","13","0","0","0","2","0","17","2","5","5","0","12","3","4","10","0","17","3","0","13","1","0","17"
"Berlin Köpenick","52.44254","13.58228","1","0","0","0","0","0","1","1","0","0","0","1","0","0","1","0","1","0","0","1","0","0","1"
"Bertrange","49.61111","6.05","1","0","0","0","0","0","1","0","1","0","0","1","0","0","1","0","1","1","0","0","0","0","1"
"Bertrange","49.31368","6.19208","1","0","0","0","0","0","1","0","1","0","0","1","0","0","1","0","1","1","0","0","0","0","1"
"Berwick","29.69465","-91.21899","1","0","0","0","0","0","1","0","0","1","0","1","0","1","0","0","1","0","1","0","0","0","1"
"Berwick","41.05453","-76.23327","1","0","0","0","0","0","1","0","0","1","0","1","0","1","0","0","1","0","1","0","0","0","1"
"Berwick","43.26592","-70.8645","1","0","0","0","0","0","1","0","0","1","0","1","0","1","0","0","1","0","1","0","0","0","1"
"Berwick","45.05015","-64.73208","1","0","0","0","0","0","1","0","0","1","0","1","0","1","0","0","1","0","1","0","0","0","1"
"Berwick","-38.03333","145.35","1","0","0","0","0","0","1","0","0","1","0","1","0","1","0","0","1","0","1","0","0","0","1"
"Betchworth","51.23374","-0.26655","1","0","0","0","0","0","1","0","0","1","0","1","0","0","1","0","1","0","0","1","0","0","1"
"Bethlehem","33.93206","-83.71378","1","1","0","0","0","0","2","1","0","1","0","2","1","0","1","0","2","0","2","0","0","0","2"
"Bethlehem","35.82569","-81.30703","1","1","0","0","0","0","2","1","0","1","0","2","1","0","1","0","2","0","2","0","0","0","2"
"Bethlehem","40.04396","-80.69064","1","1","0","0","0","0","2","1","0","1","0","2","1","0","1","0","2","0","2","0","0","0","2"
"Bethlehem","39.39203","-80.28064","1","1","0","0","0","0","2","1","0","1","0","2","1","0","1","0","2","0","2","0","0","0","2"
"Bethlehem","40.62593","-75.37046","1","1","0","0","0","0","2","1","0","1","0","2","1","0","1","0","2","0","2","0","0","0","2"
"Bethlehem","44.28034","-71.68814","1","1","0","0","0","0","2","1","0","1","0","2","1","0","1","0","2","0","2","0","0","0","2"
"Bethlehem","-28.23078","28.30707","1","1","0","0","0","0","2","1","0","1","0","2","1","0","1","0","2","0","2","0","0","0","2"
"Bethlehem","31.70487","35.20376","1","1","0","0","0","0","2","1","0","1","0","2","1","0","1","0","2","0","2","0","0","0","2"
"Bet Shemesh","31.73072","34.99293","1","0","0","0","0","0","1","1","0","0","0","1","1","0","0","0","1","0","1","0","0","0","1"
"Betws-y-Coed","53.09382","-3.80668","1","0","0","0","0","0","1","0","0","1","0","1","0","1","0","0","1","0","0","1","0","0","1"
"Beverley","53.84587","-0.42332","9","0","0","0","1","0","11","2","4","3","0","9","6","1","4","0","11","4","4","3","0","0","11"
"Beverley","-32.10839","116.92736","9","0","0","0","1","0","11","2","4","3","0","9","6","1","4","0","11","4","4","3","0","0","11"
"Beverley","-34.89512","138.54633","9","0","0","0","1","0","11","2","4","3","0","9","6","1","4","0","11","4","4","3","0","0","11"
"Bewdley","52.3757","-2.31833","1","0","0","0","0","0","1","0","1","0","0","1","0","0","1","0","1","0","1","0","0","0","1"
"Bexhill-on-Sea","50.85023","0.47095","109","5","0","8","9","0","139","38","44","52","1","135","39","25","75","0","139","25","68","38","2","6","139"
"Bexley","39.96895","-82.93768","6","0","0","0","0","0","7","1","2","2","0","5","1","4","2","0","7","3","1","3","0","0","7"
"Bexley","51.44162","0.14866","6","0","0","0","0","0","7","1","2","2","0","5","1","4","2","0","7","3","1","3","0","0","7"
"Bexley","-33.95","151.11667","6","0","0","0","0","0","7","1","2","2","0","5","1","4","2","0","7","3","1","3","0","0","7"
"Bexleyheath","51.46291","0.13943","13","1","0","1","0","0","16","2","5","6","0","13","6","3","6","1","16","1","2","12","1","0","16"
"Bexley North","-33.93848","151.11385","1","0","0","0","0","0","1","0","0","0","0","0","0","0","1","0","1","1","0","0","0","0","1"
"Bhadarwāh","32.97941","75.71723","1","0","0","0","0","0","1","0","0","1","0","1","1","0","0","0","1","0","0","1","0","0","1"
"Bhadohi","25.39526","82.5703","1","0","0","0","0","0","1","0","0","0","0","0","0","0","1","0","1","0","0","1","0","0","1"
"Bhadrakh","21.05447","86.5156","0","1","0","0","0","0","1","1","0","0","0","1","0","1","0","0","1","0","0","1","0","0","1"
"Bhadrapur","26.54404","88.09436","0","0","0","0","1","0","1","1","0","0","0","1","0","0","1","0","1","0","0","1","0","0","1"
"Bhakkar","31.62685","71.06471","0","1","0","0","0","0","1","1","0","0","0","1","0","0","1","0","1","0","0","1","0","0","1"
"Bhaktapur","27.67298","85.43005","13","0","0","0","0","0","13","8","1","2","1","12","6","4","4","0","14","0","0","9","1","4","14"
"Bhamo","24.25256","97.23357","3","0","0","0","0","0","3","0","2","0","0","2","2","1","0","0","3","1","1","1","0","0","3"
"Bhāndāria","22.48898","90.06273","1","0","0","0","0","0","1","1","0","0","0","1","0","0","1","0","1","0","1","0","0","0","1"
"Bharatpur","27.21731","77.49009","8","0","0","0","1","0","9","4","1","1","1","7","3","4","2","0","9","0","1","7","0","1","9"
"Bharatpur","27.6768","84.43589","8","0","0","0","1","0","9","4","1","1","1","7","3","4","2","0","9","0","1","7","0","1","9"
"Bharūch","21.69482","72.9805","1","0","0","0","0","0","1","0","1","0","0","1","0","0","1","0","1","0","0","0","0","1","1"
"Bhattarai Danda","27.88333","83.93333","1","0","0","0","0","0","1","0","0","0","1","1","0","0","1","0","1","0","0","1","0","0","1"
"Bhavnagar","21.76287","72.15331","7","0","0","0","0","0","7","6","0","1","0","7","0","0","7","0","7","0","0","7","0","0","7"
"Bhilai","21.20919","81.4285","6","0","0","0","0","0","6","6","0","0","0","6","2","0","4","0","6","0","2","4","0","0","6"
"Bhimbar","32.97465","74.07846","1","0","0","0","0","0","1","1","0","1","0","2","2","0","0","0","2","0","1","1","0","0","2"
"Bhiwandi","19.30023","73.05881","1","0","0","0","0","0","1","0","0","0","1","1","0","0","0","1","1","0","1","0","0","0","1"
"Bhopal","23.25469","77.40289","9","0","0","0","0","0","9","7","2","1","0","10","4","1","5","0","10","1","0","7","0","2","10"
"Bhubaneshwar","20.27241","85.83385","6","1","0","0","0","0","7","4","1","0","0","5","4","0","3","0","7","0","0","7","0","0","7"
"Bhuj","23.25397","69.66928","1","0","0","0","0","0","1","0","1","0","0","1","1","0","0","0","1","1","0","0","0","0","1"
"Bhusāval","21.04365","75.78506","1","0","0","0","0","0","1","1","0","0","0","1","0","0","1","0","1","0","0","1","0","0","1"
"Bibiani","6.46346","-2.31938","1","0","0","0","0","0","1","0","1","0","0","1","1","0","1","0","2","0","0","0","0","0","0"
"Bibra Lake","-32.09764","115.81921","0","1","0","0","0","0","1","1","0","0","0","1","0","0","1","0","1","0","0","1","0","0","1"
"Bicaz","47.46667","23.03333","1","0","0","0","0","0","1","1","0","0","0","1","1","0","0","0","1","0","0","1","0","0","1"
"Bicaz","46.91667","26.06667","1","0","0","0","0","0","1","1","0","0","0","1","1","0","0","0","1","0","0","1","0","0","1"
"Bicester","51.89998","-1.15357","16","1","0","1","1","0","19","5","8","3","0","16","9","3","7","0","19","5","5","7","0","2","19"
"Bicton","52.72829","-2.81649","1","0","0","0","0","0","1","0","0","0","1","1","0","1","0","0","1","1","0","0","0","0","1"
"Bicton","-32.02778","115.78333","1","0","0","0","0","0","1","0","0","0","1","1","0","1","0","0","1","1","0","0","0","0","1"
"Bidbid","23.40787","58.1283","0","0","0","0","1","0","1","0","0","0","0","0","0","0","1","0","1","1","0","0","0","0","1"
"Bideford","51.01678","-4.20832","3","0","0","0","0","0","3","1","1","1","0","3","1","0","2","0","3","1","0","2","0","0","3"
"Bidhūna","26.80172","79.50829","1","0","0","0","0","0","1","0","0","0","0","0","0","1","0","0","1","0","0","1","0","0","1"
"Bielefeld","52.03333","8.53333","2","0","0","0","0","0","2","0","2","0","0","2","0","0","2","0","2","0","0","0","0","2","2"
"Bigastro","38.06237","-0.89841","1","0","0","0","0","0","1","0","0","0","0","0","0","0","1","0","1","1","0","0","0","0","1"
"Biggar","52.0668","-108.00135","0","1","0","0","0","0","1","1","0","0","0","1","1","0","0","0","1","0","0","1","0","0","1"
"Biggar","55.62297","-3.52455","0","1","0","0","0","0","1","1","0","0","0","1","1","0","0","0","1","0","0","1","0","0","1"
"Biggleswade","52.08652","-0.26493","6","0","0","0","0","0","6","0","3","0","1","4","2","1","3","0","6","3","0","3","0","0","6"
"Bihać","44.81694","15.87083","1","0","0","0","0","0","1","0","0","0","0","0","0","0","1","0","1","0","0","1","0","0","1"
"Bijapur","16.82442","75.71537","1","0","0","0","0","0","1","0","0","1","0","1","0","0","1","0","1","0","0","0","0","1","1"
"Bijeljina","44.75874","19.21437","1","0","0","0","0","0","1","0","1","0","0","1","1","0","0","0","1","0","0","0","0","1","1"
"Bilaspur","31.33027","76.75663","2","0","0","0","0","0","2","1","1","0","0","2","0","1","1","0","2","0","0","2","0","0","2"
"Bilbays","30.42039","31.56223","2","0","0","0","0","0","2","1","0","0","0","1","0","0","0","2","2","1","1","0","0","0","2"
"Bilgola Plateau","-33.64781","151.31212","1","0","0","0","0","0","1","0","0","1","0","1","0","0","1","0","1","0","0","1","0","0","1"
"Billericay","51.62867","0.41963","8","1","0","0","0","0","10","3","5","1","0","9","3","0","7","0","10","1","2","6","1","0","10"
"Billingham","54.58881","-1.29034","2","0","0","0","0","0","2","1","0","0","0","1","0","0","2","0","2","1","1","0","0","0","2"
"Billingshurst","51.02312","-0.45359","1","0","0","1","0","0","2","1","0","1","0","2","2","0","0","0","2","0","0","2","0","0","2"
"Bilovods'k","49.20846","39.58975","1","0","0","0","0","0","1","1","0","0","0","1","0","1","0","0","1","0","0","1","0","0","1"
"Bilqās","31.21452","31.35798","1","0","0","0","0","0","1","1","0","0","0","1","1","0","0","0","1","0","0","1","0","0","1"
"Bilston","55.8703","-3.17814","2","0","0","0","0","0","2","0","1","1","0","2","1","0","1","0","2","0","1","1","0","0","2"
"Bilston","52.56568","-2.07367","2","0","0","0","0","0","2","0","1","1","0","2","1","0","1","0","2","0","1","1","0","0","2"
"Binfield","51.43159","-0.7881","1","0","0","0","0","0","1","1","0","0","0","1","1","0","0","0","1","0","0","1","0","0","1"
"Bingley","53.84861","-1.83857","1","0","0","0","0","0","1","0","0","1","0","1","0","0","1","0","1","0","0","1","0","0","1"
"Binzen","47.63333","7.61667","1","0","0","0","0","0","1","0","0","0","0","0","0","0","1","0","1","0","0","1","0","0","1"
"Biratnagar","26.45505","87.27007","12","0","0","0","0","0","12","9","2","0","0","11","3","4","5","0","12","1","1","9","0","1","12"
"Birchington-on-Sea","51.37575","1.3048","3","0","0","0","0","0","3","0","2","1","0","3","0","2","1","0","3","1","1","1","0","0","3"
"Birgañj","27.01709","84.8808","7","0","0","0","0","0","7","6","0","2","0","8","2","2","4","0","8","0","0","7","0","1","8"
"Birine","35.635","3.225","1","0","0","0","0","0","1","0","0","0","0","0","0","0","0","0","0","1","0","0","0","0","1"
"Birkenhead","53.39337","-3.01479","8","0","0","1","2","0","12","1","6","2","1","10","7","1","4","0","12","5","1","5","0","1","12"
"Birkenhead","-34.83685","138.49788","8","0","0","1","2","0","12","1","6","2","1","10","7","1","4","0","12","5","1","5","0","1","12"
"Birkirkara","35.89722","14.46111","2","0","0","0","0","0","2","2","0","0","0","2","0","1","1","0","2","0","0","2","0","0","2"
"Birmingham","33.52066","-86.80249","215","12","0","10","33","0","289","60","67","82","5","214","115","30","141","3","289","54","65","162","5","4","290"
"Birmingham","42.5467","-83.21132","215","12","0","10","33","0","289","60","67","82","5","214","115","30","141","3","289","54","65","162","5","4","290"
"Birmingham","52.48142","-1.89983","215","12","0","10","33","0","289","60","67","82","5","214","115","30","141","3","289","54","65","162","5","4","290"
"Birtinya","-26.74322","153.11913","0","0","0","0","1","0","1","1","0","0","0","1","0","0","1","0","1","0","0","1","0","0","1"
"Birtley","55.08333","-2.18333","1","0","0","0","0","0","1","0","0","0","0","0","0","1","0","0","1","0","1","0","0","0","1"
"Bishkek","42.87","74.59","11","1","0","1","1","0","14","9","1","2","1","13","2","4","8","0","14","0","1","13","0","0","14"
"Bishop","37.36354","-118.39511","4","0","0","0","0","0","4","1","0","0","0","1","4","0","0","0","4","0","3","1","0","0","4"
"Bishop","27.58614","-97.79916","4","0","0","0","0","0","4","1","0","0","0","1","4","0","0","0","4","0","3","1","0","0","4"
"Bishop Auckland","54.65554","-1.67706","4","0","0","0","1","0","7","3","1","3","0","7","3","0","4","0","7","1","3","3","0","0","7"
"Bishopbriggs","55.90669","-4.21869","1","0","0","0","0","0","1","0","0","1","0","1","0","0","1","0","1","0","0","1","0","0","1"
"Bishops Stortford","51.87113","0.15868","10","0","0","0","3","0","15","5","4","4","0","13","5","3","7","0","15","0","4","11","0","0","15"
"Bishopton","55.90969","-4.5056","1","0","0","0","0","0","1","0","1","0","0","1","0","1","0","0","1","1","0","0","0","0","1"
"Bishopton","54.58333","-1.43333","1","0","0","0","0","0","1","0","1","0","0","1","0","1","0","0","1","1","0","0","0","0","1"
"Bistriţa","47.13316","24.50011","1","0","0","0","0","0","1","0","1","0","0","1","0","1","0","0","1","1","0","0","0","0","1"
"Bitola","41.03143","21.33474","3","0","0","0","1","0","4","0","2","0","0","2","1","2","1","0","4","3","0","0","0","1","4"
"Bitton","51.42479","-2.45965","1","0","0","0","0","0","1","0","1","0","0","1","1","0","0","0","1","0","0","1","0","0","1"
"Biu","10.61285","12.19458","1","0","0","0","0","0","1","1","0","0","0","1","0","1","0","0","1","0","0","1","0","0","1"
"Bizerte","37.27442","9.87391","4","0","0","0","0","0","4","0","2","1","1","4","1","1","2","0","4","3","0","1","0","0","4"
"Blackburn","55.86667","-3.63333","17","0","0","1","1","0","20","5","8","4","1","18","10","2","8","0","20","9","3","6","1","1","20"
"Blackburn","53.75","-2.48333","17","0","0","1","1","0","20","5","8","4","1","18","10","2","8","0","20","9","3","6","1","1","20"
"Blackburn","57.20376","-2.28842","17","0","0","1","1","0","20","5","8","4","1","18","10","2","8","0","20","9","3","6","1","1","20"
"Blackburn","-37.81901","145.15326","17","0","0","1","1","0","20","5","8","4","1","18","10","2","8","0","20","9","3","6","1","1","20"
"Blackpool","53.81667","-3.05","23","4","0","3","1","0","33","9","12","9","0","30","12","4","17","0","33","9","11","12","1","0","33"
"Blackridge","55.88523","-3.77479","1","0","0","0","0","0","1","0","1","0","0","1","0","1","0","0","1","1","0","0","0","0","1"
"Black River","18.02636","-77.84873","1","0","0","0","0","0","1","0","0","0","0","0","1","0","0","0","1","0","0","0","0","1","1"
"Black River","44.01256","-75.79437","1","0","0","0","0","0","1","0","0","0","0","0","1","0","0","0","1","0","0","0","0","1","1"
"Black River","-19.22517","146.61787","1","0","0","0","0","0","1","0","0","0","0","0","1","0","0","0","1","0","0","0","0","1","1"
"Blackwood","39.80234","-75.06406","13","0","0","0","1","0","14","2","8","3","1","14","3","4","7","0","14","4","2","7","0","1","14"
"Blackwood","53.29308","-6.81843","13","0","0","0","1","0","14","2","8","3","1","14","3","4","7","0","14","4","2","7","0","1","14"
"Blackwood","55.66667","-3.91667","13","0","0","0","1","0","14","2","8","3","1","14","3","4","7","0","14","4","2","7","0","1","14"
"Blackwood","51.66778","-3.2075","13","0","0","0","1","0","14","2","8","3","1","14","3","4","7","0","14","4","2","7","0","1","14"
"Blackwood","-35.02139","138.61429","13","0","0","0","1","0","14","2","8","3","1","14","3","4","7","0","14","4","2","7","0","1","14"
"Blandford Forum","50.86073","-2.16174","2","0","0","0","1","0","3","1","0","1","0","2","0","0","3","0","3","0","2","1","0","0","3"
"Blankenfelde","52.61863","13.39057","1","0","0","0","0","0","1","0","0","1","0","1","0","0","1","0","1","0","0","1","0","0","1"
"Blantyre","55.79634","-4.09485","6","0","0","0","0","0","7","1","1","1","4","7","4","2","1","0","7","3","0","3","1","0","7"
"Blantyre","-15.78499","35.00854","6","0","0","0","0","0","7","1","1","1","4","7","4","2","1","0","7","3","0","3","1","0","7"
"Blaydon-on-Tyne","54.96461","-1.71392","4","0","0","0","1","0","5","1","2","2","0","5","1","0","4","0","5","1","1","3","0","0","5"
"Blewbury","51.5688","-1.23261","1","0","0","0","0","0","1","0","0","1","0","1","0","0","1","0","1","0","0","1","0","0","1"
"Blida","36.47004","2.8277","3","0","0","0","0","0","3","2","0","0","0","2","1","0","2","0","3","0","0","3","0","0","3"
"Blidworth","53.09849","-1.11689","1","0","0","0","0","0","1","0","0","1","0","1","1","0","0","0","1","0","1","0","0","0","1"
"Bloemfontein","-29.12107","26.214","1","0","0","0","0","0","1","0","0","1","0","1","0","0","1","0","1","0","0","1","0","0","1"
"Bloomfield Hills","42.58364","-83.24549","1","0","0","0","0","0","1","0","0","0","0","0","1","0","0","0","1","0","1","0","0","0","1"
"Bludenz","47.15476","9.82255","1","0","0","0","0","0","1","0","0","0","1","1","0","0","1","0","1","0","1","0","0","0","1"
"Blue Springs","39.01695","-94.28161","1","0","0","0","0","0","1","0","0","0","0","0","0","0","1","0","1","1","0","0","0","0","1"
"Blyth","55.12708","-1.50856","25","1","0","0","5","0","31","5","6","7","0","18","8","3","20","0","31","10","7","11","1","2","31"
"Bo","7.96472","-11.73833","4","1","0","0","0","0","5","0","5","0","0","5","2","2","0","1","5","0","0","2","0","3","5"
"Bo","20.67264","105.53625","4","1","0","0","0","0","5","0","5","0","0","5","2","2","0","1","5","0","0","2","0","3","5"
"Bobo-Dioulasso","11.17715","-4.2979","4","2","0","0","0","0","6","1","4","1","0","6","3","2","1","0","6","1","1","2","0","2","6"
"Boca Raton","26.35869","-80.0831","0","0","0","0","0","0","1","0","0","0","0","0","1","0","0","0","1","0","0","1","0","0","1"
"Bocholt","51.17337","5.57994","1","0","0","0","0","0","1","0","0","1","0","1","0","0","1","0","1","0","0","1","0","0","1"
"Bocholt","51.83879","6.61531","1","0","0","0","0","0","1","0","0","1","0","1","0","0","1","0","1","0","0","1","0","0","1"
"Boconó","9.25385","-70.25105","0","0","0","0","0","0","0","0","0","0","0","0","0","0","0","0","0","0","0","0","0","0","0"
"Bodhan","18.66208","77.88581","2","0","0","0","0","0","2","2","0","0","0","2","0","0","2","0","2","0","0","2","0","0","2"
"Bodmin","50.47151","-4.7243","2","0","0","0","2","0","4","4","0","0","0","4","1","0","3","0","4","0","3","1","0","0","4"
"Boghni","36.54222","3.95306","1","0","0","0","0","0","1","0","1","0","0","1","0","1","0","0","1","1","0","0","0","0","1"
"Bognor Regis","50.78206","-0.67978","10","0","0","0","1","0","12","1","7","3","0","11","2","3","7","0","12","5","1","4","1","1","12"
"Bogor","-6.3314","105.8684","2","0","0","0","0","0","2","2","0","0","0","2","1","0","1","0","2","0","0","2","0","0","2"
"Bogor","-6.59444","106.78917","2","0","0","0","0","0","2","2","0","0","0","2","1","0","1","0","2","0","0","2","0","0","2"
"Bogotá","4.60971","-74.08175","23","0","0","0","0","0","23","11","3","2","0","16","6","7","8","0","21","6","5","10","0","2","23"
"Bogra","24.85098","89.37108","7","1","0","0","0","0","8","0","2","2","3","7","3","1","2","2","8","0","1","6","0","1","8"
"Bokspits","-26.9","20.7","1","0","0","0","0","0","1","0","1","0","0","1","1","0","0","0","1","0","0","0","0","1","1"
"Bolaang","0.9411","124.1556","1","0","0","0","0","0","1","0","0","0","0","0","1","0","0","0","1","1","0","0","0","0","1"
"Bolgatanga","10.78556","-0.85139","1","0","0","0","0","0","1","0","0","1","0","1","0","0","1","0","1","0","0","0","0","1","1"
"Bollington","53.29446","-2.10963","2","0","0","0","0","0","2","0","0","2","0","2","1","0","1","0","2","0","2","0","0","0","2"
"Bolney","50.99534","-0.20303","1","0","0","0","0","0","1","0","0","0","0","0","0","0","1","0","1","0","0","1","0","0","1"
"Bolton","32.34931","-90.4601","28","4","0","1","4","0","39","8","9","19","0","36","15","4","20","0","39","5","9","25","0","0","39"
"Bolton","34.32072","-78.40195","28","4","0","1","4","0","39","8","9","19","0","36","15","4","20","0","39","5","9","25","0","0","39"
"Bolton","42.43343","-71.60784","28","4","0","1","4","0","39","8","9","19","0","36","15","4","20","0","39","5","9","25","0","0","39"
"Bolton","53.58333","-2.43333","28","4","0","1","4","0","39","8","9","19","0","36","15","4","20","0","39","5","9","25","0","0","39"
"Bolton le Sands","54.09632","-2.80017","1","0","0","0","0","0","1","0","0","0","0","0","0","0","0","0","0","0","1","0","0","0","1"
"Bolu","40.73583","31.60611","1","1","0","0","0","0","2","1","0","0","0","1","2","0","0","0","2","2","0","0","0","0","2"
"Bolvadin","38.71111","31.04861","1","0","0","0","0","0","1","0","1","0","0","1","0","1","0","0","1","0","0","0","0","1","1"
"Bondi Beach","-33.89079","151.27852","1","0","0","0","0","0","1","0","0","1","0","1","0","0","1","0","1","0","0","1","0","0","1"
"Bondojito","20.44395","-99.70022","1","0","0","0","0","0","1","1","0","0","0","1","0","1","0","0","1","0","0","1","0","0","1"
"Bonn","50.73438","7.09549","3","0","0","0","0","0","3","0","1","1","0","2","2","0","1","0","3","1","1","1","0","0","3"
"Bonny","4.4516","7.17074","1","0","0","0","0","0","1","0","1","0","0","1","1","0","0","0","1","0","1","0","0","0","1"
"Bonnybridge","56.00152","-3.8886","2","0","0","0","0","0","2","0","0","2","0","2","0","0","2","0","2","0","0","2","0","0","2"
"Boone","42.0597","-93.88023","1","0","0","0","0","0","1","1","0","0","0","1","1","0","0","0","1","0","0","1","0","0","1"
"Boone","36.21679","-81.67455","1","0","0","0","0","0","1","1","0","0","0","1","1","0","0","0","1","0","0","1","0","0","1"
"Bootle","53.46667","-3.01667","1","0","0","1","0","0","2","1","1","0","0","2","1","1","0","0","2","1","0","1","0","0","2"
"Bor","49.71159","12.77516","1","0","0","0","0","0","1","0","1","0","0","1","0","0","1","0","1","0","0","1","0","0","1"
"Bor","57.11667","14.16667","1","0","0","0","0","0","1","0","1","0","0","1","0","0","1","0","1","0","0","1","0","0","1"
"Bor","44.07488","22.09591","1","0","0","0","0","0","1","0","1","0","0","1","0","0","1","0","1","0","0","1","0","0","1"
"Bor","6.20889","31.55861","1","0","0","0","0","0","1","0","1","0","0","1","0","0","1","0","1","0","0","1","0","0","1"
"Bor","37.89056","34.55889","1","0","0","0","0","0","1","0","1","0","0","1","0","0","1","0","1","0","0","1","0","0","1"
"Bor","56.35808","44.07477","1","0","0","0","0","0","1","0","1","0","0","1","0","0","1","0","1","0","0","1","0","0","1"
"Bor","61.60111","90.01806","1","0","0","0","0","0","1","0","1","0","0","1","0","0","1","0","1","0","0","1","0","0","1"
"Borås","57.72101","12.9401","1","0","0","0","0","0","1","1","0","0","0","1","0","0","1","0","1","0","0","1","0","0","1"
"Bordeaux","44.84044","-0.5805","0","0","0","0","0","0","1","0","0","1","0","1","1","0","0","0","1","0","0","1","0","0","1"
"Bordj Bou Arreridj","36.07321","4.76108","4","0","0","0","0","0","4","0","2","0","0","2","0","2","1","0","3","0","0","1","0","2","3"
"Bordon","51.11357","-0.86245","4","0","0","0","0","0","4","1","0","3","0","4","3","0","1","0","4","0","0","4","0","0","4"
"Borehamwood","51.65468","-0.27762","8","0","0","1","1","0","10","2","5","1","0","8","3","1","6","0","10","2","2","6","0","0","10"
"Borgloon","50.80505","5.34366","1","0","0","0","0","0","1","0","1","0","0","1","0","0","1","0","1","1","0","0","0","0","1"
"Borough Green","51.29158","0.30478","1","0","0","0","0","0","1","0","1","0","0","1","1","0","0","0","1","0","1","0","0","0","1"
"Borough Park","40.63399","-73.99681","1","0","0","0","0","0","1","0","0","0","0","0","0","1","0","0","1","1","0","0","0","0","1"
"Bosaso","11.28421","49.18158","4","0","0","0","0","0","4","0","2","0","2","4","1","2","0","1","4","2","0","2","0","0","4"
"Bosham","50.83088","-0.85384","1","0","0","0","0","0","1","1","0","0","0","1","0","1","0","0","1","0","0","1","0","0","1"
"Boston","30.79186","-83.78989","10","0","0","0","1","0","11","1","3","4","1","9","6","2","3","0","11","4","4","2","1","0","11"
"Boston","40.31201","-79.8231","10","0","0","0","1","0","11","1","3","4","1","9","6","2","3","0","11","4","4","2","1","0","11"
"Boston","42.62895","-78.73753","10","0","0","0","1","0","11","1","3","4","1","9","6","2","3","0","11","4","4","2","1","0","11"
"Boston","37.6093","-75.84271","10","0","0","0","1","0","11","1","3","4","1","9","6","2","3","0","11","4","4","2","1","0","11"
"Boston","42.35843","-71.05977","10","0","0","0","1","0","11","1","3","4","1","9","6","2","3","0","11","4","4","2","1","0","11"
"Boston","53.03083","-8.93167","10","0","0","0","1","0","11","1","3","4","1","9","6","2","3","0","11","4","4","2","1","0","11"
"Boston","52.97633","-0.02664","10","0","0","0","1","0","11","1","3","4","1","9","6","2","3","0","11","4","4","2","1","0","11"
"Boston","7.87111","126.36417","10","0","0","0","1","0","11","1","3","4","1","9","6","2","3","0","11","4","4","2","1","0","11"
"Bothaville","-27.3887","26.61701","1","0","0","0","0","0","1","0","0","1","0","1","1","0","0","0","1","0","0","1","0","0","1"
"Bouaké","7.69385","-5.03031","2","0","0","0","0","0","2","0","2","0","0","2","1","1","0","0","2","2","0","0","0","0","2"
"Boufarik","36.57413","2.91214","1","0","0","0","0","0","1","1","0","0","0","1","1","0","0","0","1","0","0","1","0","0","1"
"Boughton","53.2","-0.98333","1","0","0","0","0","0","1","1","0","0","0","1","0","0","0","1","1","0","1","0","0","0","1"
"Boukhalef","35.7328","-5.89954","0","0","0","0","0","0","0","0","0","0","0","0","1","0","0","0","1","0","0","0","0","1","1"
"Boulder","46.23659","-112.12083","1","0","0","0","1","0","2","0","0","2","0","2","1","0","1","0","2","0","0","2","0","0","2"
"Boulder","40.01499","-105.27055","1","0","0","0","1","0","2","0","0","2","0","2","1","0","1","0","2","0","0","2","0","0","2"
"Boulder","-30.78204","121.4912","1","0","0","0","1","0","2","0","0","2","0","2","1","0","1","0","2","0","0","2","0","0","2"
"Boulogne-Billancourt","48.83545","2.24128","0","0","0","1","0","0","1","1","0","0","0","1","1","0","0","0","1","0","0","1","0","0","1"
"Boumagueur","35.5052","5.5525","1","0","0","0","0","0","1","0","0","0","0","0","1","0","0","0","1","0","0","1","0","0","1"
"Bountiful","40.88939","-111.88077","1","0","0","0","0","0","1","0","1","0","0","1","1","0","0","0","1","0","0","1","0","0","1"
"Bourne","41.74122","-70.59892","5","0","0","0","0","0","5","0","1","2","0","3","2","0","3","0","5","2","1","2","0","0","5"
"Bourne","52.76667","-0.38333","5","0","0","0","0","0","5","0","1","2","0","3","2","0","3","0","5","2","1","2","0","0","5"
"Bourne End","51.57622","-0.71291","2","0","0","0","0","1","3","1","0","0","0","1","1","1","1","0","3","0","0","3","0","0","3"
"Bournemouth","50.72048","-1.8795","35","2","0","0","6","0","44","8","14","18","1","41","14","8","21","1","44","8","8","24","1","3","44"
"Bourton on the Water","51.88584","-1.75492","0","0","0","0","1","0","1","0","0","1","0","1","1","0","0","0","1","0","0","1","0","0","1"
"Bovingdon","51.72312","-0.5367","1","0","0","0","0","0","1","0","1","0","0","1","1","0","0","0","1","0","0","1","0","0","1"
"Bowie","33.559","-97.84865","1","0","0","0","0","0","1","0","1","0","0","1","0","1","0","0","1","1","0","0","0","0","1"
"Bowie","38.94278","-76.73028","1","0","0","0","0","0","1","0","1","0","0","1","0","1","0","0","1","1","0","0","0","0","1"
"Bowling Green","39.34199","-91.19514","1","0","0","0","0","0","1","1","0","0","0","1","0","0","1","0","1","0","0","1","0","0","1"
"Bowling Green","36.99032","-86.4436","1","0","0","0","0","0","1","1","0","0","0","1","0","0","1","0","1","0","0","1","0","0","1"
"Bowling Green","41.37477","-83.65132","1","0","0","0","0","0","1","1","0","0","0","1","0","0","1","0","1","0","0","1","0","0","1"
"Bowling Green","27.63837","-81.82397","1","0","0","0","0","0","1","1","0","0","0","1","0","0","1","0","1","0","0","1","0","0","1"
"Bowling Green","39.6237","-78.80446","1","0","0","0","0","0","1","1","0","0","0","1","0","0","1","0","1","0","0","1","0","0","1"
"Bowling Green","38.04958","-77.34665","1","0","0","0","0","0","1","1","0","0","0","1","0","0","1","0","1","0","0","1","0","0","1"
"Bowmore","55.75583","-6.28426","1","0","0","0","0","0","1","0","1","0","0","1","0","0","1","0","1","0","0","0","0","1","1"
"Box","51.41472","-2.24556","1","0","0","0","0","0","1","0","0","1","0","1","0","0","1","0","1","0","0","1","0","0","1"
"Boyacá","5.45371","-73.3625","1","0","0","0","0","0","1","0","1","0","0","1","0","1","0","0","1","0","0","1","0","0","1"
"Boyle","33.704","-90.72648","1","0","0","0","0","0","1","0","0","0","0","0","0","0","1","0","1","0","1","0","0","0","1"
"Boyle","53.96667","-8.3","1","0","0","0","0","0","1","0","0","0","0","0","0","0","1","0","1","0","1","0","0","0","1"
"Boynton Beach","26.52535","-80.06643","1","0","0","0","0","0","1","1","0","0","0","1","0","0","1","0","1","0","1","0","0","0","1"
"Brackley","52.03333","-1.15","6","0","0","0","1","0","7","1","1","3","0","5","1","1","5","0","7","1","2","4","0","0","7"
"Bracknell","51.41363","-0.75054","43","0","0","0","1","0","47","8","9","20","0","37","19","3","25","0","47","7","12","27","0","1","47"
"Bradford","35.42314","-91.45596","37","2","0","3","2","0","49","15","6","18","0","39","15","8","26","0","49","3","10","35","0","1","49"
"Bradford","41.17726","-89.6576","37","2","0","3","2","0","49","15","6","18","0","39","15","8","26","0","49","3","10","35","0","1","49"
"Bradford","36.07645","-88.81006","37","2","0","3","2","0","49","15","6","18","0","39","15","8","26","0","49","3","10","35","0","1","49"
"Bradford","40.13227","-84.43078","37","2","0","3","2","0","49","15","6","18","0","39","15","8","26","0","49","3","10","35","0","1","49"
"Bradford","41.9559","-78.64392","37","2","0","3","2","0","49","15","6","18","0","39","15","8","26","0","49","3","10","35","0","1","49"
"Bradford","43.99257","-72.12898","37","2","0","3","2","0","49","15","6","18","0","39","15","8","26","0","49","3","10","35","0","1","49"
"Bradford","41.39899","-71.73701","37","2","0","3","2","0","49","15","6","18","0","39","15","8","26","0","49","3","10","35","0","1","49"
"Bradford","45.06673","-68.93781","37","2","0","3","2","0","49","15","6","18","0","39","15","8","26","0","49","3","10","35","0","1","49"
"Bradford","53.79391","-1.75206","37","2","0","3","2","0","49","15","6","18","0","39","15","8","26","0","49","3","10","35","0","1","49"
"Bradford Abbas","50.92643","-2.58751","2","0","0","0","0","0","2","1","0","1","0","2","1","1","0","0","2","0","0","2","0","0","2"
"Bradford-on-Avon","51.34772","-2.25065","3","0","0","0","0","0","3","0","1","1","0","2","1","2","0","0","3","0","1","2","0","0","3"
"Braga","41.55032","-8.42005","2","0","0","0","0","0","2","0","1","0","1","2","1","0","1","0","2","1","0","1","0","0","2"
"Bragadiru","43.76667","25.51667","1","0","0","0","0","0","1","1","0","0","0","1","0","1","0","0","1","0","0","1","0","0","1"
"Bragadiru","44.37111","25.9775","1","0","0","0","0","0","1","1","0","0","0","1","0","1","0","0","1","0","0","1","0","0","1"
"Brahmapur","19.31151","84.7929","1","0","0","0","0","0","1","0","0","1","0","1","0","0","1","0","1","0","0","0","0","1","1"
"Brăila","45.27152","27.97429","0","1","0","0","0","0","1","1","0","0","0","1","0","1","0","0","1","0","0","1","0","0","1"
"Braintree","42.20384","-71.00215","9","1","0","0","1","0","11","1","5","3","0","9","5","1","5","0","11","6","1","4","0","0","11"
"Braintree","51.87819","0.55292","9","1","0","0","1","0","11","1","5","3","0","9","5","1","5","0","11","6","1","4","0","0","11"
"Bramhall","53.35801","-2.16539","1","0","0","1","1","0","3","1","1","1","0","3","2","0","1","0","3","0","1","2","0","0","3"
"Bramhope","53.88489","-1.61641","0","0","0","1","0","0","1","0","0","1","0","1","0","0","1","0","1","0","0","1","0","0","1"
"Bramley","53.41667","-1.26667","1","0","0","0","0","0","1","0","1","0","0","1","1","0","0","0","1","1","0","0","0","0","1"
"Bramley","51.32677","-1.05938","1","0","0","0","0","0","1","0","1","0","0","1","1","0","0","0","1","1","0","0","0","0","1"
"Bramley","51.19451","-0.55927","1","0","0","0","0","0","1","0","1","0","0","1","1","0","0","0","1","1","0","0","0","0","1"
"Brampton","43.68341","-79.76633","4","0","0","0","0","0","4","1","0","2","0","3","1","1","2","0","4","0","1","3","0","0","4"
"Brampton","54.95","-2.73333","4","0","0","0","0","0","4","1","0","2","0","3","1","1","2","0","4","0","1","3","0","0","4"
"Brampton","52.32039","-0.22007","4","0","0","0","0","0","4","1","0","2","0","3","1","1","2","0","4","0","1","3","0","0","4"
"Brandon","49.84692","-99.95306","1","0","0","0","0","0","1","0","0","1","0","1","0","0","1","0","1","0","1","0","0","0","1"
"Brandon","43.5947","-96.57199","1","0","0","0","0","0","1","0","0","1","0","1","0","0","1","0","1","0","1","0","0","0","1"
"Brandon","32.2732","-89.98592","1","0","0","0","0","0","1","0","0","1","0","1","0","0","1","0","1","0","1","0","0","0","1"
"Brandon","43.73526","-88.78122","1","0","0","0","0","0","1","0","0","1","0","1","0","0","1","0","1","0","1","0","0","0","1"
"Brandon","27.9378","-82.28592","1","0","0","0","0","0","1","0","0","1","0","1","0","0","1","0","1","0","1","0","0","0","1"
"Brandon","43.79812","-73.08761","1","0","0","0","0","0","1","0","0","1","0","1","0","0","1","0","1","0","1","0","0","0","1"
"Brandon","54.75","-1.61667","1","0","0","0","0","0","1","0","0","1","0","1","0","0","1","0","1","0","1","0","0","0","1"
"Brandon","52.38432","-1.3996","1","0","0","0","0","0","1","0","0","1","0","1","0","0","1","0","1","0","1","0","0","0","1"
"Brandon","-19.55389","147.35304","1","0","0","0","0","0","1","0","0","1","0","1","0","0","1","0","1","0","1","0","0","0","1"
"Brasília","-15.77972","-47.92972","1","0","0","0","0","0","1","0","1","0","0","1","0","1","0","0","1","0","0","1","0","0","1"
"Braşov","45.64861","25.60613","1","0","0","0","0","0","1","0","1","0","0","1","0","0","1","0","1","0","0","1","0","0","1"
"Brasschaat","51.2912","4.49182","1","0","0","0","0","0","1","1","0","0","0","1","0","0","1","0","1","0","0","1","0","0","1"
"Bratislava","48.14816","17.10674","8","1","0","0","0","0","9","0","1","4","0","5","1","3","5","0","9","3","1","4","0","1","9"
"Braunston","52.28979","-1.20266","1","0","0","0","0","0","1","0","0","1","0","1","0","0","1","0","1","0","0","1","0","0","1"
"Braunton","51.10847","-4.16131","1","0","0","0","0","0","1","0","1","0","0","1","0","0","1","0","1","0","0","1","0","0","1"
"Bray","34.63786","-97.81753","3","0","0","0","0","0","3","0","2","1","0","3","2","0","1","0","3","0","2","1","0","0","3"
"Bray","53.20278","-6.09833","3","0","0","0","0","0","3","0","2","1","0","3","2","0","1","0","3","0","2","1","0","0","3"
"Bray","51.5034","-0.68768","3","0","0","0","0","0","3","0","2","1","0","3","2","0","1","0","3","0","2","1","0","0","3"
"Brazzaville","-4.26613","15.28318","1","0","0","0","0","0","1","0","0","0","1","1","1","0","0","0","1","0","0","0","1","0","1"
"Brea","33.91668","-117.90006","0","0","0","0","0","0","0","0","0","0","0","0","0","0","0","0","0","0","0","0","0","0","0"
"Brechin","56.72993","-2.65729","3","0","0","0","0","0","3","1","2","0","0","3","1","0","2","0","3","0","0","2","0","1","3"
"Brecon","51.94612","-3.38887","6","0","0","0","2","0","8","1","2","4","0","7","2","1","5","0","8","1","4","3","0","0","8"
"Breda","41.74833","2.55964","2","0","0","0","0","0","2","0","0","1","0","1","0","1","1","0","2","0","1","1","0","0","2"
"Breda","51.58656","4.77596","2","0","0","0","0","0","2","0","0","1","0","1","0","1","1","0","2","0","1","1","0","0","2"
"Breda","45.7225","12.33083","2","0","0","0","0","0","2","0","0","1","0","1","0","1","1","0","2","0","1","1","0","0","2"
"Bredon","52.03008","-2.11671","1","0","0","0","0","0","1","0","1","0","0","1","1","0","0","0","1","1","0","0","0","0","1"
"Bremen","15.22","-92.34944","0","0","0","0","1","0","1","0","1","0","0","1","0","1","0","0","1","0","0","1","0","0","1"
"Bremen","41.44644","-86.14806","0","0","0","0","1","0","1","0","1","0","0","1","0","1","0","0","1","0","0","1","0","0","1"
"Bremen","33.72122","-85.1455","0","0","0","0","1","0","1","0","1","0","0","1","0","1","0","0","1","0","0","1","0","0","1"
"Bremen","39.70173","-82.42682","0","0","0","0","1","0","1","0","1","0","0","1","0","1","0","0","1","0","0","1","0","0","1"
"Bremen","44.00147","-69.42866","0","0","0","0","1","0","1","0","1","0","0","1","0","1","0","0","1","0","0","1","0","0","1"
"Bremen","53.07582","8.80717","0","0","0","0","1","0","1","0","1","0","0","1","0","1","0","0","1","0","0","1","0","0","1"
"Brent","35.36787","-94.79356","1","0","0","0","0","0","1","0","1","0","0","1","0","0","1","0","1","0","0","0","1","0","1"
"Brent","30.46881","-87.23608","1","0","0","0","0","0","1","0","1","0","0","1","0","0","1","0","1","0","0","0","1","0","1"
"Brent","32.93735","-87.16472","1","0","0","0","0","0","1","0","1","0","0","1","0","0","1","0","1","0","0","0","1","0","1"
"Brent","51.55306","-0.3023","1","0","0","0","0","0","1","0","1","0","0","1","0","0","1","0","1","0","0","0","1","0","1"
"Brent Knoll","51.25219","-2.95744","1","0","0","0","0","0","1","0","0","1","0","1","1","0","0","0","1","0","0","1","0","0","1"
"Brentwood","37.93187","-121.69579","12","3","0","2","0","0","19","4","3","11","0","18","10","1","8","0","19","1","3","13","2","0","19"
"Brentwood","38.61755","-90.34928","12","3","0","2","0","0","19","4","3","11","0","18","10","1","8","0","19","1","3","13","2","0","19"
"Brentwood","36.03312","-86.78278","12","3","0","2","0","0","19","4","3","11","0","18","10","1","8","0","19","1","3","13","2","0","19"
"Brentwood","40.37063","-79.97477","12","3","0","2","0","0","19","4","3","11","0","18","10","1","8","0","19","1","3","13","2","0","19"
"Brentwood","38.94317","-76.95664","12","3","0","2","0","0","19","4","3","11","0","18","10","1","8","0","19","1","3","13","2","0","19"
"Brentwood","40.78121","-73.24623","12","3","0","2","0","0","19","4","3","11","0","18","10","1","8","0","19","1","3","13","2","0","19"
"Brentwood","42.9787","-71.07284","12","3","0","2","0","0","19","4","3","11","0","18","10","1","8","0","19","1","3","13","2","0","19"
"Brentwood","51.62127","0.30556","12","3","0","2","0","0","19","4","3","11","0","18","10","1","8","0","19","1","3","13","2","0","19"
"Brentwood","-32.04347","115.85246","12","3","0","2","0","0","19","4","3","11","0","18","10","1","8","0","19","1","3","13","2","0","19"
"Brescia","45.53558","10.21472","0","0","0","0","0","1","1","1","0","0","0","1","0","1","0","0","1","0","0","0","1","0","1"
"Bressuire","46.84158","-0.49042","1","0","0","0","0","0","1","1","0","0","0","1","0","0","1","0","1","0","0","1","0","0","1"
"Bretigny","47.4","5.1","0","1","0","0","0","0","1","1","0","0","0","1","0","1","0","0","1","0","1","0","0","0","1"
"Brewster","48.09598","-119.78062","1","0","0","0","0","0","1","0","1","0","0","1","1","0","0","0","1","0","0","1","0","0","1"
"Brewster","41.93889","-99.86485","1","0","0","0","0","0","1","0","1","0","0","1","1","0","0","0","1","0","0","1","0","0","1"
"Brewster","40.707","-81.59818","1","0","0","0","0","0","1","0","1","0","0","1","1","0","0","0","1","0","0","1","0","0","1"
"Brewster","41.39732","-73.61707","1","0","0","0","0","0","1","0","1","0","0","1","1","0","0","0","1","0","0","1","0","0","1"
"Brewster","41.76011","-70.0828","1","0","0","0","0","0","1","0","1","0","0","1","1","0","0","0","1","0","0","1","0","0","1"
"Briançon","44.89978","6.64201","1","0","0","0","0","0","1","0","1","0","0","1","1","0","0","0","1","0","0","1","0","0","1"
"Briarwood","40.70935","-73.81529","1","0","0","0","0","0","1","0","0","1","0","1","0","1","0","0","1","0","1","0","0","0","1"
"Bridgend","51.50583","-3.57722","29","0","0","1","4","0","35","6","13","14","0","33","15","4","16","0","35","6","12","16","0","1","35"
"Bridgend","55.96366","-3.53592","29","0","0","1","4","0","35","6","13","14","0","33","15","4","16","0","35","6","12","16","0","1","35"
"Bridgend","57.4","-2.81667","29","0","0","1","4","0","35","6","13","14","0","33","15","4","16","0","35","6","12","16","0","1","35"
"Bridgetown","39.15311","-84.63717","0","1","0","0","0","0","1","1","0","0","0","1","0","0","1","0","1","0","0","0","0","1","1"
"Bridgetown","13.10732","-59.62021","0","1","0","0","0","0","1","1","0","0","0","1","0","0","1","0","1","0","0","0","0","1","1"
"Bridgetown","-33.96242","116.13598","0","1","0","0","0","0","1","1","0","0","0","1","0","0","1","0","1","0","0","0","0","1","1"
"Bridgnorth","52.53661","-2.42033","1","0","0","0","0","0","1","0","0","1","0","1","1","0","0","0","1","0","1","0","0","0","1"
"Bridgwater","51.12837","-3.00356","7","0","0","0","0","0","7","0","3","3","0","6","2","0","5","0","7","1","1","4","0","1","7"
"Bridlington","54.08306","-0.19192","6","3","0","0","0","0","9","0","4","5","0","9","3","1","5","0","9","1","6","2","0","0","9"
"Bridport","43.98506","-73.31262","6","0","0","0","0","0","6","0","0","2","0","2","2","1","3","0","6","1","2","3","0","0","6"
"Bridport","50.7338","-2.75831","6","0","0","0","0","0","6","0","0","2","0","2","2","1","3","0","6","1","2","3","0","0","6"
"Bridport","-41.00046","147.39175","6","0","0","0","0","0","6","0","0","2","0","2","2","1","3","0","6","1","2","3","0","0","6"
"Brierfield","53.82468","-2.23415","1","0","0","0","0","0","2","1","0","1","0","2","1","0","1","0","2","0","1","1","0","0","2"
"Brierley Hill","52.48173","-2.12139","6","0","0","1","0","0","7","2","1","4","0","7","1","1","5","0","7","2","1","4","0","0","7"
"Brigg","53.55201","-0.49214","1","0","0","0","0","0","1","0","1","0","0","1","0","1","0","0","1","0","0","1","0","0","1"
"Brighouse","53.70322","-1.78428","4","1","0","0","1","0","6","3","1","1","0","5","2","1","3","0","6","1","0","5","0","0","6"
"Brightlingsea","51.81164","1.02336","2","0","0","0","0","0","2","0","0","1","0","1","1","0","1","0","2","0","1","1","0","0","2"
"Brighton","39.98526","-104.82053","55","1","0","2","1","0","64","7","18","13","2","40","24","8","32","0","64","12","9","31","2","9","63"
"Brighton","41.17474","-91.81961","55","1","0","2","1","0","64","7","18","13","2","40","24","8","32","0","64","12","9","31","2","9","63"
"Brighton","39.03977","-90.14066","55","1","0","2","1","0","64","7","18","13","2","40","24","8","32","0","64","12","9","31","2","9","63"
"Brighton","35.48397","-89.72508","55","1","0","2","1","0","64","7","18","13","2","40","24","8","32","0","64","12","9","31","2","9","63"
"Brighton","33.43428","-86.94721","55","1","0","2","1","0","64","7","18","13","2","40","24","8","32","0","64","12","9","31","2","9","63"
"Brighton","35.08009","-86.43916","55","1","0","2","1","0","64","7","18","13","2","40","24","8","32","0","64","12","9","31","2","9","63"
"Brighton","42.52948","-83.78022","55","1","0","2","1","0","64","7","18","13","2","40","24","8","32","0","64","12","9","31","2","9","63"
"Brighton","43.14756","-77.55055","55","1","0","2","1","0","64","7","18","13","2","40","24","8","32","0","64","12","9","31","2","9","63"
"Brighton","50.82838","-0.13947","55","1","0","2","1","0","64","7","18","13","2","40","24","8","32","0","64","12","9","31","2","9","63"
"Brighton","-35.0182","138.52351","55","1","0","2","1","0","64","7","18","13","2","40","24","8","32","0","64","12","9","31","2","9","63"
"Brighton","-37.90561","145.00279","55","1","0","2","1","0","64","7","18","13","2","40","24","8","32","0","64","12","9","31","2","9","63"
"Brighton","-42.69814","147.24489","55","1","0","2","1","0","64","7","18","13","2","40","24","8","32","0","64","12","9","31","2","9","63"
"Brighton","-27.29582","153.05721","55","1","0","2","1","0","64","7","18","13","2","40","24","8","32","0","64","12","9","31","2","9","63"
"Brikama","13.27136","-16.64944","0","1","0","0","0","0","1","0","1","0","0","1","0","0","1","0","1","0","0","1","0","0","1"
"Brindisi","40.63215","17.93607","1","0","0","0","0","0","1","0","0","1","0","1","0","0","1","0","1","0","0","1","0","0","1"
"Brinkmann","-30.86589","-62.03742","1","0","0","0","0","0","1","0","1","0","0","1","0","1","0","0","1","1","0","0","0","0","1"
"Brisbane","37.68077","-122.39997","10","0","0","0","0","0","10","1","2","3","0","6","3","5","2","0","10","4","1","5","0","0","10"
"Brisbane","-27.46794","153.02809","10","0","0","0","0","0","10","1","2","3","0","6","3","5","2","0","10","4","1","5","0","0","10"
"Brisée Verdière","-20.16389","57.64667","1","0","0","0","1","0","2","2","0","0","0","2","2","0","0","0","2","0","0","1","0","0","1"
"Bristol","32.46153","-96.56999","162","7","0","9","20","0","215","37","54","86","3","180","75","27","111","1","214","26","34","143","3","8","214"
"Bristol","42.55891","-88.04925","162","7","0","9","20","0","215","37","54","86","3","180","75","27","111","1","214","26","34","143","3","8","214"
"Bristol","41.72144","-85.81749","162","7","0","9","20","0","215","37","54","86","3","180","75","27","111","1","214","26","34","143","3","8","214"
"Bristol","30.43247","-84.97702","162","7","0","9","20","0","215","37","54","86","3","180","75","27","111","1","214","26","34","143","3","8","214"
"Bristol","36.59511","-82.18874","162","7","0","9","20","0","215","37","54","86","3","180","75","27","111","1","214","26","34","143","3","8","214"
"Bristol","36.59649","-82.18847","162","7","0","9","20","0","215","37","54","86","3","180","75","27","111","1","214","26","34","143","3","8","214"
"Bristol","40.10067","-74.85183","162","7","0","9","20","0","215","37","54","86","3","180","75","27","111","1","214","26","34","143","3","8","214"
"Bristol","44.13339","-73.07901","162","7","0","9","20","0","215","37","54","86","3","180","75","27","111","1","214","26","34","143","3","8","214"
"Bristol","41.67176","-72.94927","162","7","0","9","20","0","215","37","54","86","3","180","75","27","111","1","214","26","34","143","3","8","214"
"Bristol","43.59119","-71.73675","162","7","0","9","20","0","215","37","54","86","3","180","75","27","111","1","214","26","34","143","3","8","214"
"Bristol","41.67705","-71.26616","162","7","0","9","20","0","215","37","54","86","3","180","75","27","111","1","214","26","34","143","3","8","214"
"Bristol","43.95758","-69.50921","162","7","0","9","20","0","215","37","54","86","3","180","75","27","111","1","214","26","34","143","3","8","214"
"Bristol","51.45523","-2.59665","162","7","0","9","20","0","215","37","54","86","3","180","75","27","111","1","214","26","34","143","3","8","214"
"Briston","52.85369","1.05899","1","0","0","0","0","0","1","1","0","0","0","1","1","0","0","0","1","0","1","0","0","0","1"
"Brixham","50.39431","-3.51585","3","0","0","0","0","0","3","0","0","2","0","2","0","0","3","0","3","0","0","3","0","0","3"
"Brno","49.19522","16.60796","1","1","0","0","0","0","2","0","2","0","0","2","0","1","1","0","2","1","0","1","0","0","2"
"Broad Haven","51.78025","-5.10258","1","0","0","0","0","0","1","0","0","0","0","0","0","1","0","0","1","0","0","1","0","0","1"
"Broadstairs","51.35908","1.43938","4","0","0","0","1","0","5","0","2","3","0","5","2","0","3","0","5","0","2","3","0","0","5"
"Broadstone","50.75717","-1.99406","1","0","0","0","0","0","1","0","0","1","0","1","0","0","1","0","1","0","1","0","0","0","1"
"Broadway","35.45793","-79.05308","1","0","0","0","0","0","2","1","1","0","0","2","1","0","1","0","2","0","1","1","0","0","2"
"Broadway","38.61317","-78.79891","1","0","0","0","0","0","2","1","1","0","0","2","1","0","1","0","2","0","1","1","0","0","2"
"Broadway","52.03825","-1.86079","1","0","0","0","0","0","2","1","1","0","0","2","1","0","1","0","2","0","1","1","0","0","2"
"Bromborough","53.3485","-2.97935","3","0","0","0","0","0","3","0","1","1","0","2","1","0","1","0","2","2","0","1","0","0","3"
"Bromley","38.64062","-84.84828","22","0","0","0","2","0","28","5","9","9","0","23","10","3","15","0","28","3","8","16","1","0","28"
"Bromley","39.082","-84.56022","22","0","0","0","2","0","28","5","9","9","0","23","10","3","15","0","28","3","8","16","1","0","28"
"Bromley","51.40606","0.01519","22","0","0","0","2","0","28","5","9","9","0","23","10","3","15","0","28","3","8","16","1","0","28"
"Bromsgrove","52.33574","-2.05983","8","3","0","0","1","0","13","4","3","3","0","10","9","1","3","0","13","2","6","5","0","0","13"
"Brookings","42.05261","-124.28398","1","0","0","0","0","0","1","0","0","0","0","0","1","0","0","0","1","0","0","1","0","0","1"
"Brookings","44.31136","-96.79839","1","0","0","0","0","0","1","0","0","0","0","0","1","0","0","0","1","0","0","1","0","0","1"
"Brookline","42.73481","-71.65813","1","0","0","0","0","0","1","0","0","1","0","1","1","0","0","0","1","0","0","1","0","0","1"
"Brookline","42.33176","-71.12116","1","0","0","0","0","0","1","0","0","1","0","1","1","0","0","0","1","0","0","1","0","0","1"
"Brooklyn","41.73361","-92.44546","4","1","0","1","0","0","6","3","0","0","0","3","3","0","3","0","6","0","3","3","0","0","6"
"Brooklyn","38.65866","-90.16594","4","1","0","1","0","0","6","3","0","0","0","3","3","0","3","0","6","0","3","3","0","0","6"
"Brooklyn","42.85361","-89.3704","4","1","0","1","0","0","6","3","0","0","0","3","3","0","3","0","6","0","3","3","0","0","6"
"Brooklyn","39.53921","-86.36916","4","1","0","1","0","0","6","3","0","0","0","3","3","0","3","0","6","0","3","3","0","0","6"
"Brooklyn","42.10587","-84.24828","4","1","0","1","0","0","6","3","0","0","0","3","3","0","3","0","6","0","3","3","0","0","6"
"Brooklyn","41.43977","-81.73541","4","1","0","1","0","0","6","3","0","0","0","3","3","0","3","0","6","0","3","3","0","0","6"
"Brooklyn","40.6501","-73.94958","4","1","0","1","0","0","6","3","0","0","0","3","3","0","3","0","6","0","3","3","0","0","6"
"Brooklyn","41.78815","-71.9498","4","1","0","1","0","0","6","3","0","0","0","3","3","0","3","0","6","0","3","3","0","0","6"
"Brooklyn","-37.81609","144.8415","4","1","0","1","0","0","6","3","0","0","0","3","3","0","3","0","6","0","3","3","0","0","6"
"Brooklyn","-41.07223","145.90731","4","1","0","1","0","0","6","3","0","0","0","3","3","0","3","0","6","0","3","3","0","0","6"
"Brooklyn","-33.54903","151.22492","4","1","0","1","0","0","6","3","0","0","0","3","3","0","3","0","6","0","3","3","0","0","6"
"Brooklyn","-41.30586","174.76257","4","1","0","1","0","0","6","3","0","0","0","3","3","0","3","0","6","0","3","3","0","0","6"
"Brough","53.72861","-0.57215","4","1","0","0","0","0","5","1","1","3","0","5","2","0","3","0","5","0","0","5","0","0","5"
"Broughton","53.16303","-2.99309","1","0","0","0","0","0","1","0","1","0","0","1","1","0","0","0","1","0","0","1","0","0","1"
"Broughton","52.37331","-0.77493","1","0","0","0","0","0","1","0","1","0","0","1","1","0","0","0","1","0","0","1","0","0","1"
"Broughton","52.05038","-0.69351","1","0","0","0","0","0","1","0","1","0","0","1","1","0","0","0","1","0","0","1","0","0","1"
"Broughton","53.56667","-0.55","1","0","0","0","0","0","1","0","1","0","0","1","1","0","0","0","1","0","0","1","0","0","1"
"Broughton","-20.11667","146.43333","1","0","0","0","0","0","1","0","1","0","0","1","1","0","0","0","1","0","0","1","0","0","1"
"Broughton Astley","52.52787","-1.21768","1","0","0","0","0","0","1","0","1","0","0","1","1","0","0","0","1","1","0","0","0","0","1"
"Brownsweg","5.00435","-55.15333","1","0","0","0","0","0","1","0","1","0","0","1","0","1","0","0","1","0","0","1","0","0","1"
"Broxbourne","51.74712","-0.01923","2","0","0","0","0","0","2","0","0","1","0","1","1","0","1","0","2","1","0","1","0","0","2"
"Broxburn","55.93415","-3.47133","0","0","0","0","0","0","1","1","0","0","0","1","0","0","1","0","1","0","1","0","0","0","1"
"Bruff","52.47417","-8.54583","1","0","0","0","0","0","1","0","1","0","0","1","0","1","0","0","1","1","0","0","0","0","1"
"Brugg","47.48096","8.20869","0","0","0","0","1","0","1","0","0","0","0","0","1","0","0","0","1","0","0","1","0","0","1"
"Brunswick","39.42336","-93.13048","1","0","0","0","0","0","1","0","1","0","0","1","0","1","0","0","1","0","0","1","0","0","1"
"Brunswick","41.23811","-81.8418","1","0","0","0","0","0","1","0","1","0","0","1","0","1","0","0","1","0","0","1","0","0","1"
"Brunswick","31.14995","-81.49149","1","0","0","0","0","0","1","0","1","0","0","1","0","1","0","0","1","0","0","1","0","0","1"
"Brunswick","34.28684","-78.70113","1","0","0","0","0","0","1","0","1","0","0","1","0","1","0","0","1","0","0","1","0","0","1"
"Brunswick","39.31427","-77.62777","1","0","0","0","0","0","1","0","1","0","0","1","0","1","0","0","1","0","0","1","0","0","1"
"Brunswick","43.91452","-69.96533","1","0","0","0","0","0","1","0","1","0","0","1","0","1","0","0","1","0","0","1","0","0","1"
"Brunswick","-33.2324","115.86282","1","0","0","0","0","0","1","0","1","0","0","1","0","1","0","0","1","0","0","1","0","0","1"
"Brunswick","-37.76667","144.96667","1","0","0","0","0","0","1","0","1","0","0","1","0","1","0","0","1","0","0","1","0","0","1"
"Brussels","44.73611","-87.62093","9","0","0","0","1","0","10","2","2","2","0","6","1","2","7","0","10","1","1","7","1","0","10"
"Brussels","43.73339","-81.24975","9","0","0","0","1","0","10","2","2","2","0","6","1","2","7","0","10","1","1","7","1","0","10"
"Brussels","50.85045","4.34878","9","0","0","0","1","0","10","2","2","2","0","6","1","2","7","0","10","1","1","7","1","0","10"
"Bruton","51.1125","-2.45278","1","0","0","0","0","0","1","0","1","0","0","1","0","0","1","0","1","0","0","1","0","0","1"
"Brynmawr","51.8","-3.18333","1","0","0","0","0","0","1","0","0","1","0","1","0","0","1","0","1","0","0","1","0","0","1"
"Bry-sur-Marne","48.83811","2.52488","0","0","0","1","0","1","2","2","0","0","0","2","0","0","2","0","2","0","2","0","0","0","2"
"Bucaramanga","7.12539","-73.1198","2","0","0","0","0","0","2","1","0","0","0","1","1","0","1","0","2","1","0","1","0","0","2"
"Bucha","50.88333","11.51667","1","0","0","0","0","0","1","0","1","0","0","1","0","1","0","0","1","1","0","0","0","0","1"
"Bucha","50.63333","11.7","1","0","0","0","0","0","1","0","1","0","0","1","0","1","0","0","1","1","0","0","0","0","1"
"Bucha","50.54345","30.21201","1","0","0","0","0","0","1","0","1","0","0","1","0","1","0","0","1","1","0","0","0","0","1"
"Buchanan","41.82727","-86.36112","1","0","0","0","0","0","1","1","0","0","0","1","1","0","0","0","1","0","0","1","0","0","1"
"Buchanan","33.8026","-85.18856","1","0","0","0","0","0","1","1","0","0","0","1","1","0","0","0","1","0","0","1","0","0","1"
"Buchanan","37.52736","-79.67976","1","0","0","0","0","0","1","1","0","0","0","1","1","0","0","0","1","0","0","1","0","0","1"
"Buchanan","41.26204","-73.93819","1","0","0","0","0","0","1","1","0","0","0","1","1","0","0","0","1","0","0","1","0","0","1"
"Buchanan","5.87693","-10.04964","1","0","0","0","0","0","1","1","0","0","0","1","1","0","0","0","1","0","0","1","0","0","1"
"Bucharest","44.43225","26.10626","38","1","0","0","1","0","40","7","12","2","3","24","20","8","11","1","40","18","3","15","2","2","40"
"Buckhurst Hill","51.62409","0.03262","3","0","0","0","0","0","4","1","1","2","0","4","1","0","3","0","4","0","0","4","0","0","4"
"Buckingham","26.67507","-81.73203","10","1","0","2","0","0","14","5","4","3","1","13","6","2","6","0","14","2","2","8","0","2","14"
"Buckingham","37.55015","-78.55556","10","1","0","2","0","0","14","5","4","3","1","13","6","2","6","0","14","2","2","8","0","2","14"
"Buckingham","45.58563","-75.4208","10","1","0","2","0","0","14","5","4","3","1","13","6","2","6","0","14","2","2","8","0","2","14"
"Buckingham","51.99968","-0.98779","10","1","0","2","0","0","14","5","4","3","1","13","6","2","6","0","14","2","2","8","0","2","14"
"Buckley","47.16316","-122.02678","2","0","0","0","2","0","4","1","1","1","0","3","1","0","3","0","4","1","3","0","0","0","4"
"Buckley","40.59698","-88.0381","2","0","0","0","2","0","4","1","1","1","0","3","1","0","3","0","4","1","3","0","0","0","4"
"Buckley","44.50445","-85.67701","2","0","0","0","2","0","4","1","1","1","0","3","1","0","3","0","4","1","3","0","0","0","4"
"Buckley","53.16667","-3.08333","2","0","0","0","2","0","4","1","1","1","0","3","1","0","3","0","4","1","3","0","0","0","4"
"Bucureşci","46.13333","22.9","1","0","0","0","0","0","1","0","0","0","0","0","0","0","1","0","1","0","0","1","0","0","1"
"Bucuresti","44.42802","26.09665","25","1","0","0","1","0","28","3","8","4","0","15","9","5","14","0","28","8","3","15","1","1","28"
"Budakovo","42.355","20.925","1","0","0","0","0","0","1","0","0","0","0","0","0","1","0","0","1","0","0","1","0","0","1"
"Budaörs","47.46181","18.95845","1","0","0","0","0","0","1","0","1","0","0","1","1","0","0","0","1","1","0","0","0","0","1"
"Budapest","47.49835","19.04045","9","0","0","0","0","0","10","2","1","2","0","5","4","2","4","0","10","3","0","6","1","0","10"
"Budapest II. kerület","47.51984","19.02218","2","0","0","0","1","0","3","2","0","0","0","2","0","1","2","0","3","1","1","1","0","0","3"
"Budapest XI. kerület","47.47603","19.03605","2","0","0","0","0","0","2","0","0","1","0","1","2","0","0","0","2","1","0","1","0","0","2"
"Bude","31.46295","-90.8501","1","0","0","1","1","0","3","2","1","0","0","3","0","1","2","0","3","0","1","2","0","0","3"
"Bude","50.82435","-4.5413","1","0","0","1","1","0","3","2","1","0","0","3","0","1","2","0","3","0","1","2","0","0","3"
"Budleigh Salterton","50.62983","-3.32181","1","0","0","0","0","0","1","0","0","0","0","0","1","0","0","0","1","1","0","0","0","0","1"
"Buea","4.15342","9.24231","3","0","0","0","0","0","3","0","0","1","1","2","2","1","0","0","3","0","1","1","0","0","2"
"Bu‘eina","32.80636","35.36486","2","0","0","0","0","0","2","1","0","0","0","1","1","0","1","0","2","1","0","1","0","0","2"
"Buena Park","33.86751","-117.99812","1","0","0","0","0","0","1","0","0","0","0","0","0","0","1","0","1","1","0","0","0","0","1"
"Buenos Aires","32.42278","-116.94111","18","3","0","0","0","0","21","7","7","0","0","14","3","4","14","0","21","7","3","7","4","0","21"
"Buenos Aires","20.58145","-104.03105","18","3","0","0","0","0","21","7","7","0","0","14","3","4","14","0","21","7","3","7","4","0","21"
"Buenos Aires","18.02444","-102.28583","18","3","0","0","0","0","21","7","7","0","0","14","3","4","14","0","21","7","3","7","4","0","21"
"Buenos Aires","19.07499","-102.17999","18","3","0","0","0","0","21","7","7","0","0","14","3","4","14","0","21","7","3","7","4","0","21"
"Buenos Aires","20.38341","-102.17599","18","3","0","0","0","0","21","7","7","0","0","14","3","4","14","0","21","7","3","7","4","0","21"
"Buenos Aires","19.61745","-99.6679","18","3","0","0","0","0","21","7","7","0","0","14","3","4","14","0","21","7","3","7","4","0","21"
"Buenos Aires","20.02139","-98.29222","18","3","0","0","0","0","21","7","7","0","0","14","3","4","14","0","21","7","3","7","4","0","21"
"Buenos Aires","20.15333","-97.74833","18","3","0","0","0","0","21","7","7","0","0","14","3","4","14","0","21","7","3","7","4","0","21"
"Buenos Aires","20.95806","-97.5","18","3","0","0","0","0","21","7","7","0","0","14","3","4","14","0","21","7","3","7","4","0","21"
"Buenos Aires","18.94156","-96.76692","18","3","0","0","0","0","21","7","7","0","0","14","3","4","14","0","21","7","3","7","4","0","21"
"Buenos Aires","18.25787","-96.61505","18","3","0","0","0","0","21","7","7","0","0","14","3","4","14","0","21","7","3","7","4","0","21"
"Buenos Aires","18.46463","-95.24879","18","3","0","0","0","0","21","7","7","0","0","14","3","4","14","0","21","7","3","7","4","0","21"
"Buenos Aires","15.58595","-92.49913","18","3","0","0","0","0","21","7","7","0","0","14","3","4","14","0","21","7","3","7","4","0","21"
"Buenos Aires","14.8898","-92.48121","18","3","0","0","0","0","21","7","7","0","0","14","3","4","14","0","21","7","3","7","4","0","21"
"Buenos Aires","15.03333","-88.96667","18","3","0","0","0","0","21","7","7","0","0","14","3","4","14","0","21","7","3","7","4","0","21"
"Buenos Aires","15.48333","-88.18333","18","3","0","0","0","0","21","7","7","0","0","14","3","4","14","0","21","7","3","7","4","0","21"
"Buenos Aires","15.46667","-86.4","18","3","0","0","0","0","21","7","7","0","0","14","3","4","14","0","21","7","3","7","4","0","21"
"Buenos Aires","11.46916","-85.81661","18","3","0","0","0","0","21","7","7","0","0","14","3","4","14","0","21","7","3","7","4","0","21"
"Buenos Aires","9.17189","-83.33417","18","3","0","0","0","0","21","7","7","0","0","14","3","4","14","0","21","7","3","7","4","0","21"
"Buenos Aires","8.41384","-81.4844","18","3","0","0","0","0","21","7","7","0","0","14","3","4","14","0","21","7","3","7","4","0","21"
"Buenos Aires","-5.26083","-79.96417","18","3","0","0","0","0","21","7","7","0","0","14","3","4","14","0","21","7","3","7","4","0","21"
"Buenos Aires","8.63146","-79.94775","18","3","0","0","0","0","21","7","7","0","0","14","3","4","14","0","21","7","3","7","4","0","21"
"Buenos Aires","-8.13861","-79.04028","18","3","0","0","0","0","21","7","7","0","0","14","3","4","14","0","21","7","3","7","4","0","21"
"Buenos Aires","-9.12417","-78.4975","18","3","0","0","0","0","21","7","7","0","0","14","3","4","14","0","21","7","3","7","4","0","21"
"Buenos Aires","3.01397","-76.64612","18","3","0","0","0","0","21","7","7","0","0","14","3","4","14","0","21","7","3","7","4","0","21"
"Buenos Aires","-6.79111","-76.32639","18","3","0","0","0","0","21","7","7","0","0","14","3","4","14","0","21","7","3","7","4","0","21"
"Buenos Aires","-34.61315","-58.37723","18","3","0","0","0","0","21","7","7","0","0","14","3","4","14","0","21","7","3","7","4","0","21"
"Buffalo","44.34831","-106.69894","2","0","0","0","0","0","2","1","0","0","0","1","1","0","1","0","2","0","0","2","0","0","2"
"Buffalo","45.58416","-103.54603","2","0","0","0","0","0","2","1","0","0","0","1","1","0","1","0","2","0","0","2","0","0","2"
"Buffalo","36.83559","-99.6304","2","0","0","0","0","0","2","1","0","0","0","1","1","0","1","0","2","0","0","2","0","0","2"
"Buffalo","31.46379","-96.05802","2","0","0","0","0","0","2","1","0","0","0","1","1","0","1","0","2","0","0","2","0","0","2"
"Buffalo","45.17191","-93.87469","2","0","0","0","0","0","2","1","0","0","0","1","1","0","1","0","2","0","0","2","0","0","2"
"Buffalo","37.64393","-93.09241","2","0","0","0","0","0","2","1","0","0","0","1","1","0","1","0","2","0","0","2","0","0","2"
"Buffalo","41.45642","-90.72347","2","0","0","0","0","0","2","1","0","0","0","1","1","0","1","0","2","0","0","2","0","0","2"
"Buffalo","40.88254","-86.74529","2","0","0","0","0","0","2","1","0","0","0","1","1","0","1","0","2","0","0","2","0","0","2"
"Buffalo","38.61759","-81.9818","2","0","0","0","0","0","2","1","0","0","0","1","1","0","1","0","2","0","0","2","0","0","2"
"Buffalo","34.72569","-81.68343","2","0","0","0","0","0","2","1","0","0","0","1","1","0","1","0","2","0","0","2","0","0","2"
"Buffalo","42.88645","-78.87837","2","0","0","0","0","0","2","1","0","0","0","1","1","0","1","0","2","0","0","2","0","0","2"
"Buford","34.12066","-84.00435","1","0","0","0","0","0","1","0","1","0","0","1","1","0","0","0","1","1","0","0","0","0","1"
"Bugene","-1.59111","31.14028","1","1","0","0","0","0","2","0","1","1","0","2","0","0","2","0","2","0","1","0","0","0","1"
"Buikwe","0.3375","33.01056","1","0","0","0","0","0","1","0","0","0","0","0","1","0","0","0","1","0","0","0","0","1","1"
"Builth Wells","52.1494","-3.40469","2","0","0","0","2","0","4","0","0","4","0","4","0","0","4","0","4","0","1","3","0","0","4"
"Buin","-33.73257","-70.74281","1","0","0","0","0","0","1","0","0","0","0","0","0","1","0","0","1","1","0","0","0","0","1"
"Buin","-6.74864","155.69147","1","0","0","0","0","0","1","0","0","0","0","0","0","1","0","0","1","1","0","0","0","0","1"
"Bujumbura","-3.38193","29.36142","5","0","0","0","0","0","5","0","2","0","3","5","2","1","1","1","5","0","0","1","2","2","5"
"Bukavu","-2.49077","28.84281","1","0","0","0","0","0","1","0","1","0","0","1","0","1","0","0","1","1","0","0","0","0","1"
"Bukit Mertajam","5.36301","100.4667","1","0","0","0","0","0","1","0","0","1","0","1","0","0","1","0","1","0","0","1","0","0","1"
"Bukoba","-1.33167","31.81222","1","0","0","0","0","0","1","0","0","0","0","0","1","0","0","0","1","0","0","1","0","0","1"
"Bulacan","14.79278","120.87889","2","0","0","0","0","0","2","1","1","0","0","2","0","1","1","0","2","1","1","0","0","0","2"
"Bulacan","6.5675","125.42111","2","0","0","0","0","0","2","1","1","0","0","2","0","1","1","0","2","1","1","0","0","0","2"
"Bülach / Seematt","47.51716","8.54651","0","0","0","1","0","0","1","1","0","0","0","1","0","0","1","0","1","0","0","1","0","0","1"
"Bulawayo","-20.15","28.58333","4","0","0","0","0","0","4","0","2","1","0","3","2","2","0","0","4","1","0","2","0","1","4"
"Bulkington","51.32361","-2.08361","1","0","0","0","0","0","1","0","0","1","0","1","0","0","1","0","1","0","0","1","0","0","1"
"Bunclody","52.6553","-6.65359","1","0","0","0","0","0","1","0","0","0","0","0","1","0","0","0","1","0","0","1","0","0","1"
"Bungay","52.45434","1.43818","2","0","0","0","0","0","2","0","0","1","0","1","1","0","1","0","2","0","0","2","0","0","2"
"Bungoma","0.5635","34.56055","3","0","0","0","0","0","3","2","1","0","0","3","3","0","0","0","3","0","0","2","0","1","3"
"Bungoma","0.58333","34.58333","3","0","0","0","0","0","3","2","1","0","0","3","3","0","0","0","3","0","0","2","0","1","3"
"Bunia","1.55941","30.25224","2","0","0","0","0","0","2","1","1","0","0","2","1","1","0","0","2","0","0","1","0","1","2"
"Buntingford","51.94612","-0.01841","1","0","0","0","0","0","1","0","0","0","0","0","0","1","0","0","1","0","1","0","0","0","1"
"Buol","1.1584","121.4361","1","0","0","0","0","0","1","0","0","0","0","0","0","0","1","0","1","0","0","0","0","1","1"
"Buôn Ma Thuột","12.66747","108.03775","2","0","0","0","0","0","2","0","1","0","0","1","1","0","1","0","2","1","0","1","0","0","2"
"Buqan","42.55806","20.45278","1","0","0","0","0","0","1","1","0","0","0","1","0","0","1","0","1","0","0","1","0","0","1"
"Burao","9.52213","45.53363","4","0","0","0","0","0","4","1","0","0","2","3","3","0","0","1","4","2","0","1","0","1","4"
"Buraydah","26.32599","43.97497","5","0","0","0","0","0","5","0","3","0","0","3","0","3","2","0","5","4","0","0","0","1","5"
"Bures Saint Mary","51.9724","0.77488","2","0","0","1","0","0","3","0","0","1","0","1","1","0","2","0","3","0","1","2","0","0","3"
"Būrewāla","30.16667","72.65","1","0","0","0","0","0","1","1","0","0","0","1","0","0","1","0","1","0","0","1","0","0","1"
"Burford","43.10292","-80.42869","1","0","0","0","0","0","1","0","0","1","0","1","0","0","1","0","1","0","0","1","0","0","1"
"Burford","51.80915","-1.63628","1","0","0","0","0","0","1","0","0","1","0","1","0","0","1","0","1","0","0","1","0","0","1"
"Burgas","42.50606","27.46781","2","0","0","0","0","0","2","0","2","0","0","2","0","2","0","0","2","1","0","0","0","1","2"
"Burgess Hill","50.95843","-0.13287","8","0","0","0","2","0","12","2","2","6","0","10","5","3","4","0","12","0","4","7","0","1","12"
"Burghead","57.70113","-3.48992","1","0","0","0","0","0","1","0","1","0","0","1","0","0","1","0","1","0","1","0","0","0","1"
"Buriton","50.97505","-0.94851","1","0","0","0","0","0","1","1","0","0","0","1","0","1","0","0","1","0","0","1","0","0","1"
"Burke","43.1825","-99.29205","1","0","0","0","0","0","1","0","0","0","0","0","1","0","0","0","1","0","0","1","0","0","1"
"Burke","31.23185","-94.76854","1","0","0","0","0","0","1","0","0","0","0","0","1","0","0","0","1","0","0","1","0","0","1"
"Burke","38.79345","-77.27165","1","0","0","0","0","0","1","0","0","0","0","0","1","0","0","0","1","0","0","1","0","0","1"
"Burley in Wharfedale","53.9102","-1.75798","1","0","0","0","0","0","1","0","0","0","0","0","0","0","1","0","1","0","1","0","0","0","1"
"Burlington","48.47566","-122.32544","3","0","0","0","0","0","3","0","1","2","0","3","2","0","1","0","3","1","0","2","0","0","3"
"Burlington","39.30611","-102.26936","3","0","0","0","0","0","3","0","1","2","0","3","2","0","1","0","3","1","0","2","0","0","3"
"Burlington","48.27529","-101.42878","3","0","0","0","0","0","3","0","1","2","0","3","2","0","1","0","3","1","0","2","0","0","3"
"Burlington","38.19447","-95.74276","3","0","0","0","0","0","3","0","1","2","0","3","2","0","1","0","3","1","0","2","0","0","3"
"Burlington","40.80754","-91.11292","3","0","0","0","0","0","3","0","1","2","0","3","2","0","1","0","3","1","0","2","0","0","3"
"Burlington","42.0528","-88.54814","3","0","0","0","0","0","3","0","1","2","0","3","2","0","1","0","3","1","0","2","0","0","3"
"Burlington","42.67807","-88.2762","3","0","0","0","0","0","3","0","1","2","0","3","2","0","1","0","3","1","0","2","0","0","3"
"Burlington","40.48031","-86.39472","3","0","0","0","0","0","3","0","1","2","0","3","2","0","1","0","3","1","0","2","0","0","3"
"Burlington","39.02756","-84.72411","3","0","0","0","0","0","3","0","1","2","0","3","2","0","1","0","3","1","0","2","0","0","3"
"Burlington","41.57227","-84.308","3","0","0","0","0","0","3","0","1","2","0","3","2","0","1","0","3","1","0","2","0","0","3"
"Burlington","38.4073","-82.53571","3","0","0","0","0","0","3","0","1","2","0","3","2","0","1","0","3","1","0","2","0","0","3"
"Burlington","43.38621","-79.83713","3","0","0","0","0","0","3","0","1","2","0","3","2","0","1","0","3","1","0","2","0","0","3"
"Burlington","36.09569","-79.4378","3","0","0","0","0","0","3","0","1","2","0","3","2","0","1","0","3","1","0","2","0","0","3"
"Burlington","40.07122","-74.86489","3","0","0","0","0","0","3","0","1","2","0","3","2","0","1","0","3","1","0","2","0","0","3"
"Burlington","44.47588","-73.21207","3","0","0","0","0","0","3","0","1","2","0","3","2","0","1","0","3","1","0","2","0","0","3"
"Burlington","42.50482","-71.19561","3","0","0","0","0","0","3","0","1","2","0","3","2","0","1","0","3","1","0","2","0","0","3"
"Burnaby","49.26636","-122.95263","1","0","0","1","1","0","3","1","1","0","0","2","1","1","1","0","3","0","1","2","0","0","3"
"Burnham-on-Crouch","51.63272","0.81488","1","0","0","0","1","0","2","0","1","1","0","2","1","0","1","0","2","0","0","2","0","0","2"
"Burnham-on-Sea","51.23862","-2.9978","1","0","0","0","0","0","1","0","0","1","0","1","0","0","1","0","1","0","0","1","0","0","1"
"Burnley","53.8","-2.23333","21","0","0","0","4","0","27","3","11","11","0","25","9","5","13","0","27","6","10","10","0","1","27"
"Burnley","-37.82959","145.01732","21","0","0","0","4","0","27","3","11","11","0","25","9","5","13","0","27","6","10","10","0","1","27"
"Burntisland","56.05865","-3.23664","4","0","0","0","0","0","4","1","0","3","0","4","2","0","2","0","4","0","3","1","0","0","4"
"Burntwood","52.68075","-1.92759","6","1","0","0","0","0","7","1","3","2","0","6","4","2","1","0","7","5","0","2","0","0","7"
"Burry Port","51.68435","-4.24687","3","0","0","1","1","0","5","2","2","1","0","5","1","2","2","0","5","2","1","2","0","0","5"
"Bursa","40.19559","29.06013","2","0","0","1","0","0","3","0","0","1","0","1","1","2","0","0","3","2","1","0","0","0","3"
"Burscough","53.5964","-2.83972","0","1","0","0","1","0","2","0","0","1","0","1","1","1","0","0","2","0","1","1","0","0","2"
"Bursledon","50.88658","-1.31596","1","0","0","0","0","0","1","0","0","1","0","1","1","0","0","0","1","0","0","1","0","0","1"
"Burton","42.99947","-83.61634","7","0","0","1","2","0","11","4","2","3","0","9","4","1","6","0","11","2","4","5","0","0","11"
"Burton","41.47061","-81.1451","7","0","0","1","2","0","11","4","2","3","0","9","4","1","6","0","11","2","4","5","0","0","11"
"Burton","32.43575","-80.724","7","0","0","1","2","0","11","4","2","3","0","9","4","1","6","0","11","2","4","5","0","0","11"
"Burton","51.71556","-4.92222","7","0","0","1","2","0","11","4","2","3","0","9","4","1","6","0","11","2","4","5","0","0","11"
"Burton","53.25954","-3.02549","7","0","0","1","2","0","11","4","2","3","0","9","4","1","6","0","11","2","4","5","0","0","11"
"Burton","53.26667","-0.56667","7","0","0","1","2","0","11","4","2","3","0","9","4","1","6","0","11","2","4","5","0","0","11"
"Burton","-34.73339","138.60247","7","0","0","1","2","0","11","4","2","3","0","9","4","1","6","0","11","2","4","5","0","0","11"
"Burton Latimer","52.36368","-0.67853","1","0","0","0","0","0","1","0","0","1","0","1","0","1","0","0","1","0","0","1","0","0","1"
"Burton Leonard","54.0691","-1.50116","0","0","0","0","1","0","1","0","0","1","0","1","0","0","1","0","1","0","1","0","0","0","1"
"Burton upon Trent","52.80728","-1.64263","8","1","0","2","1","0","12","3","1","4","0","8","2","3","7","0","12","3","2","7","0","0","12"
"Burwell","41.78167","-99.13315","2","0","0","0","0","0","2","0","1","1","0","2","0","1","1","0","2","0","1","1","0","0","2"
"Burwell","53.29305","0.03463","2","0","0","0","0","0","2","0","1","1","0","2","0","1","1","0","2","0","1","1","0","0","2"
"Burwell","52.27632","0.32732","2","0","0","0","0","0","2","0","1","1","0","2","0","1","1","0","2","0","1","1","0","0","2"
"Bury","53.6","-2.3","12","0","0","0","2","0","15","1","3","5","0","9","7","0","8","0","15","5","1","9","0","0","15"
"Bury","49.31307","2.34401","12","0","0","0","2","0","15","1","3","5","0","9","7","0","8","0","15","5","1","9","0","0","15"
"Bury St Edmunds","52.2463","0.71111","16","0","0","0","1","0","17","1","5","9","0","15","4","3","10","0","17","3","4","10","0","0","17"
"Bushat","42.11944","19.89972","1","0","0","0","0","0","1","1","0","0","0","1","1","0","0","0","1","0","0","1","0","0","1"
"Bushenyi","-0.53695","30.18579","1","0","0","0","0","0","1","0","0","1","0","1","1","0","0","0","1","0","0","1","0","0","1"
"Bushey","51.64316","-0.36053","8","0","0","0","0","0","9","3","0","1","0","4","4","1","4","0","9","1","2","6","0","0","9"
"Busia","0.46588","34.09221","2","0","0","0","0","0","2","0","0","0","0","0","1","0","1","0","2","1","0","0","0","1","2"
"Busia","0.46005","34.11169","2","0","0","0","0","0","2","0","0","0","0","0","1","0","1","0","2","1","0","0","0","1","2"
"Busto Arsizio","45.61128","8.84914","0","0","0","0","1","0","1","0","0","0","0","0","1","0","0","0","1","0","0","0","1","0","1"
"Butajīra","8.11667","38.36667","1","0","0","0","0","0","1","1","0","0","0","1","1","0","0","0","1","0","1","0","0","0","1"
"Butaleja","0.91194","33.95111","1","0","0","0","0","0","1","0","0","0","0","0","0","1","0","0","1","0","0","1","0","0","1"
"Butare","-2.59667","29.73944","2","0","0","0","0","0","2","1","0","0","1","2","0","0","0","1","1","0","0","1","0","0","1"
"Butembo","0.14164","29.29117","1","0","0","0","0","0","1","0","0","1","0","1","0","1","0","0","1","0","0","1","0","0","1"
"Butere","0.20694","34.49006","1","0","0","0","0","0","1","0","1","0","0","1","0","1","0","0","1","0","0","0","0","1","1"
"Butha-Buthe","-28.76659","28.24937","1","0","0","0","0","0","1","0","0","0","0","0","1","0","0","0","1","1","0","0","0","0","1"
"Butterworth","-32.33083","28.14981","1","0","0","0","0","0","1","1","0","0","0","1","0","0","0","1","1","0","0","1","0","0","1"
"Butterworth","5.3991","100.36382","1","0","0","0","0","0","1","1","0","0","0","1","0","0","0","1","1","0","0","1","0","0","1"
"Butuan","8.94917","125.54361","1","0","0","0","0","0","1","0","0","0","0","0","0","0","1","0","1","0","0","1","0","0","1"
"Butwāl","27.70055","83.44836","22","1","0","0","0","0","23","14","2","1","1","18","5","5","12","1","23","1","3","18","0","0","22"
"Buxton","35.26768","-75.54237","7","0","0","1","1","0","10","1","1","6","0","8","3","0","6","1","10","0","2","7","0","1","10"
"Buxton","43.63786","-70.51894","7","0","0","1","1","0","10","1","1","6","0","8","3","0","6","1","10","0","2","7","0","1","10"
"Buxton","53.25741","-1.90982","7","0","0","1","1","0","10","1","1","6","0","8","3","0","6","1","10","0","2","7","0","1","10"
"Buxton","52.75255","1.29982","7","0","0","1","1","0","10","1","1","6","0","8","3","0","6","1","10","0","2","7","0","1","10"
"Buxton","-34.26017","150.53288","7","0","0","1","1","0","10","1","1","6","0","8","3","0","6","1","10","0","2","7","0","1","10"
"Bweyogerere","0.35773","32.66332","1","0","0","0","0","0","1","0","1","0","0","1","0","1","0","0","1","0","0","1","0","0","1"
"Bydgoszcz","53.1235","18.00762","1","0","0","0","0","0","1","1","0","0","0","1","0","0","1","0","1","1","0","0","0","0","1"
"Byfleet","51.34018","-0.47254","2","0","0","0","1","0","3","0","1","2","0","3","0","1","1","1","3","1","1","1","0","0","3"
"Byumba","-1.5763","30.0675","0","1","0","0","0","0","1","1","0","0","0","1","0","0","1","0","1","0","0","1","0","0","1"
"Cabanatuan City","15.48586","120.96648","1","0","0","0","0","0","1","1","0","0","0","1","0","1","0","0","1","0","0","1","0","0","1"
"Cabra Número Uno","9.10863","-79.33694","1","0","0","0","0","0","1","0","0","0","1","1","0","0","0","1","1","0","1","0","0","0","1"
"Cabrobó","-8.51417","-39.31","1","0","0","0","0","0","1","1","0","0","0","1","0","0","1","0","1","0","0","1","0","0","1"
"Cachan","48.79632","2.33661","0","1","0","0","0","0","1","1","0","0","0","1","0","1","0","0","1","0","0","1","0","0","1"
"Caddington","51.86621","-0.45679","2","0","0","0","0","0","2","0","0","2","0","2","0","0","2","0","2","0","1","1","0","0","2"
"Caerleon","51.60952","-2.95378","0","0","0","1","0","0","1","1","0","0","0","1","0","0","1","0","1","0","1","0","0","0","1"
"Caernarfon","53.14126","-4.27016","6","1","0","0","2","0","9","1","4","2","1","8","2","4","3","0","9","2","3","3","0","1","9"
"Caerphilly","51.57452","-3.218","30","0","0","0","2","0","33","5","18","9","0","32","17","3","13","0","33","13","3","17","0","0","33"
"Caersws","52.51634","-3.42948","1","0","0","0","0","0","1","0","0","1","0","1","0","0","1","0","1","0","1","0","0","0","1"
"Cagliari","39.23054","9.11917","1","0","0","0","0","0","1","0","1","0","0","1","0","1","0","0","1","1","0","0","0","0","1"
"Cahir","52.37694","-7.92167","1","0","0","0","0","0","1","0","1","0","0","1","1","0","0","0","1","0","0","1","0","0","1"
"Cahul","45.90425","28.19929","1","0","0","0","0","0","1","0","0","0","1","1","1","0","0","0","1","0","0","1","0","0","1"
"Čair","42.01528","21.44111","1","0","0","0","0","0","1","0","0","1","0","1","0","0","1","0","1","0","0","0","0","1","1"
"Cairo","41.00112","-98.60757","100","7","0","1","13","0","126","33","34","17","9","93","50","33","39","4","126","45","13","51","11","7","127"
"Cairo","37.00533","-89.17646","100","7","0","1","13","0","126","33","34","17","9","93","50","33","39","4","126","45","13","51","11","7","127"
"Cairo","30.87751","-84.20214","100","7","0","1","13","0","126","33","34","17","9","93","50","33","39","4","126","45","13","51","11","7","127"
"Cairo","40.832","-84.08606","100","7","0","1","13","0","126","33","34","17","9","93","50","33","39","4","126","45","13","51","11","7","127"
"Cairo","42.29897","-73.99847","100","7","0","1","13","0","126","33","34","17","9","93","50","33","39","4","126","45","13","51","11","7","127"
"Cairo","30.06263","31.24967","100","7","0","1","13","0","126","33","34","17","9","93","50","33","39","4","126","45","13","51","11","7","127"
"Calabar","4.95893","8.32695","4","0","0","0","0","0","4","0","0","3","1","4","0","0","4","0","4","0","1","2","1","0","4"
"Calabozo","8.92416","-67.42929","1","0","0","0","0","0","1","0","0","0","0","0","1","0","0","0","1","1","0","0","0","0","1"
"Calais","45.18376","-67.27662","1","0","0","0","0","0","1","0","0","0","0","0","0","0","1","0","1","0","0","1","0","0","1"
"Calais","50.95194","1.85635","1","0","0","0","0","0","1","0","0","0","0","0","0","0","1","0","1","0","0","1","0","0","1"
"Calamba","14.21167","121.16528","3","0","0","0","0","0","3","1","1","1","0","3","2","0","1","0","3","0","2","1","0","0","3"
"Calamba","10.1755","123.2826","3","0","0","0","0","0","3","1","1","1","0","3","2","0","1","0","3","0","2","1","0","0","3"
"Calamba","8.5587","123.6425","3","0","0","0","0","0","3","1","1","1","0","3","2","0","1","0","3","0","2","1","0","0","3"
"Calamba","9.10361","125.59417","3","0","0","0","0","0","3","1","1","1","0","3","2","0","1","0","3","0","2","1","0","0","3"
"Călan","45.73333","22.98333","0","1","0","0","0","0","1","0","0","1","0","1","0","0","1","0","1","0","0","1","0","0","1"
"Caldercruix","55.88886","-3.88664","2","0","0","0","0","0","2","0","1","1","0","2","1","0","1","0","2","0","0","2","0","0","2"
"Caldicot","51.58661","-2.75736","5","0","0","0","0","0","6","0","3","3","0","6","0","1","5","0","6","1","3","2","0","0","6"
"Calgary","51.05011","-114.08529","23","2","0","0","0","0","25","4","8","10","1","23","11","3","9","2","25","4","7","13","1","0","25"
"Cali","3.43722","-76.5225","6","0","0","0","0","0","6","3","3","0","0","6","4","0","2","0","6","3","0","2","1","0","6"
"Callington","50.50147","-4.31314","0","1","0","0","0","0","1","0","1","0","0","1","1","0","0","0","1","0","1","0","0","0","1"
"Callington","-35.11977","139.0414","0","1","0","0","0","0","1","0","1","0","0","1","1","0","0","0","1","0","1","0","0","0","1"
"Calne","51.43879","-2.00571","4","0","0","0","0","0","4","0","3","0","0","3","2","0","2","0","4","1","0","3","0","0","4"
"Calp","38.6447","0.0445","0","0","0","0","1","0","1","0","0","0","0","0","1","0","0","0","1","0","0","1","0","0","1"
"Camberley","51.33705","-0.74261","18","0","0","1","3","0","22","7","5","9","0","21","5","3","14","0","22","4","8","9","0","1","22"
"Camborne","50.21306","-5.29731","2","0","0","0","0","0","2","0","0","1","0","1","0","0","2","0","2","1","1","0","0","0","2"
"Cambourne","52.22115","-0.07025","1","0","0","0","0","0","1","0","1","0","0","1","1","0","0","0","1","1","0","0","0","0","1"
"Cambridge","40.28195","-100.16569","66","2","0","4","4","0","84","15","17","33","2","67","27","15","42","1","85","6","14","59","1","4","84"
"Cambridge","41.89832","-93.5291","66","2","0","4","4","0","84","15","17","33","2","67","27","15","42","1","85","6","14","59","1","4","84"
"Cambridge","45.57274","-93.22439","66","2","0","4","4","0","84","15","17","33","2","67","27","15","42","1","85","6","14","59","1","4","84"
"Cambridge","41.30365","-90.1929","66","2","0","4","4","0","84","15","17","33","2","67","27","15","42","1","85","6","14","59","1","4","84"
"Cambridge","43.00361","-89.0165","66","2","0","4","4","0","84","15","17","33","2","67","27","15","42","1","85","6","14","59","1","4","84"
"Cambridge","40.03118","-81.58846","66","2","0","4","4","0","84","15","17","33","2","67","27","15","42","1","85","6","14","59","1","4","84"
"Cambridge","43.3601","-80.31269","66","2","0","4","4","0","84","15","17","33","2","67","27","15","42","1","85","6","14","59","1","4","84"
"Cambridge","18.31326","-77.90252","66","2","0","4","4","0","84","15","17","33","2","67","27","15","42","1","85","6","14","59","1","4","84"
"Cambridge","38.56317","-76.07883","66","2","0","4","4","0","84","15","17","33","2","67","27","15","42","1","85","6","14","59","1","4","84"
"Cambridge","43.02813","-73.38122","66","2","0","4","4","0","84","15","17","33","2","67","27","15","42","1","85","6","14","59","1","4","84"
"Cambridge","42.3751","-71.10561","66","2","0","4","4","0","84","15","17","33","2","67","27","15","42","1","85","6","14","59","1","4","84"
"Cambridge","45.02422","-69.47394","66","2","0","4","4","0","84","15","17","33","2","67","27","15","42","1","85","6","14","59","1","4","84"
"Cambridge","52.2","0.11667","66","2","0","4","4","0","84","15","17","33","2","67","27","15","42","1","85","6","14","59","1","4","84"
"Cambridge","-42.83333","147.45","66","2","0","4","4","0","84","15","17","33","2","67","27","15","42","1","85","6","14","59","1","4","84"
"Cambridge","-37.87822","175.4402","66","2","0","4","4","0","84","15","17","33","2","67","27","15","42","1","85","6","14","59","1","4","84"
"Cambrils","41.06997","1.05949","1","0","0","0","0","0","1","0","0","0","0","0","0","0","1","0","1","1","0","0","0","0","1"
"Cambuslang","55.80966","-4.16096","2","0","0","0","0","0","2","1","1","0","0","2","0","1","1","0","2","1","1","0","0","0","2"
"Camden Town","51.54057","-0.14334","3","0","0","0","0","0","3","1","0","0","0","1","1","0","2","0","3","0","1","2","0","0","3"
"Camelford","50.62185","-4.67963","2","0","0","0","0","0","2","0","1","1","0","2","1","0","1","0","2","0","2","0","0","0","2"
"Camooweal","-19.92154","138.12013","1","0","0","0","0","0","1","0","0","0","0","0","1","0","0","0","1","0","0","0","0","1","1"
"Campbell River","50.01634","-125.24459","1","0","0","0","0","0","1","0","1","0","0","1","0","0","1","0","1","1","0","0","0","0","1"
"Câmpeni","46.36667","23.05","1","0","0","0","0","0","1","1","0","0","0","1","0","0","1","0","1","0","0","1","0","0","1"
"Câmpeni","44.36764","24.01504","1","0","0","0","0","0","1","1","0","0","0","1","0","0","1","0","1","0","0","1","0","0","1"
"Câmpeni","46.60061","26.62738","1","0","0","0","0","0","1","1","0","0","0","1","0","0","1","0","1","0","0","1","0","0","1"
"Câmpeni","47.50625","26.99522","1","0","0","0","0","0","1","1","0","0","0","1","0","0","1","0","1","0","0","1","0","0","1"
"Câmpina","45.12619","25.73496","1","0","0","0","0","0","1","0","0","0","0","0","1","0","0","0","1","1","0","0","0","0","1"
"Campinas","-27.59444","-48.60694","2","0","0","0","0","0","2","1","0","1","0","2","0","1","1","0","2","0","1","1","0","0","2"
"Campinas","-22.90556","-47.06083","2","0","0","0","0","0","2","1","0","1","0","2","0","1","1","0","2","0","1","1","0","0","2"
"Campobasso","41.55947","14.66737","1","0","0","0","0","0","1","0","1","0","0","1","0","0","1","0","1","1","0","0","0","0","1"
"Campo Limpo Paulista","-23.20639","-46.78444","1","0","0","0","0","0","1","1","0","0","0","1","1","0","0","0","1","1","0","0","0","0","1"
"Camporeale","37.88612","13.10107","1","0","0","0","0","0","1","0","1","0","0","1","0","0","1","0","1","1","0","0","0","0","1"
"Campos dos Goytacazes","-21.75227","-41.33044","1","0","0","0","0","0","1","0","0","0","0","0","0","1","0","0","1","1","0","0","0","0","1"
"Çanakkale","40.15552","26.41271","1","0","0","0","0","0","1","0","0","1","0","1","0","0","1","0","1","0","0","1","0","0","1"
"Canberra","-35.28346","149.12807","2","0","0","0","0","0","2","0","0","0","1","1","1","1","0","0","2","2","0","0","0","0","2"
"Canewdon","51.61759","0.74458","1","0","0","0","0","0","1","0","1","0","0","1","1","0","0","0","1","0","0","1","0","0","1"
"Canmore","51.08335","-115.35206","1","0","0","0","0","0","1","1","0","0","0","1","1","0","0","0","1","0","0","1","0","0","1"
"Cannock","52.69045","-2.03085","10","4","0","0","0","0","16","6","5","3","1","15","4","3","9","0","16","4","5","7","0","0","16"
"Canterbury","43.33702","-71.56535","13","2","1","0","2","0","20","4","3","10","0","17","3","4","12","1","20","2","4","14","0","0","20"
"Canterbury","51.27904","1.07992","13","2","1","0","2","0","20","4","3","10","0","17","3","4","12","1","20","2","4","14","0","0","20"
"Canterbury","-37.8247","145.08476","13","2","1","0","2","0","20","4","3","10","0","17","3","4","12","1","20","2","4","14","0","0","20"
"Canterbury","-33.91192","151.11862","13","2","1","0","2","0","20","4","3","10","0","17","3","4","12","1","20","2","4","14","0","0","20"
"Cần Thơ","10.03711","105.78825","3","0","0","0","0","0","3","0","1","1","0","2","3","0","0","0","3","1","0","2","0","0","3"
"Canton","36.05365","-98.58842","1","0","0","0","0","0","2","1","0","1","0","2","0","1","1","0","2","1","0","1","0","0","2"
"Canton","38.38612","-97.42809","1","0","0","0","0","0","2","1","0","1","0","2","0","1","1","0","2","1","0","1","0","0","2"
"Canton","43.30081","-96.59282","1","0","0","0","0","0","2","1","0","1","0","2","0","1","1","0","2","1","0","1","0","0","2"
"Canton","32.55652","-95.8633","1","0","0","0","0","0","2","1","0","1","0","2","0","1","1","0","2","1","0","1","0","0","2"
"Canton","40.1295","-91.51852","1","0","0","0","0","0","2","1","0","1","0","2","0","1","1","0","2","1","0","1","0","0","2"
"Canton","32.61264","-90.03675","1","0","0","0","0","0","2","1","0","1","0","2","0","1","1","0","2","1","0","1","0","0","2"
"Canton","40.55809","-90.03512","1","0","0","0","0","0","2","1","0","1","0","2","0","1","1","0","2","1","0","1","0","0","2"
"Canton","34.23676","-84.49076","1","0","0","0","0","0","2","1","0","1","0","2","0","1","1","0","2","1","0","1","0","0","2"
"Canton","42.30865","-83.48216","1","0","0","0","0","0","2","1","0","1","0","2","0","1","1","0","2","1","0","1","0","0","2"
"Canton","35.53288","-82.83736","1","0","0","0","0","0","2","1","0","1","0","2","0","1","1","0","2","1","0","1","0","0","2"
"Canton","40.79895","-81.37845","1","0","0","0","0","0","2","1","0","1","0","2","0","1","1","0","2","1","0","1","0","0","2"
"Canton","41.65646","-76.85329","1","0","0","0","0","0","2","1","0","1","0","2","0","1","1","0","2","1","0","1","0","0","2"
"Canton","44.59562","-75.16909","1","0","0","0","0","0","2","1","0","1","0","2","0","1","1","0","2","1","0","1","0","0","2"
"Canton","42.15843","-71.14477","1","0","0","0","0","0","2","1","0","1","0","2","0","1","1","0","2","1","0","1","0","0","2"
"Canton","44.4408","-70.31649","1","0","0","0","0","0","2","1","0","1","0","2","0","1","1","0","2","1","0","1","0","0","2"
"Canvey Island","51.52199","0.5809","1","0","0","2","0","0","3","2","0","0","0","2","1","0","2","0","3","1","0","2","0","0","3"
"Capaccio","40.42435","15.07981","1","0","0","0","0","0","1","0","1","0","0","1","0","0","1","0","1","0","0","1","0","0","1"
"Cape Coast","5.10535","-1.2466","2","0","0","0","0","0","2","0","2","0","0","2","2","0","0","0","2","2","0","0","0","0","2"
"Cape Town","-33.92584","18.42322","19","0","0","0","4","0","24","3","11","4","0","18","12","6","3","3","24","12","2","9","0","1","24"
"Caracas","10.48801","-66.87919","6","3","0","0","0","0","9","5","1","2","0","8","3","2","4","0","9","2","1","6","0","0","9"
"Caravaca","38.10558","-1.86343","1","0","0","0","0","0","1","0","1","0","0","1","0","1","0","0","1","1","0","0","0","0","1"
"Cardenden","56.1431","-3.25687","1","0","0","0","0","0","1","0","0","1","0","1","0","0","1","0","1","0","0","1","0","0","1"
"Cardiff","51.48","-3.18","197","6","1","8","14","0","243","49","79","101","2","231","76","28","137","1","242","54","54","127","0","6","241"
"Cardiff","-32.94201","151.6544","197","6","1","8","14","0","243","49","79","101","2","231","76","28","137","1","242","54","54","127","0","6","241"
"Cardigan","52.08373","-4.66228","4","0","0","0","1","0","5","1","2","2","0","5","1","1","3","0","5","2","2","1","0","0","5"
"Cardigan","-37.53333","143.75","4","0","0","0","1","0","5","1","2","2","0","5","1","1","3","0","5","2","2","1","0","0","5"
"Carlingford","54.04","-6.18833","2","0","0","0","0","0","2","0","0","2","0","2","0","0","2","0","2","0","2","0","0","0","2"
"Carlingford","-33.78269","151.04888","2","0","0","0","0","0","2","0","0","2","0","2","0","0","2","0","2","0","2","0","0","0","2"
"Carlisle","35.50065","-95.02634","24","0","0","0","4","0","29","5","18","4","0","27","12","5","12","0","29","13","3","12","1","0","29"
"Carlisle","41.50082","-93.49105","24","0","0","0","4","0","29","5","18","4","0","27","12","5","12","0","29","13","3","12","1","0","29"
"Carlisle","34.78315","-91.74652","24","0","0","0","4","0","29","5","18","4","0","27","12","5","12","0","29","13","3","12","1","0","29"
"Carlisle","38.96838","-87.40557","24","0","0","0","4","0","29","5","18","4","0","27","12","5","12","0","29","13","3","12","1","0","29"
"Carlisle","39.582","-84.32022","24","0","0","0","4","0","29","5","18","4","0","27","12","5","12","0","29","13","3","12","1","0","29"
"Carlisle","38.31202","-84.02743","24","0","0","0","4","0","29","5","18","4","0","27","12","5","12","0","29","13","3","12","1","0","29"
"Carlisle","40.20148","-77.18887","24","0","0","0","4","0","29","5","18","4","0","27","12","5","12","0","29","13","3","12","1","0","29"
"Carlisle","42.52926","-71.3495","24","0","0","0","4","0","29","5","18","4","0","27","12","5","12","0","29","13","3","12","1","0","29"
"Carlisle","17.13226","-61.80356","24","0","0","0","4","0","29","5","18","4","0","27","12","5","12","0","29","13","3","12","1","0","29"
"Carlisle","54.8951","-2.9382","24","0","0","0","4","0","29","5","18","4","0","27","12","5","12","0","29","13","3","12","1","0","29"
"Carlisle","-31.97945","115.91808","24","0","0","0","4","0","29","5","18","4","0","27","12","5","12","0","29","13","3","12","1","0","29"
"Carlow","52.84083","-6.92611","1","0","0","0","0","0","1","0","0","1","0","1","0","0","1","0","1","1","0","0","0","0","1"
"Carlow","53.75861","10.93789","1","0","0","0","0","0","1","0","0","1","0","1","0","0","1","0","1","1","0","0","0","0","1"
"Carlsbad","33.15809","-117.35059","2","0","0","0","0","0","2","0","0","0","0","0","1","0","1","0","2","0","1","1","0","0","2"
"Carlsbad","32.42067","-104.22884","2","0","0","0","0","0","2","0","0","0","0","0","1","0","1","0","2","0","1","1","0","0","2"
"Carlsbad","31.60543","-100.64343","2","0","0","0","0","0","2","0","0","0","0","0","1","0","1","0","2","0","1","1","0","0","2"
"Carlton","45.29428","-123.17649","1","0","0","0","0","0","1","0","0","1","0","1","0","1","0","0","1","0","1","0","0","0","1"
"Carlton","46.67576","-114.07872","1","0","0","0","0","0","1","0","0","1","0","1","0","1","0","0","1","0","1","0","0","0","1"
"Carlton","46.66383","-92.42491","1","0","0","0","0","0","1","0","0","1","0","1","0","1","0","0","1","0","1","0","0","0","1"
"Carlton","54.59004","-1.39117","1","0","0","0","0","0","1","0","0","1","0","1","0","1","0","0","1","0","1","0","0","0","1"
"Carlton","52.18801","-0.60704","1","0","0","0","0","0","1","0","0","1","0","1","0","1","0","0","1","0","1","0","0","0","1"
"Carlton","-37.8","144.96667","1","0","0","0","0","0","1","0","0","1","0","1","0","1","0","0","1","0","1","0","0","0","1"
"Carlton","-42.86196","147.65523","1","0","0","0","0","0","1","0","0","1","0","1","0","1","0","0","1","0","1","0","0","0","1"
"Carlton","-33.97107","151.12136","1","0","0","0","0","0","1","0","0","1","0","1","0","1","0","0","1","0","1","0","0","0","1"
"Carmarthen","51.85552","-4.30535","18","1","0","2","1","0","22","4","5","8","0","17","8","5","9","0","22","7","10","5","0","0","22"
"Carmel","39.97837","-86.11804","1","0","0","0","0","0","1","0","1","0","0","1","1","0","0","0","1","1","0","0","0","0","1"
"Carmel","41.43009","-73.68013","1","0","0","0","0","0","1","0","1","0","0","1","1","0","0","0","1","1","0","0","0","0","1"
"Carmel","44.79757","-69.05115","1","0","0","0","0","0","1","0","1","0","0","1","1","0","0","0","1","1","0","0","0","0","1"
"Carmel","-32.01667","116.1","1","0","0","0","0","0","1","0","1","0","0","1","1","0","0","0","1","1","0","0","0","0","1"
"Carnegie","35.10367","-98.60367","1","0","0","0","0","0","1","0","0","1","0","1","1","0","0","0","1","0","0","1","0","0","1"
"Carnegie","40.40868","-80.08339","1","0","0","0","0","0","1","0","0","1","0","1","1","0","0","0","1","0","0","1","0","0","1"
"Carnegie","-37.89359","145.05534","1","0","0","0","0","0","1","0","0","1","0","1","1","0","0","0","1","0","0","1","0","0","1"
"Carnforth","54.13163","-2.76914","2","0","0","0","0","0","2","0","0","2","0","2","2","0","0","0","2","1","1","0","0","0","2"
"Carnoustie","56.50263","-2.7053","0","0","0","0","1","0","1","0","0","1","0","1","0","0","1","0","1","0","1","0","0","0","1"
"Carnwath","55.70036","-3.62579","1","0","0","0","0","0","1","0","0","0","0","0","1","0","0","0","1","0","0","1","0","0","1"
"Caronno Pertusella","45.59777","9.04634","1","0","0","0","0","0","1","0","1","0","0","1","0","0","1","0","1","1","0","0","0","0","1"
"Carrollton","32.95373","-96.89028","1","0","0","0","0","0","1","0","0","1","0","1","0","1","0","0","1","0","0","1","0","0","1"
"Carrollton","39.35835","-93.49577","1","0","0","0","0","0","1","0","0","1","0","1","0","1","0","0","1","0","0","1","0","0","1"
"Carrollton","39.30227","-90.40706","1","0","0","0","0","0","1","0","0","1","0","1","0","1","0","0","1","0","0","1","0","0","1"
"Carrollton","33.50818","-89.92036","1","0","0","0","0","0","1","0","0","1","0","1","0","1","0","0","1","0","0","1","0","0","1"
"Carrollton","33.26169","-88.09503","1","0","0","0","0","0","1","0","0","1","0","1","0","1","0","0","1","0","0","1","0","0","1"
"Carrollton","38.6809","-85.1794","1","0","0","0","0","0","1","0","0","1","0","1","0","1","0","0","1","0","0","1","0","0","1"
"Carrollton","33.58011","-85.07661","1","0","0","0","0","0","1","0","0","1","0","1","0","1","0","0","1","0","0","1","0","0","1"
"Carrollton","43.45864","-83.93025","1","0","0","0","0","0","1","0","0","1","0","1","0","1","0","0","1","0","0","1","0","0","1"
"Carrollton","40.57284","-81.08565","1","0","0","0","0","0","1","0","0","1","0","1","0","1","0","0","1","0","0","1","0","0","1"
"Carrollton","36.94682","-76.56051","1","0","0","0","0","0","1","0","0","1","0","1","0","1","0","0","1","0","0","1","0","0","1"
"Carshalton","51.36829","-0.16755","9","0","0","0","0","0","9","1","3","4","0","8","4","2","3","0","9","1","3","5","0","0","9"
"Cartagena","10.39972","-75.51444","1","0","0","0","0","0","1","0","0","1","0","1","0","0","1","0","1","0","0","1","0","0","1"
"Cartagena","-33.55384","-71.60761","1","0","0","0","0","0","1","0","0","1","0","1","0","0","1","0","1","0","0","1","0","0","1"
"Cartagena","37.60512","-0.98623","1","0","0","0","0","0","1","0","0","1","0","1","0","0","1","0","1","0","0","1","0","0","1"
"Cartagena","9.8203","122.4004","1","0","0","0","0","0","1","0","0","1","0","1","0","0","1","0","1","0","0","1","0","0","1"
"Carterton","51.75905","-1.59435","3","0","0","0","0","0","5","1","3","1","0","5","1","1","3","0","5","2","0","2","0","1","5"
"Carthage","32.15738","-94.33742","2","0","0","0","0","0","2","0","2","0","0","2","0","1","1","0","2","2","0","0","0","0","2"
"Carthage","37.17645","-94.31022","2","0","0","0","0","0","2","0","2","0","0","2","0","1","1","0","2","2","0","0","0","0","2"
"Carthage","40.41643","-91.13625","2","0","0","0","0","0","2","0","2","0","0","2","0","1","1","0","2","2","0","0","0","0","2"
"Carthage","32.73264","-89.53618","2","0","0","0","0","0","2","0","2","0","0","2","0","1","1","0","2","2","0","0","0","0","2"
"Carthage","41.91892","-89.31371","2","0","0","0","0","0","2","0","2","0","0","2","0","1","1","0","2","2","0","0","0","0","2"
"Carthage","36.25228","-85.95165","2","0","0","0","0","0","2","0","2","0","0","2","0","1","1","0","2","2","0","0","0","0","2"
"Carthage","39.73838","-85.57192","2","0","0","0","0","0","2","0","2","0","0","2","0","1","1","0","2","2","0","0","0","0","2"
"Carthage","35.34599","-79.41697","2","0","0","0","0","0","2","0","2","0","0","2","0","1","1","0","2","2","0","0","0","0","2"
"Carthage","43.97812","-75.60936","2","0","0","0","0","0","2","0","2","0","0","2","0","1","1","0","2","2","0","0","0","0","2"
"Carthage","44.62423","-70.47312","2","0","0","0","0","0","2","0","2","0","0","2","0","1","1","0","2","2","0","0","0","0","2"
"Carthage","36.86108","10.33161","2","0","0","0","0","0","2","0","2","0","0","2","0","1","1","0","2","2","0","0","0","0","2"
"Casablanca","33.58831","-7.61138","12","3","0","1","0","0","16","9","4","1","1","15","6","4","6","0","16","2","3","8","1","3","17"
"Cascais","38.69681","-9.42147","3","0","0","0","0","0","3","0","0","3","0","3","1","1","1","0","3","2","0","1","0","0","3"
"Cassino","41.48581","13.82835","1","0","0","0","0","0","1","0","1","0","0","1","0","1","0","0","1","0","0","0","0","1","1"
"Castaic","34.48888","-118.62287","1","0","0","0","0","0","1","0","1","0","0","1","0","1","0","0","1","0","0","1","0","0","1"
"Castelnaudary","43.31829","1.95449","1","0","0","0","0","0","1","0","1","0","0","1","1","0","0","0","1","1","0","0","0","0","1"
"Castel San Pietro Terme","44.39854","11.58546","1","0","0","0","0","0","1","1","0","0","0","1","0","0","1","0","1","0","0","1","0","0","1"
"Castlebar","53.85","-9.3","1","0","0","0","1","0","2","1","0","1","0","2","1","0","1","0","2","0","1","1","0","0","2"
"Castle Cary","51.09","-2.51417","1","0","0","0","0","0","2","0","0","2","0","2","0","0","2","0","2","0","1","1","0","0","2"
"Castlederg","54.70699","-7.59336","1","0","0","0","0","0","1","0","1","0","0","1","0","1","0","0","1","1","0","0","0","0","1"
"Castle Donington","52.84291","-1.34188","1","0","0","0","0","0","1","0","1","0","0","1","0","0","1","0","1","1","0","0","0","0","1"
"Castle Douglas","54.94095","-3.92784","1","0","0","0","0","0","1","0","1","0","0","1","1","0","0","0","1","0","1","0","0","0","1"
"Castleford","53.72587","-1.36256","5","0","0","0","0","0","5","1","2","3","0","6","3","0","3","0","6","2","1","3","0","0","6"
"Castle Rock","46.27511","-122.90761","1","0","0","0","0","0","1","0","1","0","0","1","1","0","0","0","1","0","0","1","0","0","1"
"Castle Rock","39.37221","-104.85609","1","0","0","0","0","0","1","0","1","0","0","1","1","0","0","0","1","0","0","1","0","0","1"
"Castrop-Rauxel","51.55657","7.31155","1","0","0","0","0","0","1","0","0","0","0","0","0","1","0","0","1","0","0","1","0","0","1"
"Catanzaro","38.88247","16.60086","1","0","0","0","0","0","1","0","0","0","0","0","1","0","0","0","1","0","0","0","0","1","1"
"Caterham","51.2823","-0.07889","7","1","0","1","2","0","11","2","4","4","0","10","3","1","6","1","11","2","3","6","0","0","11"
"Catford","51.44491","-0.02043","1","0","0","0","0","0","1","0","0","0","0","0","0","1","0","0","1","0","0","0","0","1","1"
"Catterick","54.37542","-1.63328","2","0","0","0","1","0","3","0","3","0","0","3","2","0","1","0","3","2","0","0","0","1","3"
"Cầu Giấy","21.03228","105.80073","1","0","0","0","0","0","1","1","0","0","0","1","0","0","1","0","1","0","0","1","0","0","1"
"Caulfield","-37.88251","145.02288","2","0","0","0","0","0","2","0","1","1","0","2","0","1","1","0","2","1","0","1","0","0","2"
"Caulfield North","-37.8739","145.02485","2","0","0","0","1","0","3","0","1","2","0","3","2","0","1","0","3","1","1","1","0","0","3"
"Cavan","53.99083","-7.36056","1","0","0","0","0","0","1","0","1","0","0","1","1","0","0","0","1","0","0","1","0","0","1"
"Cavan","48.67242","-3.34606","1","0","0","0","0","0","1","0","1","0","0","1","1","0","0","0","1","0","0","1","0","0","1"
"Cavite","15.67785","120.76978","1","0","0","0","0","0","1","0","0","0","0","0","0","1","0","0","1","1","0","0","0","0","1"
"Cawood","36.78398","-83.22823","1","0","0","0","0","0","1","0","1","0","0","1","0","0","1","0","1","0","0","1","0","0","1"
"Cawood","53.83303","-1.12962","1","0","0","0","0","0","1","0","1","0","0","1","0","0","1","0","1","0","0","1","0","0","1"
"Cebu City","10.31672","123.89071","5","0","0","0","0","0","5","2","0","0","2","4","3","0","1","1","5","1","2","2","0","0","5"
"Cecil","44.80999","-88.45232","1","0","0","0","0","0","1","1","0","0","0","1","0","0","1","0","1","0","0","1","0","0","1"
"Cedar Park","30.5052","-97.82029","2","0","0","0","0","0","2","0","0","1","0","1","0","1","1","0","2","0","0","2","0","0","2"
"Celje","46.23092","15.26044","1","0","0","0","0","0","1","0","1","0","0","1","0","0","1","0","1","0","0","1","0","0","1"
"Centennial","39.57916","-104.87692","1","0","0","0","0","0","1","0","1","0","0","1","0","0","1","0","1","1","0","0","0","0","1"
"Central","37.41665","-113.62441","0","1","0","0","0","0","1","0","1","0","0","1","1","0","0","0","1","0","0","1","0","0","1"
"Central","32.86757","-109.79286","0","1","0","0","0","0","1","0","1","0","0","1","1","0","0","0","1","0","0","1","0","0","1"
"Central","30.55435","-91.03677","0","1","0","0","0","0","1","0","1","0","0","1","1","0","0","0","1","0","0","1","0","0","1"
"Central","35.80369","-89.5373","0","1","0","0","0","0","1","0","1","0","0","1","1","0","0","0","1","0","0","1","0","0","1"
"Central","34.72427","-82.78125","0","1","0","0","0","0","1","0","1","0","0","1","1","0","0","0","1","0","0","1","0","0","1"
"Central","36.32622","-82.28958","0","1","0","0","0","0","1","0","1","0","0","1","1","0","0","0","1","0","0","1","0","0","1"
"Central","22.28299","114.15846","0","1","0","0","0","0","1","0","1","0","0","1","1","0","0","0","1","0","0","1","0","0","1"
"Central Falls","41.89066","-71.39228","1","0","0","0","0","0","1","1","0","0","0","1","1","0","0","0","1","1","0","0","0","0","1"
"Centre de Flacq","-20.18972","57.71444","3","0","0","0","0","0","3","1","0","2","0","3","0","0","3","0","3","0","2","1","0","0","3"
"Centurion","-25.85891","28.18577","0","0","0","0","1","0","1","1","0","0","0","1","0","1","0","0","1","0","1","0","0","0","1"
"Cernusco sul Naviglio","45.52526","9.33297","1","0","0","0","1","0","2","1","1","0","0","2","0","0","2","0","2","0","1","1","0","0","2"
"Cesena","44.1391","12.24315","2","0","0","0","0","0","2","1","0","0","0","1","1","0","1","0","2","1","0","1","0","0","2"
"Cesenatico","44.19987","12.3991","1","0","0","0","0","0","1","0","0","0","0","0","0","1","0","0","1","1","0","0","0","0","1"
"Cēsis","57.31188","25.27456","1","0","0","0","0","0","1","0","0","0","1","1","0","0","0","1","1","0","0","0","0","0","0"
"Chadiza","-14.06779","32.43917","1","0","0","0","0","0","1","0","1","0","0","1","0","0","0","1","1","0","0","1","0","0","1"
"Chafford Hundred","51.4892","0.2944","1","0","0","0","0","0","1","0","1","0","0","1","0","1","0","0","1","0","0","1","0","0","1"
"Chak Azam Sahu","30.75202","73.02834","1","0","0","0","0","0","1","0","1","0","0","1","1","0","0","0","1","0","0","1","0","0","1"
"Chakwal","32.93286","72.85394","1","0","0","0","0","0","1","1","0","0","0","1","1","0","0","0","1","0","0","1","0","0","1"
"Chalatenango","14.03333","-88.93333","1","0","0","0","0","0","1","1","0","0","0","1","0","1","0","0","1","0","0","0","1","0","1"
"Chalfont Saint Peter","51.60885","-0.55618","4","0","0","0","1","0","5","0","2","1","1","4","1","0","4","0","5","1","2","2","0","0","5"
"Chalfont St Giles","51.63184","-0.57026","4","0","0","0","2","0","6","2","0","1","0","3","2","0","4","0","6","0","2","4","0","0","6"
"Chalgrove","51.66476","-1.0764","0","0","0","0","1","0","1","0","1","0","0","1","0","0","1","0","1","1","0","0","0","0","1"
"Chama","36.90307","-106.57948","8","0","0","0","0","0","8","1","6","1","0","8","2","1","0","5","8","6","0","2","0","0","8"
"Chama","-11.21303","33.1521","8","0","0","0","0","0","8","1","6","1","0","8","2","1","0","5","8","6","0","2","0","0","8"
"Chaman","30.91769","66.45259","5","1","0","0","0","0","6","1","5","0","0","6","1","5","0","0","6","0","1","5","0","0","6"
"Champaign","40.11642","-88.24338","1","0","0","2","0","0","3","0","1","2","0","3","2","0","1","0","3","0","0","3","0","0","3"
"Chandigarh","30.73629","76.7884","2","1","0","0","0","0","3","2","0","0","1","3","0","1","2","0","3","0","0","2","0","1","3"
"Chandler","33.30616","-111.84125","0","0","0","0","1","0","1","0","1","0","0","1","0","1","0","0","1","1","0","0","0","0","1"
"Chandler","35.70173","-96.88086","0","0","0","0","1","0","1","0","1","0","0","1","0","1","0","0","1","1","0","0","0","0","1"
"Chandler","32.30793","-95.47996","0","0","0","0","1","0","1","0","1","0","0","1","0","1","0","0","1","1","0","0","0","0","1"
"Chandler","38.04171","-87.36806","0","0","0","0","1","0","1","0","1","0","0","1","0","1","0","0","1","1","0","0","0","0","1"
"Chandler","48.34935","-64.67926","0","0","0","0","1","0","1","0","1","0","0","1","0","1","0","0","1","1","0","0","0","0","1"
"Chandler","-27.51398","153.14907","0","0","0","0","1","0","1","0","1","0","0","1","0","1","0","0","1","1","0","0","0","0","1"
"Chang-hua","24.07327","120.56276","1","0","0","0","0","0","1","0","0","0","1","1","1","0","0","0","1","1","0","0","0","0","1"
"Changuinola","9.43","-82.52","1","0","0","0","0","0","1","0","0","0","0","0","0","0","1","0","1","1","0","0","0","0","1"
"Chaniá","35.51124","24.02921","3","0","0","0","0","0","3","2","1","0","0","3","1","1","1","0","3","3","0","0","0","0","3"
"Chapel en le Frith","53.32407","-1.91291","3","0","0","0","0","0","3","2","0","1","0","3","1","0","2","0","3","0","2","1","0","0","3"
"Chapel Hill","35.62646","-86.69333","1","0","0","0","0","0","2","0","0","0","0","0","0","2","0","0","2","1","1","0","0","0","2"
"Chapel Hill","35.9132","-79.05584","1","0","0","0","0","0","2","0","0","0","0","0","0","2","0","0","2","1","1","0","0","0","2"
"Chapel Hill","-27.50264","152.95012","1","0","0","0","0","0","2","0","0","0","0","0","0","2","0","0","2","1","1","0","0","0","2"
"Chapmanslade","51.22917","-2.24889","1","0","0","0","0","0","1","0","1","0","0","1","0","0","1","0","1","1","0","0","0","0","1"
"Chard","50.8727","-2.96597","5","0","0","1","0","0","6","2","1","1","0","4","3","1","2","0","6","0","3","2","0","1","6"
"Charfield","51.62722","-2.40667","1","0","0","0","0","0","1","0","0","1","0","1","0","0","1","0","1","0","1","0","0","0","1"
"Charikar","35.01361","69.17139","1","0","0","0","0","0","1","0","0","1","0","1","0","1","0","0","1","0","0","1","0","0","1"
"Charing","51.21073","0.79466","1","0","0","0","0","0","1","0","0","0","0","0","0","0","1","0","1","0","1","0","0","0","1"
"Charleston","35.29704","-94.03632","1","0","0","0","0","0","1","0","0","0","0","0","0","0","1","0","1","0","0","1","0","0","1"
"Charleston","34.00678","-90.05676","1","0","0","0","0","0","1","0","0","0","0","0","0","0","1","0","1","0","0","1","0","0","1"
"Charleston","36.92089","-89.35063","1","0","0","0","0","0","1","0","0","0","0","0","0","0","1","0","1","0","0","1","0","0","1"
"Charleston","39.49615","-88.17615","1","0","0","0","0","0","1","0","0","0","0","0","0","0","1","0","1","0","0","1","0","0","1"
"Charleston","35.2873","-84.75827","1","0","0","0","0","0","1","0","0","0","0","0","0","0","1","0","1","0","0","1","0","0","1"
"Charleston","38.34982","-81.63262","1","0","0","0","0","0","1","0","0","0","0","0","0","0","1","0","1","0","0","1","0","0","1"
"Charleston","32.77657","-79.93092","1","0","0","0","0","0","1","0","0","0","0","0","0","0","1","0","1","0","0","1","0","0","1"
"Charleston","40.53677","-74.23737","1","0","0","0","0","0","1","0","0","0","0","0","0","0","1","0","1","0","0","1","0","0","1"
"Charleston","45.08506","-69.04059","1","0","0","0","0","0","1","0","0","0","0","0","0","0","1","0","1","0","0","1","0","0","1"
"Charleston","-34.91667","138.9","1","0","0","0","0","0","1","0","0","0","0","0","0","0","1","0","1","0","0","1","0","0","1"
"Charlotte","28.86192","-98.70641","2","0","0","0","0","0","2","0","1","0","0","1","1","1","0","0","2","1","0","1","0","0","2"
"Charlotte","36.17728","-87.33973","2","0","0","0","0","0","2","0","1","0","0","1","1","1","0","0","2","1","0","1","0","0","2"
"Charlotte","42.56365","-84.83582","2","0","0","0","0","0","2","0","1","0","0","1","1","1","0","0","2","1","0","1","0","0","2"
"Charlotte","35.22709","-80.84313","2","0","0","0","0","0","2","0","1","0","0","1","1","1","0","0","2","1","0","1","0","0","2"
"Charlotte","44.30977","-73.26096","2","0","0","0","0","0","2","0","1","0","0","1","1","1","0","0","2","1","0","1","0","0","2"
"Charlton","42.13565","-71.97007","1","0","0","0","1","0","2","1","1","0","0","2","1","0","1","0","2","0","0","2","0","0","2"
"Charlton","51.59917","-2.05639","1","0","0","0","1","0","2","1","1","0","0","2","1","0","1","0","2","0","0","2","0","0","2"
"Charlton","-36.26437","143.34901","1","0","0","0","1","0","2","1","1","0","0","2","1","0","1","0","2","0","0","2","0","0","2"
"Charlwood","51.15644","-0.22586","1","0","0","0","0","0","1","0","0","1","0","1","0","0","1","0","1","0","0","1","0","0","1"
"Charsadda","34.14822","71.7406","5","1","0","0","0","0","6","3","1","2","1","7","1","0","6","0","7","0","1","5","0","1","7"
"Chatham","32.30626","-92.45042","8","0","0","0","1","0","14","6","1","4","0","11","6","0","8","0","14","3","9","2","0","0","14"
"Chatham","39.67616","-89.70454","8","0","0","0","1","0","14","6","1","4","0","11","6","0","8","0","14","3","9","2","0","0","14"
"Chatham","41.74115","-87.61255","8","0","0","0","1","0","14","6","1","4","0","11","6","0","8","0","14","3","9","2","0","0","14"
"Chatham","42.41224","-82.18494","8","0","0","0","1","0","14","6","1","4","0","11","6","0","8","0","14","3","9","2","0","0","14"
"Chatham","36.82569","-79.39808","8","0","0","0","1","0","14","6","1","4","0","11","6","0","8","0","14","3","9","2","0","0","14"
"Chatham","40.74093","-74.38376","8","0","0","0","1","0","14","6","1","4","0","11","6","0","8","0","14","3","9","2","0","0","14"
"Chatham","42.36425","-73.59484","8","0","0","0","1","0","14","6","1","4","0","11","6","0","8","0","14","3","9","2","0","0","14"
"Chatham","41.68206","-69.95974","8","0","0","0","1","0","14","6","1","4","0","11","6","0","8","0","14","3","9","2","0","0","14"
"Chatham","51.37891","0.52786","8","0","0","0","1","0","14","6","1","4","0","11","6","0","8","0","14","3","9","2","0","0","14"
"Chattanooga","35.04563","-85.30968","1","0","0","0","0","0","1","0","1","0","0","1","0","1","0","0","1","0","0","1","0","0","1"
"Chatteris","52.45624","0.05236","2","0","0","0","0","0","2","0","1","1","0","2","0","0","2","0","2","0","0","2","0","0","2"
"Cheadle","52.98333","-1.98333","4","0","0","0","1","0","5","1","2","2","0","5","3","0","2","0","5","1","1","3","0","0","5"
"Cheam","51.36179","-0.21977","1","0","0","1","0","0","3","1","0","0","0","1","1","0","2","0","3","1","0","2","0","0","3"
"Cheboksary","56.13222","47.25194","1","0","0","0","0","0","1","0","0","0","0","0","0","1","0","0","1","0","0","1","0","0","1"
"Cheddar","51.27537","-2.77662","1","0","0","0","0","0","1","0","0","1","0","1","0","0","1","0","1","0","1","0","0","0","1"
"Chelmsford","42.59981","-71.36728","41","3","0","1","11","0","60","9","23","20","2","54","21","10","30","0","61","16","10","32","3","0","61"
"Chelmsford","51.73575","0.46958","41","3","0","1","11","0","60","9","23","20","2","54","21","10","30","0","61","16","10","32","3","0","61"
"Cheltenham","51.90006","-2.07972","24","4","0","1","1","0","30","7","10","9","0","26","14","2","14","0","30","4","7","17","0","2","30"
"Cheltenham","-34.86788","138.52336","24","4","0","1","1","0","30","7","10","9","0","26","14","2","14","0","30","4","7","17","0","2","30"
"Cheltenham","-37.96944","145.04806","24","4","0","1","1","0","30","7","10","9","0","26","14","2","14","0","30","4","7","17","0","2","30"
"Chenab Nagar","31.75511","72.91403","1","0","0","0","0","0","1","1","0","0","0","1","1","0","0","0","1","0","0","1","0","0","1"
"Chennai","13.08784","80.27847","25","1","0","0","2","0","28","21","2","2","1","26","8","6","14","0","28","3","3","21","0","1","28"
"Chepstow","51.64087","-2.67683","4","2","0","0","0","0","7","2","2","2","0","6","3","0","4","0","7","0","2","5","0","0","7"
"Cherkasy","49.42854","32.06207","1","0","0","1","0","0","2","1","1","0","0","2","1","0","1","0","2","0","0","2","0","0","2"
"Chernivtsi","48.29149","25.94034","4","0","0","0","0","0","4","1","1","1","0","3","0","1","2","1","4","2","0","2","0","0","4"
"Chernivtsi","48.54225","28.11473","4","0","0","0","0","0","4","1","1","1","0","3","0","1","2","1","4","2","0","2","0","0","4"
"Cherry Hills Village","39.64165","-104.95943","1","0","0","0","0","0","1","0","0","0","0","0","1","0","0","0","1","0","0","1","0","0","1"
"Chertsey","46.07109","-73.89095","1","1","0","0","0","0","2","1","0","1","0","2","0","1","1","0","2","0","0","2","0","0","2"
"Chertsey","51.38812","-0.50782","1","1","0","0","0","0","2","1","0","1","0","2","0","1","1","0","2","0","0","2","0","0","2"
"Chesapeake","38.42786","-82.4571","2","0","0","0","0","0","2","0","1","0","0","1","2","0","0","0","2","2","0","0","0","0","2"
"Chesapeake","38.22344","-81.53623","2","0","0","0","0","0","2","0","1","0","0","1","2","0","0","0","2","2","0","0","0","0","2"
"Chesapeake","36.81904","-76.27494","2","0","0","0","0","0","2","0","1","0","0","1","2","0","0","0","2","2","0","0","0","0","2"
"Chesham","51.7","-0.6","5","0","0","0","1","0","8","1","4","2","0","7","2","2","4","0","8","4","1","3","0","0","8"
"Cheshunt","51.7002","-0.03026","6","0","0","0","0","0","6","0","4","1","0","5","3","1","2","0","6","1","1","2","2","0","6"
"Chessington","51.3624","-0.30427","3","0","0","0","0","0","3","0","1","1","0","2","0","2","1","0","3","0","1","1","1","0","3"
"Chester","40.30627","-121.23191","40","0","0","0","2","0","43","2","17","21","2","42","15","8","20","0","43","8","13","19","0","3","43"
"Chester","48.51054","-110.96747","40","0","0","0","2","0","43","2","17","21","2","42","15","8","20","0","43","8","13","19","0","3","43"
"Chester","37.91366","-89.82205","40","0","0","0","2","0","43","2","17","21","2","42","15","8","20","0","43","8","13","19","0","3","43"
"Chester","32.39378","-83.15293","40","0","0","0","2","0","43","2","17","21","2","42","15","8","20","0","43","8","13","19","0","3","43"
"Chester","34.70486","-81.21426","40","0","0","0","2","0","43","2","17","21","2","42","15","8","20","0","43","8","13","19","0","3","43"
"Chester","40.61312","-80.56285","40","0","0","0","2","0","43","2","17","21","2","42","15","8","20","0","43","8","13","19","0","3","43"
"Chester","37.35682","-77.44165","40","0","0","0","2","0","43","2","17","21","2","42","15","8","20","0","43","8","13","19","0","3","43"
"Chester","38.97539","-76.2894","40","0","0","0","2","0","43","2","17","21","2","42","15","8","20","0","43","8","13","19","0","3","43"
"Chester","39.84967","-75.35707","40","0","0","0","2","0","43","2","17","21","2","42","15","8","20","0","43","8","13","19","0","3","43"
"Chester","40.78427","-74.69683","40","0","0","0","2","0","43","2","17","21","2","42","15","8","20","0","43","8","13","19","0","3","43"
"Chester","41.36259","-74.27126","40","0","0","0","2","0","43","2","17","21","2","42","15","8","20","0","43","8","13","19","0","3","43"
"Chester","42.27926","-72.97871","40","0","0","0","2","0","43","2","17","21","2","42","15","8","20","0","43","8","13","19","0","3","43"
"Chester","43.26285","-72.59509","40","0","0","0","2","0","43","2","17","21","2","42","15","8","20","0","43","8","13","19","0","3","43"
"Chester","42.95675","-71.25728","40","0","0","0","2","0","43","2","17","21","2","42","15","8","20","0","43","8","13","19","0","3","43"
"Chester","45.40867","-68.49975","40","0","0","0","2","0","43","2","17","21","2","42","15","8","20","0","43","8","13","19","0","3","43"
"Chester","44.54225","-64.23891","40","0","0","0","2","0","43","2","17","21","2","42","15","8","20","0","43","8","13","19","0","3","43"
"Chester","53.1905","-2.89189","40","0","0","0","2","0","43","2","17","21","2","42","15","8","20","0","43","8","13","19","0","3","43"
"Chesterfield","38.66311","-90.57707","20","0","0","0","3","0","23","4","8","7","0","19","5","4","14","0","23","5","4","14","0","0","23"
"Chesterfield","40.11254","-85.59692","20","0","0","0","3","0","23","4","8","7","0","19","5","4","14","0","23","5","4","14","0","0","23"
"Chesterfield","34.73599","-80.08812","20","0","0","0","3","0","23","4","8","7","0","19","5","4","14","0","23","5","4","14","0","0","23"
"Chesterfield","37.37709","-77.50582","20","0","0","0","3","0","23","4","8","7","0","19","5","4","14","0","23","5","4","14","0","0","23"
"Chesterfield","42.39175","-72.83982","20","0","0","0","3","0","23","4","8","7","0","19","5","4","14","0","23","5","4","14","0","0","23"
"Chesterfield","42.8873","-72.47037","20","0","0","0","3","0","23","4","8","7","0","19","5","4","14","0","23","5","4","14","0","0","23"
"Chesterfield","53.25","-1.41667","20","0","0","0","3","0","23","4","8","7","0","19","5","4","14","0","23","5","4","14","0","0","23"
"Chester-le-Street","54.85862","-1.57408","4","0","0","0","2","0","6","2","0","2","0","4","2","0","4","0","6","0","2","4","0","0","6"
"Chestermere","51.03341","-113.81867","1","0","0","0","0","0","1","0","0","1","0","1","0","1","0","0","1","0","0","1","0","0","1"
"Chevreuse","48.70662","2.03329","1","0","0","0","0","0","1","0","0","0","0","0","0","0","1","0","1","0","0","1","0","0","1"
"Chhindwāra","22.05697","78.93958","1","0","0","0","0","0","1","0","0","1","0","1","0","0","1","0","1","0","0","1","0","0","1"
"Chibuto","-24.68667","33.53056","1","0","0","0","0","0","1","0","1","0","0","1","1","0","0","0","1","0","1","0","0","0","1"
"Chicago","41.85003","-87.65005","15","0","0","0","0","0","15","4","2","4","0","10","6","4","5","0","15","1","2","9","1","2","15"
"Chicago Lawn","41.77503","-87.69644","1","0","0","0","0","0","1","1","0","0","0","1","0","0","1","0","1","0","0","1","0","0","1"
"Chichawatni","30.5301","72.69155","2","0","0","0","0","0","2","0","0","1","0","1","0","2","0","0","2","0","0","0","0","2","2"
"Chichester","43.24925","-71.39979","33","2","0","1","4","0","42","6","14","13","1","34","19","7","16","0","42","7","11","23","1","0","42"
"Chichester","50.83673","-0.78003","33","2","0","1","4","0","42","6","14","13","1","34","19","7","16","0","42","7","11","23","1","0","42"
"Chico","47.61148","-122.71042","1","0","0","0","0","0","1","0","0","1","0","1","0","1","0","0","1","0","0","1","0","0","1"
"Chico","39.72849","-121.83748","1","0","0","0","0","0","1","0","0","1","0","1","0","1","0","0","1","0","0","1","0","0","1"
"Chico","33.29595","-97.79892","1","0","0","0","0","0","1","0","0","1","0","1","0","1","0","0","1","0","0","1","0","0","1"
"Chiddingfold","51.11866","-0.62262","7","0","0","0","0","0","7","1","0","0","0","1","1","1","5","0","7","0","2","5","0","0","7"
"Chigwell","51.61999","0.07596","2","0","0","0","0","0","2","0","0","1","0","1","0","0","2","0","2","0","0","1","1","0","2"
"Chigwell","-42.80912","147.2448","2","0","0","0","0","0","2","0","0","1","0","1","0","0","2","0","2","0","0","1","1","0","2"
"Chihuahua","28.63528","-106.08889","3","0","0","0","0","0","3","1","1","1","0","3","1","1","1","0","3","1","0","2","0","0","3"
"Chihuahua","16.02966","-91.97331","3","0","0","0","0","0","3","1","1","1","0","3","1","1","1","0","3","1","0","2","0","0","3"
"Chikhli","20.75751","73.06268","2","0","0","0","0","0","2","0","0","0","1","1","1","0","1","0","2","1","0","1","0","0","2"
"Chikhli","20.35046","76.25774","2","0","0","0","0","0","2","0","0","0","1","1","1","0","1","0","2","1","0","1","0","0","2"
"Chikwawa","-16.03352","34.80091","2","0","0","0","0","0","2","0","1","0","1","2","1","0","1","0","2","2","0","0","0","0","2"
"Chilaw","7.57583","79.79528","5","0","0","0","0","0","5","2","1","2","0","5","1","1","2","1","5","1","0","4","0","0","5"
"Chilches","39.78238","-0.18742","1","0","0","0","0","0","1","1","0","0","0","1","0","0","0","1","1","0","1","0","0","0","1"
"Chililabombwe","-12.36475","27.82286","3","0","0","0","0","0","3","0","1","1","1","3","2","1","0","0","3","1","0","0","1","1","3"
"Chingola","-12.52897","27.88382","3","0","0","0","0","0","3","0","3","0","0","3","3","0","0","0","3","2","0","1","0","0","3"
"Chiniot","31.72091","72.97836","1","0","0","0","0","0","1","0","0","1","0","1","0","0","1","0","1","0","0","0","1","0","1"
"Chinley","53.34025","-1.939","1","0","0","0","0","0","1","0","1","0","0","1","0","0","1","0","1","0","0","1","0","0","1"
"Chinnor","51.70177","-0.91161","1","0","0","0","0","0","1","0","1","0","0","1","1","0","0","0","1","1","0","0","0","0","1"
"Chipata","-13.63333","32.65","2","0","0","0","0","0","2","0","1","0","1","2","1","0","1","0","2","1","0","0","0","1","2"
"Chiplūn","17.53339","73.50935","1","0","0","0","0","0","1","1","0","0","0","1","1","0","0","0","1","0","0","1","0","0","1"
"Chippenham","51.46","-2.12472","15","1","0","1","0","0","18","3","6","7","0","16","3","2","13","0","18","1","7","9","0","1","18"
"Chippenham","52.30184","0.43636","15","1","0","1","0","0","18","3","6","7","0","16","3","2","13","0","18","1","7","9","0","1","18"
"Chipping Norton","51.94109","-1.5453","2","0","0","0","0","0","4","0","0","2","0","2","0","1","3","0","4","1","0","3","0","0","4"
"Chipping Norton","-33.91801","150.95927","2","0","0","0","0","0","4","0","0","2","0","2","0","1","3","0","4","1","0","3","0","0","4"
"Chirgaon","25.57198","78.81432","1","0","0","0","0","0","1","0","0","0","0","0","0","0","1","0","1","1","0","0","0","0","1"
"Chisinau","47.00556","28.8575","13","3","0","0","0","0","16","5","3","2","0","10","1","6","9","0","16","7","1","6","0","2","16"
"Chislehurst","51.41709","0.06858","1","0","0","0","0","0","1","0","0","1","0","1","0","0","1","0","1","0","0","1","0","0","1"
"Chitre","28.42673","83.69076","0","0","0","1","0","0","1","0","0","0","0","0","0","0","1","0","1","0","0","0","0","0","0"
"Chitré","7.96082","-80.42944","1","0","0","0","0","0","1","1","0","0","0","1","0","0","1","0","1","0","0","1","0","0","1"
"Chittagong","22.3384","91.83168","49","2","0","0","3","1","56","29","8","9","3","49","20","8","25","2","55","5","7","32","4","8","56"
"Chittaurgarh","24.88963","74.62403","1","0","0","0","0","0","1","1","0","0","0","1","0","1","0","0","1","0","0","1","0","0","1"
"Chittoor","13.21055","79.0956","1","0","0","0","0","0","1","1","0","0","0","1","0","0","1","0","1","0","0","1","0","0","1"
"Chlef","36.16525","1.33452","2","0","0","0","0","0","2","1","1","0","0","2","0","1","1","0","2","1","1","0","0","0","2"
"Choa Saidan Shah","32.71962","72.98625","1","0","0","0","0","0","1","1","0","0","0","1","1","0","0","0","1","0","0","1","0","0","1"
"Chobham","51.34836","-0.60639","1","0","0","0","0","0","1","0","0","1","0","1","0","0","0","1","1","0","1","0","0","0","1"
"Cholsey","51.5728","-1.15356","1","0","0","0","0","0","1","0","1","0","0","1","1","0","0","0","1","0","0","1","0","0","1"
"Choma","-16.80889","26.9875","3","0","0","0","1","0","4","0","3","0","1","4","1","1","1","1","4","1","1","0","1","1","4"
"Chongwe","-15.32916","28.68204","1","0","0","0","0","0","1","0","1","0","0","1","0","0","1","0","1","1","0","0","0","0","1"
"Choppington","55.15004","-1.60332","1","0","0","0","0","0","1","0","0","0","0","0","1","0","0","0","1","1","0","0","0","0","1"
"Chorley","53.65","-2.61667","20","0","0","0","3","0","23","4","9","7","0","20","16","3","4","0","23","3","5","15","0","0","23"
"Chorleywood","51.65472","-0.51404","1","0","0","0","0","0","1","0","0","0","0","0","0","0","1","0","1","0","0","1","0","0","1"
"Christchurch","50.73583","-1.78129","22","0","0","0","1","0","24","5","5","10","0","20","7","2","15","0","24","4","8","9","1","1","23"
"Christchurch","-43.53333","172.63333","22","0","0","0","1","0","24","5","5","10","0","20","7","2","15","0","24","4","8","9","1","1","23"
"Chudleigh","50.60496","-3.60031","1","0","0","0","0","0","1","0","0","1","0","1","0","0","1","0","1","0","0","1","0","0","1"
"Chuka","-0.33316","37.64587","1","0","0","0","0","0","1","0","0","0","0","0","0","0","0","0","0","0","0","1","0","0","1"
"Chula Vista","32.64005","-117.0842","2","0","0","0","0","0","2","0","0","0","0","0","1","1","0","0","2","1","0","1","0","0","2"
"Chula Vista","27.04083","-103.36611","2","0","0","0","0","0","2","0","0","0","0","0","1","1","0","0","2","1","0","1","0","0","2"
"Chunian","30.96621","73.97908","0","1","0","0","0","0","1","0","0","1","0","1","1","0","0","0","1","0","0","1","0","0","1"
"Church Stretton","52.53778","-2.80149","1","0","0","0","0","0","1","0","0","1","0","1","0","1","0","0","1","0","0","1","0","0","1"
"Cicero","41.84559","-87.75394","1","0","0","0","0","0","1","0","1","0","0","1","0","0","0","0","0","1","0","0","0","0","1"
"Cicero","40.12393","-86.01332","1","0","0","0","0","0","1","0","1","0","0","1","0","0","0","0","0","1","0","0","0","0","1"
"Cincinnati","39.12711","-84.51439","0","0","0","1","0","0","1","1","0","0","0","1","0","1","0","0","1","0","0","1","0","0","1"
"Cirencester","51.71927","-1.97145","8","0","0","0","0","0","8","1","5","0","0","6","5","1","2","0","8","2","3","3","0","0","8"
"Citrus Heights","38.70712","-121.28106","1","0","0","0","0","0","1","0","0","0","0","0","1","0","0","0","1","0","0","1","0","0","1"
"Ciudad Obregón","27.48642","-109.94083","2","0","0","0","0","0","2","0","0","0","0","0","2","0","0","0","2","2","0","0","0","0","2"
"Ciudad Victoria","23.74174","-99.14599","2","0","0","0","1","0","3","1","0","0","0","1","3","0","0","0","3","0","0","3","0","0","3"
"Cividale del Friuli","46.09019","13.42861","2","0","0","0","0","0","2","1","0","0","0","1","0","0","2","0","2","0","2","0","0","0","2"
"Clackmannan","56.10743","-3.75098","1","0","0","0","0","0","1","0","0","1","0","1","0","0","1","0","1","0","1","0","0","0","1"
"Clacton-on-Sea","51.78967","1.15597","2","0","0","0","0","0","2","0","1","0","0","1","0","0","2","0","2","1","0","1","0","0","2"
"Clanfield","51.71623","-1.58888","1","1","0","0","0","0","2","1","0","1","0","2","0","0","2","0","2","0","0","2","0","0","2"
"Clanwilliam","-32.18173","18.89217","1","0","0","0","0","0","1","1","0","0","0","1","0","0","1","0","1","0","0","1","0","0","1"
"Clapham","52.16085","-0.49529","2","0","0","0","0","0","2","0","0","2","0","2","2","0","0","0","2","0","0","2","0","0","2"
"Clapham","-34.98989","138.60158","2","0","0","0","0","0","2","0","0","2","0","2","2","0","0","0","2","0","0","2","0","0","2"
"Clara","53.3425","-7.61389","1","0","0","0","0","0","1","1","0","0","0","1","0","0","1","0","1","0","0","1","0","0","1"
"Claremorris","53.71667","-9","1","0","0","0","0","0","1","0","1","0","0","1","0","0","1","0","1","0","1","0","0","0","1"
"Claverdon","52.27919","-1.71267","1","0","0","0","0","0","1","0","0","0","0","0","0","0","1","0","1","0","0","1","0","0","1"
"Clayton South","-37.93333","145.11667","1","0","0","0","0","0","1","0","1","0","0","1","0","1","0","0","1","0","0","1","0","0","1"
"Cleator Moor","54.52143","-3.5159","0","0","0","0","0","0","1","0","0","0","0","0","0","0","1","0","1","0","0","1","0","0","1"
"Cleckheaton","53.72405","-1.71294","4","1","0","0","0","0","5","1","0","4","0","5","3","0","2","0","5","1","1","3","0","0","5"
"Cleethorpes","53.56047","-0.03225","2","0","0","0","0","0","3","0","2","1","0","3","0","0","3","0","3","0","2","1","0","0","3"
"Clermont","43.00359","-91.65237","2","0","0","0","0","0","2","0","0","1","0","1","1","0","1","0","2","0","0","2","0","0","2"
"Clermont","39.80977","-86.32249","2","0","0","0","0","0","2","0","0","1","0","1","1","0","1","0","2","0","0","2","0","0","2"
"Clermont","34.47788","-83.77351","2","0","0","0","0","0","2","0","0","1","0","1","1","0","1","0","2","0","0","2","0","0","2"
"Clermont","28.54944","-81.77285","2","0","0","0","0","0","2","0","0","1","0","1","1","0","1","0","2","0","0","2","0","0","2"
"Clermont","43.65174","-0.91734","2","0","0","0","0","0","2","0","0","1","0","1","1","0","1","0","2","0","0","2","0","0","2"
"Clermont","49.37897","2.41258","2","0","0","0","0","0","2","0","0","1","0","1","1","0","1","0","2","0","0","2","0","0","2"
"Clermont","-22.82407","147.63635","2","0","0","0","0","0","2","0","0","1","0","1","1","0","1","0","2","0","0","2","0","0","2"
"Clevedon","51.44227","-2.85786","1","1","0","0","2","0","4","1","1","2","0","4","2","0","2","0","4","1","1","1","0","1","4"
"Cleveleys","53.8775","-3.03987","1","0","0","0","0","0","1","0","1","0","0","1","1","0","0","0","1","1","0","0","0","0","1"
"Cliffside Park","40.82149","-73.98764","2","0","0","0","0","0","2","1","0","1","0","2","1","0","1","0","2","0","0","2","0","0","2"
"Clifton Beach","-16.76313","145.67167","1","0","0","0","0","0","1","0","0","0","0","0","0","1","0","0","1","1","0","0","0","0","1"
"Clifton Beach","-42.98531","147.52107","1","0","0","0","0","0","1","0","0","0","0","0","0","1","0","0","1","1","0","0","0","0","1"
"Clifton Hill","-37.79798","144.99533","0","0","0","0","1","0","1","1","0","0","0","1","0","0","1","0","1","0","0","0","1","0","1"
"Clitheroe","53.86667","-2.4","7","0","0","0","1","0","9","1","3","4","1","9","3","1","3","1","8","2","3","3","0","0","8"
"Cluj-Napoca","46.76667","23.6","17","0","0","0","0","0","17","2","3","5","0","10","6","3","8","0","17","3","2","8","0","4","17"
"Clunderwen","51.84056","-4.73167","2","0","0","0","0","0","2","1","0","0","0","1","0","0","2","0","2","0","1","1","0","0","2"
"Clutton","51.32944","-2.54306","1","0","0","0","0","0","1","1","0","0","0","1","0","0","1","0","1","1","0","0","0","0","1"
"Clydebank","55.90137","-4.4057","1","0","0","0","0","0","1","0","0","1","0","1","0","0","1","0","1","0","0","1","0","0","1"
"Clyde North","-38.11667","145.33333","0","0","0","0","1","0","1","0","1","0","0","1","1","0","0","0","1","0","0","1","0","0","1"
"Coalville","40.91773","-111.39936","3","0","0","0","0","0","3","0","0","3","0","3","1","0","2","0","3","0","0","3","0","0","3"
"Coalville","42.44525","-94.12579","3","0","0","0","0","0","3","0","0","3","0","3","1","0","2","0","3","0","0","3","0","0","3"
"Coalville","52.72247","-1.3702","3","0","0","0","0","0","3","0","0","3","0","3","1","0","2","0","3","0","0","3","0","0","3"
"Coatbridge","55.86216","-4.02469","2","1","0","0","1","0","4","0","1","2","0","3","1","1","2","0","4","1","2","1","0","0","4"
"Cobham","51.32997","-0.4113","4","0","0","0","0","0","5","2","0","2","0","4","2","0","3","0","5","0","3","2","0","0","5"
"Cobija","-11.02671","-68.76918","1","0","0","0","0","0","1","0","0","0","0","0","0","0","1","0","1","0","0","0","0","1","1"
"Cochabamba","-6.48333","-78.9","3","0","0","0","0","0","3","3","0","0","0","3","0","0","3","0","3","0","0","3","0","0","3"
"Cochabamba","-9.49361","-77.85944","3","0","0","0","0","0","3","3","0","0","0","3","0","0","3","0","3","0","0","3","0","0","3"
"Cochabamba","-9.09536","-76.83688","3","0","0","0","0","0","3","3","0","0","0","3","0","0","3","0","3","0","0","3","0","0","3"
"Cochabamba","-17.3895","-66.1568","3","0","0","0","0","0","3","3","0","0","0","3","0","0","3","0","3","0","0","3","0","0","3"
"Cochin","9.93988","76.26022","1","0","0","0","0","0","1","0","0","1","0","1","0","0","1","0","1","0","0","1","0","0","1"
"Cochrane","51.18341","-114.46871","1","0","0","0","0","0","1","0","0","0","0","0","0","1","0","0","1","1","0","0","0","0","1"
"Cochrane","-47.2557","-72.5695","1","0","0","0","0","0","1","0","0","0","0","0","0","1","0","0","1","1","0","0","0","0","1"
"Cockatoo","-37.93677","145.49376","1","0","0","0","0","0","1","1","0","0","0","1","0","0","1","0","1","0","1","0","0","0","1"
"Cockermouth","54.66209","-3.36086","3","0","0","0","0","0","3","0","1","2","0","3","1","0","2","0","3","1","1","1","0","0","3"
"Cocoa","28.38612","-80.742","1","0","0","0","0","0","1","0","1","0","0","1","0","1","0","0","1","1","0","0","0","0","1"
"Codlea","45.7","25.45","1","0","0","0","0","0","1","0","0","1","0","1","0","0","1","0","1","0","0","1","0","0","1"
"Coedpoeth","53.05391","-3.06234","1","0","0","0","0","0","1","0","0","1","0","1","0","0","1","0","1","0","1","0","0","0","1"
"Coelbren","51.79181","-3.67014","1","0","0","0","0","0","1","0","0","1","0","1","0","0","1","0","1","0","0","1","0","0","1"
"Coffs Harbour","-30.29626","153.11351","1","0","0","0","0","0","1","0","0","0","0","0","1","0","0","0","1","1","0","0","0","0","1"
"Coggeshall","51.87077","0.68536","3","0","0","0","0","0","3","0","1","1","0","2","2","0","1","0","3","1","0","2","0","0","3"
"Coimbatore","11.00555","76.96612","2","0","0","0","0","0","2","3","0","0","0","3","0","0","3","0","3","0","0","3","0","0","3"
"Coimbra","40.20564","-8.41955","2","0","0","0","0","0","2","0","0","0","0","0","0","1","1","0","2","1","0","1","0","0","2"
"Colac","-38.339","143.58489","1","0","0","0","0","0","1","0","0","1","0","1","0","0","1","0","1","0","1","0","0","0","1"
"Colbert","33.85316","-96.50249","1","0","0","0","0","0","1","0","1","0","0","1","0","0","1","0","1","0","1","0","0","0","1"
"Colbert","34.03789","-83.21265","1","0","0","0","0","0","1","0","1","0","0","1","0","0","1","0","1","0","1","0","0","0","1"
"Colchester","40.42643","-90.79263","37","1","0","2","2","0","42","9","16","8","1","34","16","7","19","0","42","15","10","14","1","2","42"
"Colchester","44.54394","-73.14791","37","1","0","2","2","0","42","9","16","8","1","34","16","7","19","0","42","15","10","14","1","2","42"
"Colchester","41.57565","-72.33203","37","1","0","2","2","0","42","9","16","8","1","34","16","7","19","0","42","15","10","14","1","2","42"
"Colchester","51.88921","0.90421","37","1","0","2","2","0","42","9","16","8","1","34","16","7","19","0","42","15","10","14","1","2","42"
"Cold Norton","51.67209","0.66997","1","0","0","0","0","0","2","0","1","1","0","2","1","0","1","0","2","0","0","2","0","0","2"
"Coleford","51.79535","-2.61354","3","0","0","0","0","0","3","0","1","1","0","2","2","0","1","0","3","1","1","1","0","0","3"
"Coleraine","47.28883","-93.42771","4","0","0","0","0","0","4","0","4","0","0","4","1","1","2","0","4","2","1","0","0","1","4"
"Coleraine","55.13333","-6.66667","4","0","0","0","0","0","4","0","4","0","0","4","1","1","2","0","4","2","1","0","0","1","4"
"Coleraine","-37.59827","141.69124","4","0","0","0","0","0","4","0","4","0","0","4","1","1","2","0","4","2","1","0","0","1","4"
"College Station","30.62798","-96.33441","1","0","0","0","0","0","1","0","0","0","0","0","0","1","0","0","1","0","0","1","0","0","1"
"College Station","34.70815","-92.22126","1","0","0","0","0","0","1","0","0","0","0","0","0","1","0","0","1","0","0","1","0","0","1"
"Colleyville","32.88096","-97.15501","2","0","0","0","0","0","2","0","0","0","0","0","1","0","1","0","2","1","1","0","0","0","2"
"Colne","53.85713","-2.16851","3","0","0","0","0","0","3","1","1","1","0","3","1","1","1","0","3","1","1","1","0","0","3"
"Colombo","-25.29167","-49.22417","11","0","0","0","0","0","11","8","2","0","0","10","3","2","6","0","11","5","0","6","0","0","11"
"Colombo","6.93548","79.84868","11","0","0","0","0","0","11","8","2","0","0","10","3","2","6","0","11","5","0","6","0","0","11"
"Coloncito","8.56292","-79.89944","1","0","0","0","0","0","1","0","0","0","0","0","1","0","0","0","1","0","0","0","0","0","0"
"Coloncito","8.32611","-72.08742","1","0","0","0","0","0","1","0","0","0","0","0","1","0","0","0","1","0","0","0","0","0","0"
"Colorado Springs","38.83388","-104.82136","2","0","0","0","0","0","2","0","0","0","1","1","2","0","0","0","2","1","0","1","0","0","2"
"Columbia","38.03631","-120.40131","1","0","0","0","0","0","1","0","0","1","0","1","1","0","0","0","1","0","0","1","0","0","1"
"Columbia","38.95171","-92.33407","1","0","0","0","0","0","1","0","0","1","0","1","1","0","0","0","1","0","0","1","0","0","1"
"Columbia","32.10516","-92.07791","1","0","0","0","0","0","1","0","0","1","0","1","1","0","0","0","1","0","0","1","0","0","1"
"Columbia","38.44366","-90.20122","1","0","0","0","0","0","1","0","0","1","0","1","1","0","0","0","1","0","0","1","0","0","1"
"Columbia","31.25184","-89.83758","1","0","0","0","0","0","1","0","0","1","0","1","1","0","0","0","1","0","0","1","0","0","1"
"Columbia","35.61507","-87.03528","1","0","0","0","0","0","1","0","0","1","0","1","1","0","0","0","1","0","0","1","0","0","1"
"Columbia","37.10284","-85.30635","1","0","0","0","0","0","1","0","0","1","0","1","1","0","0","0","1","0","0","1","0","0","1"
"Columbia","31.29271","-85.11267","1","0","0","0","0","0","1","0","0","1","0","1","1","0","0","0","1","0","0","1","0","0","1"
"Columbia","34.00071","-81.03481","1","0","0","0","0","0","1","0","0","1","0","1","1","0","0","0","1","0","0","1","0","0","1"
"Columbia","39.24038","-76.83942","1","0","0","0","0","0","1","0","0","1","0","1","1","0","0","0","1","0","0","1","0","0","1"
"Columbia","40.03371","-76.50441","1","0","0","0","0","0","1","0","0","1","0","1","1","0","0","0","1","0","0","1","0","0","1"
"Columbia","35.91766","-76.25215","1","0","0","0","0","0","1","0","0","1","0","1","1","0","0","0","1","0","0","1","0","0","1"
"Columbia","44.85199","-71.55175","1","0","0","0","0","0","1","0","0","1","0","1","1","0","0","0","1","0","0","1","0","0","1"
"Columbus","45.63661","-109.25211","3","0","0","0","0","0","3","0","1","1","1","3","1","0","2","0","3","1","0","2","0","0","3"
"Columbus","31.8276","-107.64002","3","0","0","0","0","0","3","0","1","1","1","3","1","0","2","0","3","1","0","2","0","0","3"
"Columbus","41.42973","-97.36838","3","0","0","0","0","0","3","0","1","1","1","3","1","0","2","0","3","1","0","2","0","0","3"
"Columbus","29.70662","-96.53969","3","0","0","0","0","0","3","0","1","1","1","3","1","0","2","0","3","1","0","2","0","0","3"
"Columbus","37.16923","-94.84412","3","0","0","0","0","0","3","0","1","1","1","3","1","0","2","0","3","1","0","2","0","0","3"
"Columbus","45.26522","-93.05015","3","0","0","0","0","0","3","0","1","1","1","3","1","0","2","0","3","1","0","2","0","0","3"
"Columbus","43.33805","-89.01539","3","0","0","0","0","0","3","0","1","1","1","3","1","0","2","0","3","1","0","2","0","0","3"
"Columbus","33.49567","-88.42726","3","0","0","0","0","0","3","0","1","1","1","3","1","0","2","0","3","1","0","2","0","0","3"
"Columbus","39.20144","-85.92138","3","0","0","0","0","0","3","0","1","1","1","3","1","0","2","0","3","1","0","2","0","0","3"
"Columbus","32.46098","-84.98771","3","0","0","0","0","0","3","0","1","1","1","3","1","0","2","0","3","1","0","2","0","0","3"
"Columbus","39.96118","-82.99879","3","0","0","0","0","0","3","0","1","1","1","3","1","0","2","0","3","1","0","2","0","0","3"
"Columbus","35.25317","-82.19706","3","0","0","0","0","0","3","0","1","1","1","3","1","0","2","0","3","1","0","2","0","0","3"
"Columbus","41.94089","-79.58172","3","0","0","0","0","0","3","0","1","1","1","3","1","0","2","0","3","1","0","2","0","0","3"
"Columbus","42.68396","-75.37267","3","0","0","0","0","0","3","0","1","1","1","3","1","0","2","0","3","1","0","2","0","0","3"
"Colwyn Bay","53.29483","-3.72674","6","0","0","0","1","0","7","1","3","2","0","6","0","2","5","0","7","4","1","2","0","0","7"
"Colyton","50.74006","-3.07021","1","0","0","0","0","0","1","0","0","1","0","1","0","0","1","0","1","0","1","0","0","0","1"
"Colyton","-33.78283","150.79679","1","0","0","0","0","0","1","0","0","1","0","1","0","0","1","0","1","0","1","0","0","0","1"
"Comber","54.54937","-5.74379","3","0","0","0","0","0","3","0","1","2","0","3","0","0","3","0","3","0","2","1","0","0","3"
"Comberton","52.18709","0.01905","0","1","0","0","0","0","1","0","0","1","0","1","0","0","1","0","1","0","0","1","0","0","1"
"Comilla","23.46186","91.18503","10","0","1","0","0","1","13","4","5","0","3","12","4","4","3","2","13","2","1","7","2","1","13"
"Commercy","48.76128","5.59067","1","0","0","0","0","0","1","1","0","0","0","1","0","0","1","0","1","0","0","1","0","0","1"
"Comodoro Rivadavia","-45.86413","-67.49656","2","0","0","0","0","0","2","1","1","0","0","2","0","1","1","0","2","0","1","0","0","1","2"
"Conakry","9.53795","-13.67729","3","0","0","0","0","0","3","0","3","0","0","3","1","2","0","0","3","2","0","0","0","1","3"
"Concepción","16.80908","-92.96526","2","0","0","0","0","0","2","2","0","0","0","2","0","0","2","0","2","0","1","1","0","0","2"
"Concepción","14.78417","-91.14754","2","0","0","0","0","0","2","2","0","0","0","2","0","0","2","0","2","0","1","1","0","0","2"
"Concepción","9.93333","-84","2","0","0","0","0","0","2","2","0","0","0","2","0","0","2","0","2","0","1","1","0","0","2"
"Concepción","-11.91762","-75.31401","2","0","0","0","0","0","2","2","0","0","0","2","0","0","2","0","2","0","1","1","0","0","2"
"Concepción","6.39408","-75.2583","2","0","0","0","0","0","2","2","0","0","0","2","0","0","2","0","2","0","1","1","0","0","2"
"Concepción","-36.82699","-73.04977","2","0","0","0","0","0","2","2","0","0","0","2","0","0","2","0","2","0","1","1","0","0","2"
"Concepción","6.76619","-72.694","2","0","0","0","0","0","2","2","0","0","0","2","0","0","2","0","2","0","1","1","0","0","2"
"Concepción","10.8","-71.76667","2","0","0","0","0","0","2","2","0","0","0","2","0","0","2","0","2","0","1","1","0","0","2"
"Concepción","10.4119","-71.68919","2","0","0","0","0","0","2","2","0","0","0","2","0","0","2","0","2","0","1","1","0","0","2"
"Concepción","-27.34127","-65.59636","2","0","0","0","0","0","2","2","0","0","0","2","0","0","2","0","2","0","1","1","0","0","2"
"Concepción","-16.43333","-60.9","2","0","0","0","0","0","2","2","0","0","0","2","0","0","2","0","2","0","1","1","0","0","2"
"Concepción","-28.39175","-57.88777","2","0","0","0","0","0","2","2","0","0","0","2","0","0","2","0","2","0","1","1","0","0","2"
"Concepción","-23.39985","-57.43236","2","0","0","0","0","0","2","2","0","0","0","2","0","0","2","0","2","0","1","1","0","0","2"
"Concepción de La Vega","19.22207","-70.52956","1","0","0","0","0","0","1","0","0","1","0","1","1","0","0","0","1","0","0","1","0","0","1"
"Concord","37.97798","-122.03107","0","0","0","0","1","0","1","0","1","0","0","1","0","0","0","1","1","1","0","0","0","0","1"
"Concord","38.5245","-90.35734","0","0","0","0","1","0","1","0","1","0","0","1","0","0","0","1","1","1","0","0","0","0","1"
"Concord","43.06945","-88.59871","0","0","0","0","1","0","1","0","1","0","0","1","0","0","0","1","1","1","0","0","0","0","1"
"Concord","33.46761","-87.03111","0","0","0","0","1","0","1","0","1","0","0","1","0","0","0","1","1","1","0","0","0","0","1"
"Concord","42.17782","-84.64302","0","0","0","0","1","0","1","0","1","0","0","1","0","0","0","1","1","1","0","0","0","0","1"
"Concord","35.40888","-80.58158","0","0","0","0","1","0","1","0","1","0","0","1","0","0","0","1","1","1","0","0","0","0","1"
"Concord","43.80011","-79.48291","0","0","0","0","1","0","1","0","1","0","0","1","0","0","0","1","1","1","0","0","0","0","1"
"Concord","37.34264","-78.97502","0","0","0","0","1","0","1","0","1","0","0","1","0","0","0","1","1","1","0","0","0","0","1"
"Concord","40.60816","-74.08431","0","0","0","0","1","0","1","0","1","0","0","1","0","0","0","1","1","1","0","0","0","0","1"
"Concord","43.20814","-71.53757","0","0","0","0","1","0","1","0","1","0","0","1","0","0","0","1","1","1","0","0","0","0","1"
"Concord","42.46037","-71.34895","0","0","0","0","1","0","1","0","1","0","0","1","0","0","0","1","1","1","0","0","0","0","1"
"Concord","-33.84722","151.10381","0","0","0","0","1","0","1","0","1","0","0","1","0","0","0","1","1","1","0","0","0","0","1"
"Congleton","53.16314","-2.21253","3","0","0","0","0","0","3","0","1","2","0","3","2","0","1","0","3","0","0","3","0","0","3"
"Congomah","-20.14889","57.59083","2","0","0","0","0","0","2","0","1","0","0","1","0","2","0","0","2","2","0","0","0","0","2"
"Congresbury","51.37135","-2.81018","1","0","0","0","0","0","1","1","0","0","0","1","0","0","1","0","1","0","0","1","0","0","1"
"Coningsby","53.10598","-0.17595","1","0","0","0","0","0","1","0","0","1","0","1","0","0","1","0","1","0","1","0","0","0","1"
"Conroe","30.31188","-95.45605","1","0","0","0","0","0","1","0","1","0","0","1","0","1","0","0","1","1","0","0","0","0","1"
"Consett","54.85404","-1.8316","3","0","0","0","1","0","4","0","1","2","0","3","1","0","3","0","4","1","1","2","0","0","4"
"Constanţa","44.18073","28.63432","4","1","0","0","0","0","6","2","1","0","0","3","2","2","2","0","6","3","0","3","0","0","6"
"Constantia","43.24785","-76.0002","1","0","0","0","0","0","1","0","1","0","0","1","1","0","0","0","1","1","0","0","0","0","1"
"Constantia","-34.03139","18.41833","1","0","0","0","0","0","1","0","1","0","0","1","1","0","0","0","1","1","0","0","0","0","1"
"Constantine","41.84116","-85.6686","8","0","0","0","1","0","9","3","0","5","0","8","1","2","6","0","9","1","6","1","0","1","9"
"Constantine","50.1189","-5.17595","8","0","0","0","1","0","9","3","0","5","0","8","1","2","6","0","9","1","6","1","0","1","9"
"Constantine","36.365","6.61472","8","0","0","0","1","0","9","3","0","5","0","8","1","2","6","0","9","1","6","1","0","1","9"
"Conway","37.50199","-92.82101","0","0","0","1","0","0","1","0","0","0","0","0","1","0","0","0","1","1","0","0","0","0","1"
"Conway","35.0887","-92.4421","0","0","0","1","0","0","1","0","0","0","0","0","1","0","0","0","1","1","0","0","0","0","1"
"Conway","28.50278","-81.33062","0","0","0","1","0","0","1","0","0","0","0","0","1","0","0","0","1","1","0","0","0","0","1"
"Conway","40.65979","-80.23923","0","0","0","1","0","0","1","0","0","0","0","0","1","0","0","0","1","1","0","0","0","0","1"
"Conway","33.836","-79.04781","0","0","0","1","0","0","1","0","0","0","0","0","1","0","0","0","1","1","0","0","0","0","1"
"Conway","36.4371","-77.22886","0","0","0","1","0","0","1","0","0","0","0","0","1","0","0","0","1","1","0","0","0","0","1"
"Conway","42.50981","-72.69953","0","0","0","1","0","0","1","0","0","0","0","0","1","0","0","0","1","1","0","0","0","0","1"
"Conway","43.97924","-71.12035","0","0","0","1","0","0","1","0","0","0","0","0","1","0","0","0","1","1","0","0","0","0","1"
"Conwy","53.28077","-3.83039","4","0","0","0","1","0","5","2","1","2","0","5","4","0","1","0","5","0","3","2","0","0","5"
"Cookham","51.55936","-0.7081","1","0","0","0","0","0","1","1","0","0","0","1","0","0","1","0","1","0","0","1","0","0","1"
"Cookstown","44.18341","-79.69964","6","0","0","0","0","0","7","3","2","1","0","6","2","2","3","0","7","1","1","5","0","0","7"
"Cookstown","54.64305","-6.74595","6","0","0","0","0","0","7","3","2","1","0","6","2","2","3","0","7","1","1","5","0","0","7"
"Copenhagen","43.8934","-75.67353","5","0","0","2","0","0","8","2","1","2","0","5","5","1","2","0","8","1","1","6","0","0","8"
"Copenhagen","55.67594","12.56553","5","0","0","2","0","0","8","2","1","2","0","5","5","1","2","0","8","1","1","6","0","0","8"
"Copiapó","-27.36679","-70.3314","0","1","0","0","0","0","1","0","0","0","0","0","1","0","0","0","1","0","0","1","0","0","1"
"Copthorne","51.13929","-0.11742","1","0","0","0","0","0","1","0","0","0","0","0","1","0","0","0","1","1","0","0","0","0","1"
"Coral Springs","26.27119","-80.2706","1","0","0","0","0","0","1","0","0","1","0","1","0","0","1","0","1","0","0","1","0","0","1"
"Corby","52.49637","-0.68939","4","0","0","0","0","0","5","1","3","1","0","5","3","0","2","0","5","1","1","3","0","0","5"
"Córdoba","18.8842","-96.92559","3","0","0","0","0","0","3","0","0","2","1","3","3","0","0","0","3","1","0","0","2","0","3"
"Córdoba","0.85362","-77.51817","3","0","0","0","0","0","3","0","0","2","1","3","3","0","0","0","3","1","0","0","2","0","3"
"Córdoba","4.39158","-75.68723","3","0","0","0","0","0","3","0","0","2","1","3","3","0","0","0","3","1","0","0","2","0","3"
"Córdoba","9.58612","-74.82705","3","0","0","0","0","0","3","0","0","2","1","3","3","0","0","0","3","1","0","0","2","0","3"
"Córdoba","-31.4135","-64.18105","3","0","0","0","0","0","3","0","0","2","1","3","3","0","0","0","3","1","0","0","2","0","3"
"Córdoba","37.89155","-4.77275","3","0","0","0","0","0","3","0","0","2","1","3","3","0","0","0","3","1","0","0","2","0","3"
"Corfe Castle","50.63947","-2.05672","1","0","0","0","0","0","1","0","1","0","0","1","0","0","1","0","1","0","1","0","0","0","1"
"Cork","51.89797","-8.47061","1","0","0","0","1","0","2","1","0","0","0","1","5","0","0","0","5","3","1","1","0","0","5"
"Cornwall","40.2737","-76.40607","1","0","0","0","0","0","1","0","0","1","0","1","0","0","1","0","1","0","1","0","0","0","1"
"Cornwall","45.01809","-74.72815","1","0","0","0","0","0","1","0","0","1","0","1","0","0","1","0","1","0","1","0","0","0","1"
"Cornwall","41.44482","-74.0157","1","0","0","0","0","0","1","0","0","1","0","1","0","0","1","0","1","0","1","0","0","0","1"
"Cornwall","46.22652","-63.21809","1","0","0","0","0","0","1","0","0","1","0","1","0","0","1","0","1","0","1","0","0","0","1"
"Coro","11.4045","-69.67344","1","0","0","0","0","0","1","0","1","0","0","1","1","0","0","0","1","1","0","0","0","0","1"
"Corona","33.87529","-117.56644","1","0","0","0","0","0","1","0","1","0","0","1","1","0","0","0","1","1","0","0","0","0","1"
"Corona","40.74705","-73.86014","1","0","0","0","0","0","1","0","1","0","0","1","1","0","0","0","1","1","0","0","0","0","1"
"Corozal","21.54627","-98.55444","1","0","0","0","0","0","1","0","1","0","0","1","0","1","0","0","1","1","0","0","0","0","1"
"Corozal","18.39375","-88.38849","1","0","0","0","0","0","1","0","1","0","0","1","0","1","0","0","1","1","0","0","0","0","1"
"Corozal","15.8","-86.71667","1","0","0","0","0","0","1","0","1","0","0","1","0","1","0","0","1","1","0","0","0","0","1"
"Corozal","8.07712","-81.4399","1","0","0","0","0","0","1","0","1","0","0","1","0","1","0","0","1","1","0","0","0","0","1"
"Corozal","8.20108","-77.59637","1","0","0","0","0","0","1","0","1","0","0","1","0","1","0","0","1","1","0","0","0","0","1"
"Corozal","9.31847","-75.2933","1","0","0","0","0","0","1","0","1","0","0","1","0","1","0","0","1","1","0","0","0","0","1"
"Corozal","18.34106","-66.31684","1","0","0","0","0","0","1","0","1","0","0","1","0","1","0","0","1","1","0","0","0","0","1"
"Corral de Bustos","-33.28205","-62.18463","1","0","0","0","0","0","1","0","1","0","0","1","0","0","1","0","1","1","0","0","0","0","1"
"Corsham","51.43433","-2.18437","7","0","0","0","1","0","10","0","4","6","0","10","4","1","5","0","10","0","2","8","0","0","10"
"Cosenza","39.2989","16.25307","1","0","0","0","0","0","1","1","0","0","0","1","0","0","1","0","1","0","0","1","0","0","1"
"Cosgrove","52.07518","-0.84801","1","0","0","0","0","0","1","0","1","0","0","1","1","0","0","0","1","0","0","0","0","1","1"
"Cosheston","51.69653","-4.88882","1","0","0","0","0","0","1","0","0","0","0","0","1","0","0","0","1","0","0","1","0","0","1"
"Cosoleacaque","17.99913","-94.6359","1","0","0","0","0","0","1","0","0","1","0","1","0","0","1","0","1","0","1","0","0","0","1"
"Cotonou","6.36536","2.41833","2","0","0","0","0","0","2","1","1","0","0","2","1","1","0","0","2","0","0","1","0","1","2"
"Cottage","-20.05972","57.62917","1","0","0","0","0","0","1","0","1","0","0","1","0","1","0","0","1","0","0","0","0","1","1"
"Cottingham","52.50243","-0.7554","1","0","0","0","0","0","3","0","1","1","0","2","1","0","2","0","3","1","1","1","0","0","3"
"Cottingham","53.78057","-0.41542","1","0","0","0","0","0","3","0","1","1","0","2","1","0","2","0","3","1","1","1","0","0","3"
"Coulsdon","51.32002","-0.14088","8","0","0","0","2","0","10","1","5","3","0","9","5","1","4","0","10","2","2","5","1","0","10"
"Courchevel","45.41538","6.63643","1","0","0","0","0","0","1","0","0","0","0","0","0","0","1","0","1","0","0","1","0","0","1"
"Cove","45.29653","-117.80799","0","0","0","0","0","0","1","0","0","0","0","0","1","0","0","0","1","0","1","0","0","0","1"
"Cove","29.82744","-94.80242","0","0","0","0","0","0","1","0","0","0","0","0","1","0","0","0","1","0","1","0","0","0","1"
"Cove","57.1","-2.08333","0","0","0","0","0","0","1","0","0","0","0","0","1","0","0","0","1","0","1","0","0","0","1"
"Coven","52.65587","-2.1353","1","0","0","0","0","0","1","0","0","0","0","0","1","0","0","0","1","1","0","0","0","0","1"
"Coventry","41.7001","-71.68284","62","3","0","1","9","0","80","17","19","30","1","67","20","12","47","1","80","17","28","34","0","1","80"
"Coventry","52.40656","-1.51217","62","3","0","1","9","0","80","17","19","30","1","67","20","12","47","1","80","17","28","34","0","1","80"
"Covington","47.35818","-122.12216","1","0","0","0","0","0","1","0","0","0","0","0","0","1","0","0","1","0","0","1","0","0","1"
"Covington","36.30754","-97.58644","1","0","0","0","0","0","1","0","0","0","0","0","0","1","0","0","1","0","0","1","0","0","1"
"Covington","30.47549","-90.10042","1","0","0","0","0","0","1","0","0","0","0","0","0","1","0","0","1","0","0","1","0","0","1"
"Covington","35.56425","-89.64647","1","0","0","0","0","0","1","0","0","0","0","0","0","1","0","0","1","0","0","1","0","0","1"
"Covington","40.1417","-87.39474","1","0","0","0","0","0","1","0","0","0","0","0","0","1","0","0","1","0","0","1","0","0","1"
"Covington","39.08367","-84.50855","1","0","0","0","0","0","1","0","0","0","0","0","0","1","0","0","1","0","0","1","0","0","1"
"Covington","40.11727","-84.35384","1","0","0","0","0","0","1","0","0","0","0","0","0","1","0","0","1","0","0","1","0","0","1"
"Covington","33.59678","-83.86018","1","0","0","0","0","0","1","0","0","0","0","0","0","1","0","0","1","0","0","1","0","0","1"
"Covington","37.79346","-79.99395","1","0","0","0","0","0","1","0","0","0","0","0","0","1","0","0","1","0","0","1","0","0","1"
"Cowbridge","51.46028","-3.44167","2","0","0","0","1","0","3","1","1","1","0","3","3","0","0","0","3","0","1","2","0","0","3"
"Cowdenbeath","56.11194","-3.34426","2","0","0","0","0","0","2","0","1","1","0","2","1","0","1","0","2","0","0","2","0","0","2"
"Cowes","50.76306","-1.29772","1","0","0","0","0","0","1","0","1","0","0","1","1","0","0","0","1","0","0","1","0","0","1"
"Cowes","-38.45231","145.23865","1","0","0","0","0","0","1","0","1","0","0","1","1","0","0","0","1","0","0","1","0","0","1"
"Cowfold","50.98945","-0.27243","1","0","0","0","0","0","1","0","0","0","0","0","0","0","1","0","1","0","0","1","0","0","1"
"Cox’s Bāzār","21.43973","92.00955","7","1","0","0","0","0","8","4","1","1","0","6","3","4","2","1","10","1","1","6","1","0","9"
"Coyoacán","19.3467","-99.16174","1","0","0","0","0","0","1","1","0","0","0","1","0","0","1","0","1","0","0","1","0","0","1"
"Cradley Heath","52.47214","-2.08212","2","0","0","0","0","0","3","1","1","1","0","3","0","1","2","0","3","1","0","2","0","0","3"
"Craigavon","54.44709","-6.387","5","0","0","0","1","0","7","1","2","2","0","5","1","1","5","0","7","2","1","3","0","1","7"
"Craiova","44.31667","23.8","3","0","0","0","0","0","3","0","0","0","0","0","2","1","0","0","3","3","0","0","0","0","3"
"Cramlington","55.08652","-1.58598","23","1","0","0","0","0","25","0","7","10","0","17","10","6","9","0","25","4","11","9","0","1","25"
"Cranbrook","49.49991","-115.76879","5","0","0","0","1","0","6","1","3","2","0","6","3","0","3","0","6","1","0","4","0","1","6"
"Cranbrook","51.09662","0.53567","5","0","0","0","1","0","6","1","3","2","0","6","3","0","3","0","6","1","0","4","0","1","6"
"Cranbrook","-19.30553","146.75286","5","0","0","0","1","0","6","1","3","2","0","6","3","0","3","0","6","1","0","4","0","1","6"
"Cranleigh","51.14209","-0.48374","3","1","0","0","0","0","4","0","0","3","0","3","1","2","1","0","4","0","1","3","0","0","4"
"Craven Arms","52.44308","-2.83562","0","0","0","0","1","0","1","0","1","0","0","1","0","1","0","0","1","0","0","1","0","0","1"
"Crawley","51.11303","-0.18312","19","0","0","1","0","0","21","2","7","8","0","17","8","4","9","0","21","4","7","10","0","0","21"
"Crawley","-31.98418","115.81603","19","0","0","1","0","0","21","2","7","8","0","17","8","4","9","0","21","4","7","10","0","0","21"
"Crawley Down","51.12061","-0.0773","0","0","0","0","2","0","2","1","0","0","0","1","1","0","1","0","2","0","1","1","0","0","2"
"Crediton","50.78333","-3.65","2","0","0","0","0","0","2","0","1","0","0","1","1","0","1","0","2","0","1","1","0","0","2"
"Crescent City","41.75595","-124.20175","1","0","0","0","0","0","1","0","0","0","0","0","1","0","0","0","1","0","0","1","0","0","1"
"Crescent City","40.77004","-87.85893","1","0","0","0","0","0","1","0","0","0","0","0","1","0","0","0","1","0","0","1","0","0","1"
"Crescent City","29.43025","-81.51063","1","0","0","0","0","0","1","0","0","0","0","0","1","0","0","0","1","0","0","1","0","0","1"
"Crewe","37.17321","-78.12333","15","2","0","0","0","0","18","2","5","4","0","11","8","2","8","0","18","8","4","5","0","1","18"
"Crewe","53.09787","-2.44161","15","2","0","0","0","0","18","2","5","4","0","11","8","2","8","0","18","8","4","5","0","1","18"
"Crewkerne","50.88298","-2.79588","4","1","0","0","0","0","5","1","1","1","0","3","2","0","3","0","5","1","1","2","0","1","5"
"Crick","52.34808","-1.13708","1","0","0","0","0","0","1","0","0","1","0","1","0","0","1","0","1","0","0","1","0","0","1"
"Crickhowell","51.85992","-3.13771","1","0","0","0","0","0","1","0","0","0","0","0","0","1","0","0","1","0","0","1","0","0","1"
"Crieff","56.37268","-3.83891","1","0","0","0","0","0","1","1","0","0","0","1","1","0","0","0","1","0","1","0","0","0","1"
"Crofton","42.72889","-97.49562","1","0","0","0","0","0","1","0","0","1","0","1","1","0","0","0","1","0","1","0","0","0","1"
"Crofton","37.04782","-87.485","1","0","0","0","0","0","1","0","0","1","0","1","1","0","0","0","1","0","1","0","0","0","1"
"Crofton","39.00178","-76.68747","1","0","0","0","0","0","1","0","0","1","0","1","1","0","0","0","1","0","1","0","0","0","1"
"Crofton","53.65639","-1.42968","1","0","0","0","0","0","1","0","0","1","0","1","1","0","0","0","1","0","1","0","0","0","1"
"Cromarty","57.68095","-4.0341","1","0","0","0","0","0","1","0","0","0","0","0","1","0","0","0","1","0","0","1","0","0","1"
"Cromer","52.93123","1.29892","1","0","0","0","0","0","1","0","1","0","0","1","0","0","1","0","1","1","0","0","0","0","1"
"Cromer","-33.7312","151.26788","1","0","0","0","0","0","1","0","1","0","0","1","0","0","1","0","1","1","0","0","0","0","1"
"Cromford","53.10848","-1.56014","1","0","0","0","0","0","1","0","0","0","0","0","1","0","0","0","1","0","0","1","0","0","1"
"Crondall","51.23285","-0.86329","1","0","0","0","0","0","1","0","0","0","0","0","0","0","1","0","1","0","0","1","0","0","1"
"Crook","54.71252","-1.7497","2","0","0","0","0","0","2","0","2","0","0","2","0","1","1","0","2","1","1","0","0","0","2"
"Crosby","48.9142","-103.29491","3","0","0","0","0","0","3","0","1","1","0","2","0","3","0","0","3","0","0","3","0","0","3"
"Crosby","29.91189","-95.06215","3","0","0","0","0","0","3","0","1","1","0","2","0","3","0","0","3","0","0","3","0","0","3"
"Crosby","46.48218","-93.95776","3","0","0","0","0","0","3","0","1","1","0","2","0","3","0","0","3","0","0","3","0","0","3"
"Crosby","54.18333","-4.56667","3","0","0","0","0","0","3","0","1","1","0","2","0","3","0","0","3","0","0","3","0","0","3"
"Crosby","53.47778","-3.03333","3","0","0","0","0","0","3","0","1","1","0","2","0","3","0","0","3","0","0","3","0","0","3"
"Crosne","48.71921","2.45728","1","0","0","0","0","0","1","0","0","0","0","0","0","0","1","0","1","0","0","1","0","0","1"
"Crossgates","56.08366","-3.37712","1","0","0","0","0","0","1","0","0","1","0","1","0","0","1","0","1","0","1","0","0","0","1"
"Cross Hands","51.79306","-4.0875","1","0","0","0","0","0","1","0","1","0","0","1","0","0","1","0","1","1","0","0","0","0","1"
"Crosskeys","51.61917","-3.12361","1","0","0","0","0","0","1","0","0","1","0","1","0","0","1","0","1","0","0","1","0","0","1"
"Crowborough","51.06098","0.16342","6","0","0","0","0","0","6","0","4","2","0","6","1","3","2","0","6","1","2","2","0","1","6"
"Crowthorne","51.37027","-0.79219","5","0","0","0","0","0","6","0","1","1","0","2","2","1","3","0","6","2","1","3","0","0","6"
"Croydon","40.08733","-74.9035","101","10","0","4","11","0","133","28","30","49","4","111","39","19","72","3","133","23","33","69","4","4","133"
"Croydon","43.45063","-72.16314","101","10","0","4","11","0","133","28","30","49","4","111","39","19","72","3","133","23","33","69","4","4","133"
"Croydon","51.38333","-0.1","101","10","0","4","11","0","133","28","30","49","4","111","39","19","72","3","133","23","33","69","4","4","133"
"Croydon","-37.8","145.28333","101","10","0","4","11","0","133","28","30","49","4","111","39","19","72","3","133","23","33","69","4","4","133"
"Croydon","-33.88333","151.11667","101","10","0","4","11","0","133","28","30","49","4","111","39","19","72","3","133","23","33","69","4","4","133"
"Crymych","51.97361","-4.64722","2","0","0","0","1","0","3","0","1","1","0","2","1","0","2","0","3","1","1","1","0","0","3"
"Cuauhtemoc","24.29037","-103.80913","1","0","0","0","0","0","1","0","0","0","0","0","0","1","0","0","1","0","0","0","1","0","1"
"Cuautitlán Izcalli","19.64388","-99.21598","1","0","0","0","0","0","1","0","0","1","0","1","0","0","1","0","1","0","1","0","0","0","1"
"Cúcuta","7.89391","-72.50782","1","0","0","0","0","0","1","0","1","0","0","1","0","0","1","0","1","1","0","0","0","0","1"
"Cuddapah","14.47995","78.82346","1","0","0","0","0","0","1","1","0","0","0","1","0","1","0","0","1","1","0","0","0","0","1"
"Cudworth","53.57131","-1.41595","0","0","0","0","1","0","1","0","0","1","0","1","0","0","1","0","1","0","1","0","0","0","1"
"Cuenca","-2.90055","-79.00453","1","0","0","0","0","0","1","0","0","0","0","0","0","1","0","0","1","0","0","1","0","0","1"
"Cuenca","-12.43333","-75.03333","1","0","0","0","0","0","1","0","0","0","0","0","0","1","0","0","1","0","0","1","0","0","1"
"Cuenca","40.06667","-2.13333","1","0","0","0","0","0","1","0","0","0","0","0","0","1","0","0","1","0","0","1","0","0","1"
"Cuenca","13.902","121.0521","1","0","0","0","0","0","1","0","0","0","0","0","0","1","0","0","1","0","0","1","0","0","1"
"Cugir","45.83651","23.36998","1","0","0","0","0","0","1","1","0","0","0","1","0","1","0","0","1","0","0","1","0","0","1"
"Cuilapa","14.27639","-90.29889","1","0","0","0","0","0","1","1","0","0","0","1","1","0","0","0","1","0","0","1","0","0","1"
"Cullompton","50.8553","-3.39268","5","0","0","0","0","0","5","0","3","1","0","4","0","0","4","1","5","1","0","4","0","0","5"
"Culpeper","38.47318","-77.99666","1","0","0","0","0","0","1","0","0","0","0","0","1","0","0","0","1","1","0","0","0","0","1"
"Cumbernauld","55.94685","-3.99051","6","0","0","0","0","0","6","1","1","3","0","5","1","2","3","0","6","2","0","4","0","0","6"
"Cumming","34.20732","-84.14019","1","0","0","0","0","0","1","0","0","0","0","0","0","0","1","0","1","0","0","1","0","0","1"
"Cumnock","55.45445","-4.26644","2","0","0","0","0","0","2","0","2","0","0","2","0","1","1","0","2","2","0","0","0","0","2"
"Cupar","56.31876","-3.01204","5","0","0","2","0","0","9","4","3","2","0","9","1","1","7","0","9","2","0","6","0","0","8"
"Curepipe","-20.31628","57.52594","2","0","0","0","0","0","2","0","1","1","0","2","0","1","1","0","2","0","0","2","0","0","2"
"Curitiba","-25.42778","-49.27306","1","0","0","0","0","0","1","0","0","0","0","0","0","0","1","0","1","0","1","0","0","0","1"
"Curridabat","9.91179","-84.03407","3","0","0","0","0","0","3","0","2","0","0","2","1","1","1","0","3","2","0","1","0","0","3"
"Currie","55.8964","-3.30845","1","0","0","0","0","0","1","0","0","1","0","1","0","0","1","0","1","0","0","1","0","0","1"
"Currie","-39.92976","143.85385","1","0","0","0","0","0","1","0","0","1","0","1","0","0","1","0","1","0","0","1","0","0","1"
"Curtea de Argeş","45.13422","24.67409","1","0","0","0","0","0","1","1","0","0","0","1","0","0","1","0","1","0","0","1","0","0","1"
"Cuttack","20.46497","85.87927","1","0","0","0","0","0","1","1","0","0","0","1","1","0","0","0","1","0","0","1","0","0","1"
"Cwmbran","51.65446","-3.02281","9","0","0","0","0","0","9","2","2","4","0","8","2","3","4","0","9","2","4","3","0","0","9"
"Dabwāli","29.94906","74.73832","1","0","0","0","0","0","1","0","1","0","0","1","1","0","0","0","1","1","0","0","0","0","1"
"Dadu","26.73033","67.7769","2","0","0","0","0","0","2","1","0","1","0","2","1","0","1","0","2","0","0","2","0","0","2"
"Daga","27.07529","89.87688","0","0","0","0","0","0","1","0","0","0","0","0","0","1","0","0","1","1","0","0","0","0","1"
"Dagenham","51.55","0.16667","4","0","0","1","0","0","5","1","2","0","0","3","2","0","3","0","5","1","2","2","0","0","5"
"Dagupan","16.04313","120.33325","3","0","0","0","0","0","3","3","0","0","0","3","0","3","0","0","3","0","3","0","0","0","3"
"Dagupan","17.70039","121.50448","3","0","0","0","0","0","3","3","0","0","0","3","0","3","0","0","3","0","3","0","0","0","3"
"Daifam","26.9","92.1","2","0","0","0","0","0","2","1","1","0","0","2","1","1","0","0","2","0","0","1","0","1","2"
"Dailekh","28.84434","81.71011","2","0","0","0","0","0","2","0","0","0","2","2","0","1","1","0","2","0","0","1","0","1","2"
"Dajt","41.39361","19.91583","0","0","0","0","0","0","0","1","0","0","0","1","0","0","1","0","1","0","0","1","0","0","1"
"Dakar","14.6937","-17.44406","7","0","0","0","1","0","8","0","3","4","0","7","4","3","1","0","8","1","2","2","3","0","8"
"Dalgety Bay","56.03496","-3.35049","2","0","0","0","0","0","2","0","1","1","0","2","1","0","1","0","2","0","1","1","0","0","2"
"Dalheim","49.54083","6.25972","1","0","0","0","0","0","1","0","1","0","0","1","0","1","0","0","1","1","0","0","0","0","1"
"Dalheim","49.82667","8.29528","1","0","0","0","0","0","1","0","1","0","0","1","0","1","0","0","1","1","0","0","0","0","1"
"Dalkeith","55.89317","-3.06806","5","0","0","0","0","0","5","0","1","4","0","5","2","2","1","0","5","1","1","3","0","0","5"
"Dalkeith","-31.99517","115.7998","5","0","0","0","0","0","5","0","1","4","0","5","2","2","1","0","5","1","1","3","0","0","5"
"Dallas","44.91928","-123.31705","2","0","0","0","0","0","3","0","2","0","0","2","1","1","1","0","3","1","0","2","0","0","3"
"Dallas","32.78306","-96.80667","2","0","0","0","0","0","3","0","2","0","0","2","1","1","1","0","3","1","0","2","0","0","3"
"Dallas","33.92371","-84.84077","2","0","0","0","0","0","3","0","2","0","0","2","1","1","1","0","3","1","0","2","0","0","3"
"Dallas","35.31653","-81.17619","2","0","0","0","0","0","3","0","2","0","0","2","1","1","1","0","3","1","0","2","0","0","3"
"Dallas","41.33619","-75.96325","2","0","0","0","0","0","3","0","2","0","0","2","1","1","1","0","3","1","0","2","0","0","3"
"Dallas","-37.67083","144.93542","2","0","0","0","0","0","3","0","2","0","0","2","1","1","1","0","3","1","0","2","0","0","3"
"Dalry","55.70956","-4.72167","1","0","0","0","0","0","1","0","0","0","0","0","0","0","1","0","1","0","1","0","0","0","1"
"Daly City","37.70577","-122.46192","1","0","0","0","0","0","1","1","0","0","0","1","1","0","0","0","1","0","0","1","0","0","1"
"Damanhūr","31.03408","30.46823","3","0","0","0","0","0","4","0","2","0","2","4","2","0","0","2","4","1","0","2","1","0","4"
"Damascus","45.41762","-122.45898","2","0","0","0","0","0","2","0","2","0","0","2","1","1","0","0","2","1","0","1","0","0","2"
"Damascus","36.63373","-81.78373","2","0","0","0","0","0","2","0","2","0","0","2","1","1","0","0","2","1","0","1","0","0","2"
"Damascus","39.28844","-77.20387","2","0","0","0","0","0","2","0","2","0","0","2","1","1","0","0","2","1","0","1","0","0","2"
"Damascus","33.5102","36.29128","2","0","0","0","0","0","2","0","2","0","0","2","1","1","0","0","2","1","0","1","0","0","2"
"Damaturu","11.74697","11.96083","2","0","0","0","0","0","2","0","2","0","0","2","1","1","0","0","2","1","0","1","0","0","2"
"Damietta","31.41648","31.81332","6","0","0","0","0","0","8","1","3","0","0","4","4","1","3","0","8","0","2","1","4","1","8"
"Dammam","26.43442","50.10326","17","0","0","0","1","0","18","7","6","0","1","14","10","7","1","0","18","7","0","10","0","1","18"
"Damoh","23.83312","79.4419","1","0","0","0","0","0","1","1","0","0","0","1","0","0","1","0","1","0","0","1","0","0","1"
"Dankunku","13.56667","-15.31667","1","0","0","0","0","0","1","0","0","0","1","1","1","0","0","0","1","0","0","0","0","1","1"
"Dar Chioukh","34.89638","3.48543","1","0","0","0","0","0","1","0","1","0","0","1","0","1","0","0","1","1","0","0","0","0","1"
"Dar es Salaam","-6.82349","39.26951","35","1","0","2","1","0","39","4","19","2","7","32","24","11","4","1","40","8","2","13","12","6","41"
"Darley","54.03333","-1.7","1","0","0","0","0","0","1","0","0","0","0","0","0","1","0","0","1","0","1","0","0","0","1"
"Darley","-37.65807","144.44344","1","0","0","0","0","0","1","0","0","0","0","0","0","1","0","0","1","0","1","0","0","0","1"
"Darlington","42.68306","-90.11763","12","0","0","0","4","0","16","5","3","4","0","12","4","3","9","0","16","1","3","12","0","0","16"
"Darlington","40.11004","-86.77195","12","0","0","0","4","0","16","5","3","4","0","12","4","3","9","0","16","1","3","12","0","0","16"
"Darlington","34.29988","-79.87617","12","0","0","0","4","0","16","5","3","4","0","12","4","3","9","0","16","1","3","12","0","0","16"
"Darlington","54.52429","-1.55039","12","0","0","0","4","0","16","5","3","4","0","12","4","3","9","0","16","1","3","12","0","0","16"
"Darlington","-31.91906","116.0812","12","0","0","0","4","0","16","5","3","4","0","12","4","3","9","0","16","1","3","12","0","0","16"
"Darlington","-35.03151","138.55527","12","0","0","0","4","0","16","5","3","4","0","12","4","3","9","0","16","1","3","12","0","0","16"
"Darlington","-33.89103","151.19548","12","0","0","0","4","0","16","5","3","4","0","12","4","3","9","0","16","1","3","12","0","0","16"
"Darnah","32.76704","22.63669","2","0","0","0","0","0","2","0","0","2","0","2","0","2","0","0","2","2","0","0","0","0","2"
"Dartford","51.44657","0.21423","13","0","0","0","0","0","13","1","4","5","0","10","4","0","9","0","13","4","2","6","0","1","13"
"Dartington","50.44409","-3.70958","1","0","0","0","0","0","1","0","0","1","0","1","1","0","0","0","1","0","1","0","0","0","1"
"Dartmouth","44.67134","-63.57719","2","0","0","0","0","0","2","1","0","1","0","2","1","0","1","0","2","0","2","0","0","0","2"
"Dartmouth","50.3522","-3.5794","2","0","0","0","0","0","2","1","0","1","0","2","1","0","1","0","2","0","2","0","0","0","2"
"Darwen","53.69803","-2.46494","4","0","0","0","0","0","4","1","2","1","0","4","2","1","1","0","4","2","0","2","0","0","4"
"Dashtavan","40.1001","44.39172","1","0","0","0","0","0","1","0","1","0","0","1","1","0","0","0","1","1","0","0","0","0","1"
"Daska Kalan","32.32422","74.35039","1","1","0","0","0","0","2","1","0","0","0","1","0","1","1","0","2","0","0","2","0","0","2"
"Dasmariñas","14.32944","120.93667","1","0","0","0","0","0","1","0","0","1","0","1","0","1","0","0","1","0","0","1","0","0","1"
"Datu Paglas","6.76667","124.85","1","0","0","0","0","0","1","0","1","0","0","1","0","0","1","0","1","0","0","0","0","1","1"
"Davangere","14.46693","75.92694","2","0","0","0","0","0","2","1","1","0","0","2","0","2","0","0","2","0","0","2","0","0","2"
"Davao","7.07306","125.61278","3","1","0","0","0","0","4","2","1","0","0","3","1","1","2","0","4","1","0","3","0","0","4"
"Daventry","52.25688","-1.16066","11","0","0","0","3","0","15","3","4","7","0","14","2","4","9","0","15","1","6","7","0","1","15"
"David","8.42729","-82.43085","2","0","0","0","0","0","2","1","0","0","0","1","0","2","0","0","2","1","0","1","0","0","2"
"Dayr Abū Sa‘īd","32.49816","35.68671","0","1","0","0","0","0","1","0","0","1","0","1","0","1","0","0","1","1","0","0","0","0","1"
"Dayr Mawās","27.64148","30.85012","2","0","0","0","0","0","2","0","0","1","1","2","0","0","2","0","2","1","0","1","0","0","2"
"Dayrūţ","27.55642","30.81057","2","0","0","0","0","0","2","1","0","0","0","1","1","0","1","0","2","0","1","1","0","0","2"
"Deal","40.24317","-74.00069","7","0","0","0","1","0","8","1","1","3","0","5","2","0","6","0","8","1","1","6","0","0","8"
"Deal","51.22322","1.40432","7","0","0","0","1","0","8","1","1","3","0","5","2","0","6","0","8","1","1","6","0","0","8"
"Deal","45.8591","23.62747","7","0","0","0","1","0","8","1","1","3","0","5","2","0","6","0","8","1","1","6","0","0","8"
"Deanshanger","52.04996","-0.88663","1","0","0","0","0","0","1","0","0","1","0","1","1","0","0","0","1","0","0","1","0","0","1"
"Dearham","54.71175","-3.44364","1","0","0","0","0","0","1","1","0","0","0","1","0","0","1","0","1","1","0","0","0","0","1"
"Debar","41.52444","20.52421","0","1","0","0","0","0","2","1","0","0","0","1","2","0","0","0","2","0","0","2","0","0","2"
"Debre Birhan","9.67954","39.53262","1","0","0","0","0","0","1","0","0","0","0","0","1","0","0","0","1","1","0","0","0","0","1"
"Debrecen","47.53167","21.62444","6","0","0","0","0","0","7","0","2","1","0","3","2","3","2","0","7","2","0","5","0","0","7"
"Debre Mark’os","10.35","37.73333","1","0","0","0","0","0","1","0","1","0","0","1","0","1","0","0","1","0","0","1","0","0","1"
"Deerfield","37.97974","-101.13322","1","0","0","0","0","0","1","0","0","0","0","0","1","0","0","0","1","1","0","0","0","0","1"
"Deerfield","43.05194","-89.07567","1","0","0","0","0","0","1","0","0","0","0","0","1","0","0","0","1","1","0","0","0","0","1"
"Deerfield","42.17114","-87.84451","1","0","0","0","0","0","1","0","0","0","0","0","1","0","0","0","1","1","0","0","0","0","1"
"Deerfield","41.88894","-83.77883","1","0","0","0","0","0","1","0","0","0","0","0","1","0","0","0","1","1","0","0","0","0","1"
"Deerfield","42.54453","-72.60564","1","0","0","0","0","0","1","0","0","0","0","0","1","0","0","0","1","1","0","0","0","0","1"
"Deerfield","44.23062","-71.61703","1","0","0","0","0","0","1","0","0","0","0","0","1","0","0","0","1","1","0","0","0","0","1"
"Deeside","53.20053","-3.03841","2","0","0","0","0","0","2","0","0","1","0","1","1","0","1","0","2","0","0","2","0","0","2"
"Deganwy","53.30446","-3.82735","1","0","0","0","0","0","1","0","1","0","0","1","0","0","1","0","1","0","0","1","0","0","1"
"Dehra Dūn","30.32443","78.03392","3","0","0","0","0","0","3","3","0","0","0","3","0","2","1","0","3","0","0","3","0","0","3"
"Dej","47.15","23.86667","1","0","0","0","0","0","1","0","0","0","0","0","0","1","0","0","1","1","0","0","0","0","1"
"Delabole","50.62347","-4.7319","1","0","0","0","0","0","1","0","1","0","0","1","1","0","0","0","1","0","0","1","0","0","1"
"Delft","52.00667","4.35556","1","0","0","0","0","0","1","0","0","0","0","0","0","0","1","0","1","0","0","1","0","0","1"
"Delhi","37.43216","-120.77854","25","0","0","1","2","0","28","14","4","3","0","21","9","5","13","0","27","2","0","22","1","2","27"
"Delhi","32.45764","-91.49317","25","0","0","1","2","0","28","14","4","3","0","21","9","5","13","0","27","2","0","22","1","2","27"
"Delhi","42.27814","-74.91599","25","0","0","1","2","0","28","14","4","3","0","21","9","5","13","0","27","2","0","22","1","2","27"
"Delhi","28.65195","77.23149","25","0","0","1","2","0","28","14","4","3","0","21","9","5","13","0","27","2","0","22","1","2","27"
"Del Mar","32.95949","-117.26531","1","0","0","0","0","0","1","0","0","0","0","0","0","0","1","0","1","0","0","1","0","0","1"
"Delray Beach","26.46146","-80.07282","1","0","0","0","0","0","1","0","0","0","0","0","0","0","1","0","1","0","0","1","0","0","1"
"Denbigh","53.18333","-3.41667","5","0","0","0","0","0","5","0","3","1","0","4","0","3","2","0","5","3","1","1","0","0","5"
"Denham","51.56667","-0.5","2","0","0","0","0","0","2","1","1","0","0","2","0","1","1","0","2","0","0","2","0","0","2"
"Denham","-25.92679","113.53327","2","0","0","0","0","0","2","1","1","0","0","2","0","1","1","0","2","0","0","2","0","0","2"
"Denistone","-33.79835","151.09051","1","0","0","0","0","0","1","0","0","0","0","0","0","1","0","0","1","1","0","0","0","0","1"
"Denizli","37.77417","29.0875","4","0","0","0","1","0","5","0","3","1","0","4","2","3","0","0","5","3","1","1","0","0","5"
"Denmead","50.90395","-1.06744","3","0","0","0","0","0","3","1","1","1","0","3","2","1","0","0","3","0","0","3","0","0","3"
"Denny","56.0235","-3.90812","2","0","0","0","0","0","2","0","0","2","0","2","0","0","2","0","2","0","1","1","0","0","2"
"Denton","33.21484","-97.13307","1","1","0","0","0","0","2","0","2","0","0","2","0","1","1","0","2","0","0","2","0","0","2"
"Denton","35.63347","-80.11588","1","1","0","0","0","0","2","0","2","0","0","2","0","1","1","0","2","0","0","2","0","0","2"
"Denton","38.88456","-75.82716","1","1","0","0","0","0","2","0","2","0","0","2","0","1","1","0","2","0","0","2","0","0","2"
"Denton","13.5","-14.93333","1","1","0","0","0","0","2","0","2","0","0","2","0","1","1","0","2","0","0","2","0","0","2"
"Denton","53.45678","-2.11822","1","1","0","0","0","0","2","0","2","0","0","2","0","1","1","0","2","0","0","2","0","0","2"
"Denton","54.56667","-1.66667","1","1","0","0","0","0","2","0","2","0","0","2","0","1","1","0","2","0","0","2","0","0","2"
"Denver","39.73915","-104.9847","15","0","0","1","0","0","16","2","2","4","1","9","8","2","6","0","16","2","3","11","0","0","16"
"Denver","42.67137","-92.3374","15","0","0","1","0","0","16","2","2","4","1","9","8","2","6","0","16","2","3","11","0","0","16"
"Denver","35.53125","-81.0298","15","0","0","1","0","0","16","2","2","4","1","9","8","2","6","0","16","2","3","11","0","0","16"
"Denver","40.23315","-76.13717","15","0","0","1","0","0","16","2","2","4","1","9","8","2","6","0","16","2","3","11","0","0","16"
"Deogarh","21.53827","84.73337","1","0","0","0","0","0","1","1","0","0","0","1","0","0","1","0","1","0","1","0","0","0","1"
"Deoria","26.50167","83.77936","1","0","0","0","1","0","2","2","0","0","0","2","1","0","1","0","2","0","0","2","0","0","2"
"Dera Allahyar","28.37353","68.35078","2","0","0","0","0","0","2","1","1","0","0","2","0","0","1","1","2","0","0","1","0","1","2"
"Dera Ghazi Khan","30.04587","70.64029","6","0","0","0","0","0","6","3","2","1","0","6","4","0","2","0","6","1","2","2","0","1","6"
"Dera Ismail Khan","31.83129","70.9017","1","2","0","0","0","0","3","1","0","1","0","2","1","0","1","1","3","1","1","1","0","0","3"
"Dera Murad Jamali","28.54657","68.22308","1","0","0","0","0","0","1","0","0","0","0","0","0","0","1","0","1","0","0","1","0","0","1"
"Derbendîxan","35.11207","45.68663","1","0","0","0","0","0","1","1","0","0","0","1","1","0","0","0","1","0","1","0","0","0","1"
"Derby","39.83943","-104.91859","80","2","0","3","7","0","93","16","24","19","0","59","34","14","45","0","93","23","22","47","0","1","93"
"Derby","37.54557","-97.26893","80","2","0","3","7","0","93","16","24","19","0","59","34","14","45","0","93","23","22","47","0","1","93"
"Derby","41.32065","-73.089","80","2","0","3","7","0","93","16","24","19","0","59","34","14","45","0","93","23","22","47","0","1","93"
"Derby","52.92277","-1.47663","80","2","0","3","7","0","93","16","24","19","0","59","34","14","45","0","93","23","22","47","0","1","93"
"Derby","-17.30295","123.62864","80","2","0","3","7","0","93","16","24","19","0","59","34","14","45","0","93","23","22","47","0","1","93"
"Deri","51.70812","-3.26312","1","0","0","0","0","0","1","0","1","0","0","1","1","0","0","0","1","1","0","0","0","0","1"
"Derry","40.33396","-79.29976","9","3","1","0","0","0","13","5","7","1","0","13","4","1","6","2","13","5","2","6","0","0","13"
"Derry","42.88064","-71.32729","9","3","1","0","0","0","13","5","7","1","0","13","4","1","6","2","13","5","2","6","0","0","13"
"Derry","51.58666","-9.05026","9","3","1","0","0","0","13","5","7","1","0","13","4","1","6","2","13","5","2","6","0","0","13"
"Derry","54.9981","-7.30934","9","3","1","0","0","0","13","5","7","1","0","13","4","1","6","2","13","5","2","6","0","0","13"
"De Rust","-33.49035","22.53523","1","0","0","0","0","0","1","1","0","0","0","1","1","0","0","0","1","0","0","1","0","0","1"
"Desborough","52.44183","-0.82126","3","0","0","0","0","0","4","0","3","1","0","4","1","1","1","0","3","1","1","1","0","0","3"
"Desē","11.13333","39.63333","1","0","0","0","0","0","1","0","1","0","0","1","0","1","0","0","1","0","0","0","0","0","0"
"Des Moines","47.40177","-122.32429","2","0","0","0","0","0","2","0","0","0","0","0","1","0","1","0","2","1","0","1","0","0","2"
"Des Moines","41.60054","-93.60911","2","0","0","0","0","0","2","0","0","0","0","0","1","0","1","0","2","1","0","1","0","0","2"
"Detroit","33.6615","-95.26662","2","0","0","0","0","0","2","0","0","1","1","2","2","0","0","0","2","1","0","1","0","0","2"
"Detroit","42.33143","-83.04575","2","0","0","0","0","0","2","0","0","1","1","2","2","0","0","0","2","1","0","1","0","0","2"
"Detroit","44.79257","-69.29671","2","0","0","0","0","0","2","0","0","1","1","2","2","0","0","0","2","1","0","1","0","0","2"
"Devizes","51.35084","-1.99421","3","0","0","0","0","0","3","1","2","0","0","3","2","0","1","0","3","0","1","2","0","0","3"
"Dewsbury","53.69076","-1.62907","13","0","0","1","2","0","17","6","1","4","0","11","7","1","9","0","17","2","6","8","0","1","17"
"Dhahran","26.28864","50.11396","1","0","0","0","0","0","1","1","0","0","0","1","1","0","0","0","1","0","0","1","0","0","1"
"Dhaka","23.7104","90.40744","205","12","0","1","12","0","231","106","42","25","11","184","96","47","84","5","232","33","27","125","15","31","231"
"Dhangaḍhi̇̄","28.70137","80.58975","4","0","0","0","0","0","4","2","0","0","1","3","2","0","2","0","4","0","1","3","0","0","4"
"Dharamsala","32.22006","76.32013","1","0","0","0","0","0","1","0","0","0","0","0","1","0","0","0","1","1","0","0","0","0","1"
"Dharān","26.81436","87.27972","4","0","0","0","0","0","4","4","0","0","0","4","2","0","2","0","4","0","0","4","0","0","4"
"Dharapuram","10.73828","77.53223","1","0","0","0","0","0","1","0","0","0","1","1","0","0","1","0","1","0","0","1","0","0","1"
"Dharmapuri","12.1277","78.15794","1","0","0","0","0","0","1","1","0","0","0","1","1","0","0","0","1","0","0","1","0","0","1"
"Dharmavaram","14.41435","77.72035","1","0","0","0","0","0","1","1","0","0","0","1","1","0","0","0","1","0","0","1","0","0","1"
"Dhulikhel","27.6221","85.54281","4","0","0","0","0","0","4","3","0","0","1","4","2","1","1","0","4","0","2","2","0","0","4"
"Dibrugarh","27.47989","94.90837","0","0","0","0","1","0","1","0","0","0","1","1","0","1","0","0","1","0","0","1","0","0","1"
"Didcot","51.60928","-1.24214","7","1","0","0","1","0","9","3","4","1","0","8","5","1","3","0","9","3","0","5","0","1","9"
"Diego Martin","10.72081","-61.56616","2","0","0","0","0","0","2","0","2","0","0","2","1","0","1","0","2","2","0","0","0","0","2"
"Dihok","36.86709","42.98845","9","0","0","0","0","0","9","5","2","0","1","8","0","5","3","1","9","3","0","6","0","0","9"
"Dikirnis","31.08898","31.59478","3","0","0","0","0","0","4","2","1","0","0","3","1","2","0","0","3","1","1","2","0","0","4"
"Dili","-8.55861","125.57361","3","0","0","0","0","0","3","2","1","0","0","3","0","0","3","0","3","0","0","2","0","0","2"
"Dimāpur","25.91174","93.7217","0","0","0","0","0","0","0","0","0","0","0","0","0","0","0","0","0","0","0","0","0","0","0"
"Dinājpur","25.62745","88.63779","7","0","0","0","0","0","7","3","1","2","0","6","2","2","1","2","7","0","0","5","1","1","7"
"Dinas Powys","51.43486","-3.21398","4","0","0","0","0","0","5","2","1","2","0","5","3","0","2","0","5","0","1","4","0","0","5"
"Din Daeng","13.76994","100.55299","1","0","0","0","0","0","1","1","0","0","0","1","0","0","1","0","1","0","0","1","0","0","1"
"Dinnington","55.05428","-1.67542","1","0","0","0","0","0","1","1","0","0","0","1","0","0","1","0","1","0","1","0","0","0","1"
"Dinnington","53.36667","-1.2","1","0","0","0","0","0","1","1","0","0","0","1","0","0","1","0","1","0","1","0","0","0","1"
"Diofior","14.18333","-16.66667","1","0","0","0","0","0","1","1","0","0","0","1","1","0","0","0","1","0","0","1","0","0","1"
"Dipayal","29.26083","80.94","1","0","0","0","0","0","1","0","0","1","0","1","0","0","1","0","1","0","0","1","0","0","1"
"Dire Dawa","9.59306","41.86611","1","0","0","0","0","0","1","0","1","0","1","2","1","1","0","0","2","2","0","0","0","0","2"
"Dishnā","26.12467","32.47598","0","1","0","0","0","0","1","0","0","1","0","1","0","0","1","0","1","0","1","0","0","0","1"
"Dispur","26.13564","91.80069","0","1","0","0","0","0","1","1","0","0","0","1","0","0","1","0","1","0","1","0","0","0","1"
"Diss","52.37675","1.1091","2","0","0","0","2","0","4","1","1","2","0","4","1","0","3","0","4","1","1","2","0","0","4"
"Disūq","31.13259","30.64784","1","1","0","0","0","0","2","0","1","1","0","2","0","1","1","0","2","0","1","0","0","1","2"
"Diyarbakır","37.91363","40.21721","3","0","0","0","0","0","3","0","1","0","2","3","2","0","0","1","3","2","0","0","1","0","3"
"Diyarb Najm","30.75438","31.44016","1","0","0","0","0","0","1","0","0","1","0","1","0","1","0","0","1","0","0","1","0","0","1"
"Djelfa","34.67279","3.263","1","0","0","0","0","0","1","0","1","0","0","1","1","0","0","0","1","1","0","0","0","0","1"
"Djibouti","11.58901","43.14503","1","0","0","0","0","0","1","1","0","0","0","1","1","0","0","0","1","0","0","0","1","0","1"
"Dnipro","48.4593","35.03865","4","0","0","0","1","0","5","1","0","2","0","3","2","2","1","0","5","1","0","3","0","1","5"
"Doba","8.65","16.85","0","1","0","0","0","0","1","0","1","0","0","1","0","0","1","0","1","1","0","0","0","0","1"
"Doba","47.73333","22.71667","0","1","0","0","0","0","1","0","1","0","0","1","0","0","1","0","1","1","0","0","0","0","1"
"Doba","47.29087","23.0961","0","1","0","0","0","0","1","0","1","0","0","1","0","0","1","0","1","1","0","0","0","0","1"
"Doba","44.48679","24.24397","0","1","0","0","0","0","1","0","1","0","0","1","0","0","1","0","1","1","0","0","0","0","1"
"Dobrich","43.56667","27.83333","1","0","0","0","0","0","1","0","0","0","0","0","0","1","0","0","1","0","1","0","0","0","1"
"Dodola","6.98333","39.18333","1","0","0","0","0","0","1","0","1","0","0","1","0","1","0","0","1","0","0","0","0","1","1"
"Dodoma","-6.17221","35.73947","8","0","0","0","1","0","9","0","2","2","1","5","5","4","2","0","11","1","0","2","3","5","11"
"Doha","25.28545","51.53096","28","2","0","0","1","0","31","7","13","5","0","25","14","8","9","0","31","15","5","11","0","0","31"
"Dolgellau","52.74222","-3.88611","1","0","0","0","0","0","1","0","1","0","0","1","0","0","1","0","1","0","0","1","0","0","1"
"Dollar","56.16245","-3.67135","0","0","0","1","1","0","2","1","1","0","0","2","1","0","1","0","2","1","0","1","0","0","2"
"Donabate","53.48722","-6.15194","1","0","0","0","0","0","1","0","0","1","0","1","0","0","1","0","1","0","0","1","0","0","1"
"Doncaster","53.52285","-1.13116","40","2","0","0","1","0","44","9","14","16","1","40","14","7","23","0","44","10","8","25","0","1","44"
"Doncaster","-37.78828","145.12373","40","2","0","0","1","0","44","9","14","16","1","40","14","7","23","0","44","10","8","25","0","1","44"
"Donetsk","48.023","37.80224","1","0","0","0","0","0","1","0","0","0","1","1","0","1","0","0","1","0","0","1","0","0","1"
"Donetsk","48.33962","39.95948","1","0","0","0","0","0","1","0","0","0","1","1","0","1","0","0","1","0","0","1","0","0","1"
"Donna","26.17035","-98.05195","1","0","0","0","0","0","1","0","0","0","0","0","1","0","0","0","1","0","0","0","0","1","1"
"Doral","25.81954","-80.35533","0","0","0","0","1","0","1","0","1","0","0","1","0","1","0","0","1","1","0","0","0","0","1"
"Dorchester","40.64723","-97.11337","15","1","0","0","2","0","18","1","6","5","0","12","11","0","7","0","18","3","6","8","0","1","18"
"Dorchester","45.00302","-90.33569","15","1","0","0","2","0","18","1","6","5","0","12","11","0","7","0","18","3","6","8","0","1","18"
"Dorchester","42.98339","-81.06643","15","1","0","0","2","0","18","1","6","5","0","12","11","0","7","0","18","3","6","8","0","1","18"
"Dorchester","50.71667","-2.43333","15","1","0","0","2","0","18","1","6","5","0","12","11","0","7","0","18","3","6","8","0","1","18"
"Dorking","51.23228","-0.3338","15","0","0","0","2","0","17","5","1","9","0","15","3","1","13","0","17","1","3","13","0","0","17"
"Dornoch","57.8805","-4.02879","1","0","0","0","0","0","1","0","1","0","0","1","0","0","1","0","1","0","0","1","0","0","1"
"Dortmund","51.51494","7.466","2","0","0","0","0","0","2","0","0","2","0","2","1","0","1","0","2","0","0","2","0","0","2"
"Dorval","45.4473","-73.75335","1","0","0","0","0","0","1","1","0","0","0","1","0","0","1","0","1","0","1","0","0","0","1"
"Douala","4.04827","9.70428","8","0","0","0","1","0","10","2","4","1","2","9","4","3","4","0","11","4","1","3","0","3","11"
"Douglas","31.34455","-109.54534","3","0","0","0","0","0","3","0","2","1","0","3","0","1","2","0","3","0","1","2","0","0","3"
"Douglas","42.75969","-105.38221","3","0","0","0","0","0","3","0","2","1","0","3","0","1","2","0","3","0","1","2","0","0","3"
"Douglas","41.83476","-87.61811","3","0","0","0","0","0","3","0","2","1","0","3","0","1","2","0","3","0","1","2","0","0","3"
"Douglas","34.17371","-86.32359","3","0","0","0","0","0","3","0","2","1","0","3","0","1","2","0","3","0","1","2","0","0","3"
"Douglas","42.64336","-86.20059","3","0","0","0","0","0","3","0","2","1","0","3","0","1","2","0","3","0","1","2","0","0","3"
"Douglas","31.50881","-82.84987","3","0","0","0","0","0","3","0","2","1","0","3","0","1","2","0","3","0","1","2","0","0","3"
"Douglas","42.05426","-71.73951","3","0","0","0","0","0","3","0","2","1","0","3","0","1","2","0","3","0","1","2","0","0","3"
"Douglas","54.15","-4.48333","3","0","0","0","0","0","3","0","2","1","0","3","0","1","2","0","3","0","1","2","0","0","3"
"Douglas","55.55","-3.85","3","0","0","0","0","0","3","0","2","1","0","3","0","1","2","0","3","0","1","2","0","0","3"
"Douglas","-29.05531","23.7743","3","0","0","0","0","0","3","0","2","1","0","3","0","1","2","0","3","0","1","2","0","0","3"
"Douglas","-19.32394","146.75234","3","0","0","0","0","0","3","0","2","1","0","3","0","1","2","0","3","0","1","2","0","0","3"
"Dover","48.25159","-116.61103","13","0","0","0","3","0","17","3","7","6","1","17","12","2","3","0","17","6","6","5","0","0","17"
"Dover","35.40147","-93.11434","13","0","0","0","3","0","17","3","7","6","1","17","12","2","3","0","17","6","6","5","0","0","17"
"Dover","43.97357","-92.13905","13","0","0","0","3","0","17","3","7","6","1","17","12","2","3","0","17","6","6","5","0","0","17"
"Dover","36.48783","-87.83836","13","0","0","0","3","0","17","3","7","6","1","17","12","2","3","0","17","6","6","5","0","0","17"
"Dover","27.99419","-82.21953","13","0","0","0","3","0","17","3","7","6","1","17","12","2","3","0","17","6","6","5","0","0","17"
"Dover","40.52062","-81.47401","13","0","0","0","3","0","17","3","7","6","1","17","12","2","3","0","17","6","6","5","0","0","17"
"Dover","40.00176","-76.85025","13","0","0","0","3","0","17","3","7","6","1","17","12","2","3","0","17","6","6","5","0","0","17"
"Dover","39.15817","-75.52437","13","0","0","0","3","0","17","3","7","6","1","17","12","2","3","0","17","6","6","5","0","0","17"
"Dover","40.88399","-74.5621","13","0","0","0","3","0","17","3","7","6","1","17","12","2","3","0","17","6","6","5","0","0","17"
"Dover","42.94369","-72.80399","13","0","0","0","3","0","17","3","7","6","1","17","12","2","3","0","17","6","6","5","0","0","17"
"Dover","42.24593","-71.28283","13","0","0","0","3","0","17","3","7","6","1","17","12","2","3","0","17","6","6","5","0","0","17"
"Dover","43.19786","-70.87367","13","0","0","0","3","0","17","3","7","6","1","17","12","2","3","0","17","6","6","5","0","0","17"
"Dover","51.12598","1.31257","13","0","0","0","3","0","17","3","7","6","1","17","12","2","3","0","17","6","6","5","0","0","17"
"Dover","-43.31423","147.01488","13","0","0","0","3","0","17","3","7","6","1","17","12","2","3","0","17","6","6","5","0","0","17"
"Dover Heights","-33.87083","151.27917","1","0","0","0","0","0","1","0","0","1","0","1","0","1","0","0","1","0","1","0","0","0","1"
"Downham Market","52.60714","0.38375","2","0","0","0","0","0","2","1","0","1","0","2","0","0","2","0","2","0","1","1","0","0","2"
"Downingtown","40.0065","-75.70327","2","0","0","0","0","0","2","2","0","0","0","2","0","2","0","0","2","0","0","2","0","0","2"
"Driffield","54.00613","-0.44495","4","0","0","0","0","0","4","0","0","4","0","4","0","0","4","0","4","1","0","3","0","0","4"
"Drogheda","53.71889","-6.34778","1","0","0","0","0","0","1","0","0","0","0","0","0","1","0","0","1","1","0","0","0","0","1"
"Droichead Nua","53.18194","-6.79667","1","0","0","0","0","0","1","0","1","0","0","1","1","0","0","0","1","0","1","0","0","0","1"
"Droitwich","52.26667","-2.15","4","0","0","0","1","0","5","0","2","3","0","5","3","0","2","0","5","1","1","3","0","0","5"
"Dromore","54.51331","-7.45886","1","1","0","0","0","0","2","1","1","0","0","2","0","2","0","0","2","0","0","2","0","0","2"
"Dubai","25.07725","55.30927","38","4","0","0","1","0","43","8","8","6","0","22","20","10","13","0","43","13","7","20","2","1","43"
"Dublin","37.70215","-121.93579","37","1","0","3","1","0","44","9","10","16","0","35","13","6","24","1","44","7","5","27","1","4","44"
"Dublin","32.08514","-98.34199","37","1","0","3","1","0","44","9","10","16","0","35","13","6","24","1","44","7","5","27","1","4","44"
"Dublin","39.81227","-85.20885","37","1","0","3","1","0","44","9","10","16","0","35","13","6","24","1","44","7","5","27","1","4","44"
"Dublin","40.09923","-83.11408","37","1","0","3","1","0","44","9","10","16","0","35","13","6","24","1","44","7","5","27","1","4","44"
"Dublin","32.54044","-82.90375","37","1","0","3","1","0","44","9","10","16","0","35","13","6","24","1","44","7","5","27","1","4","44"
"Dublin","37.10568","-80.68534","37","1","0","3","1","0","44","9","10","16","0","35","13","6","24","1","44","7","5","27","1","4","44"
"Dublin","40.37177","-75.20156","37","1","0","3","1","0","44","9","10","16","0","35","13","6","24","1","44","7","5","27","1","4","44"
"Dublin","42.90758","-72.06258","37","1","0","3","1","0","44","9","10","16","0","35","13","6","24","1","44","7","5","27","1","4","44"
"Dublin","53.33306","-6.24889","37","1","0","3","1","0","44","9","10","16","0","35","13","6","24","1","44","7","5","27","1","4","44"
"Dubti","11.73292","41.082","1","0","0","0","0","0","1","1","0","0","0","1","0","1","0","0","1","0","0","0","1","0","1"
"Dudley","32.54239","-83.07043","29","1","0","3","3","0","39","11","9","2","0","22","17","8","14","0","39","14","7","16","0","2","39"
"Dudley","42.0451","-71.93007","29","1","0","3","3","0","39","11","9","2","0","22","17","8","14","0","39","14","7","16","0","2","39"
"Dudley","52.5","-2.08333","29","1","0","3","3","0","39","11","9","2","0","22","17","8","14","0","39","14","7","16","0","2","39"
"Dudley","-32.99373","151.72197","29","1","0","3","3","0","39","11","9","2","0","22","17","8","14","0","39","14","7","16","0","2","39"
"Dufftown","57.44571","-3.12708","1","0","0","0","0","0","1","1","0","0","0","1","0","0","1","0","1","0","1","0","0","0","1"
"Dugopolje","43.58056","16.60278","1","0","0","0","0","0","1","1","0","0","0","1","0","0","1","0","1","0","0","1","0","0","1"
"Dukinfield","53.47497","-2.08809","2","0","0","0","0","0","2","0","1","1","0","2","0","1","1","0","2","2","0","0","0","0","2"
"Duleek","53.65667","-6.41917","1","0","0","0","0","0","1","0","0","1","0","1","0","0","1","0","1","0","1","0","0","0","1"
"Duluth","46.78327","-92.10658","3","0","0","0","0","0","3","0","2","0","0","2","1","1","1","0","3","1","1","1","0","0","3"
"Duluth","34.00288","-84.14464","3","0","0","0","0","0","3","0","2","0","0","2","1","1","1","0","3","1","1","1","0","0","3"
"Dumaguete","9.30722","123.30261","1","0","0","0","0","0","1","0","0","0","0","0","0","1","0","0","1","1","0","0","0","0","1"
"Dumbarton","37.60376","-77.49137","2","2","0","0","0","0","4","0","2","2","0","4","2","1","1","0","4","3","1","0","0","0","4"
"Dumbarton","55.94433","-4.57061","2","2","0","0","0","0","4","0","2","2","0","4","2","1","1","0","4","3","1","0","0","0","4"
"Dumfries","38.56762","-77.32804","7","0","0","0","0","0","9","2","6","1","0","9","2","4","3","0","9","3","3","3","0","0","9"
"Dumfries","55.06959","-3.61139","7","0","0","0","0","0","9","2","6","1","0","9","2","4","3","0","9","3","3","3","0","0","9"
"Dunblane","56.18843","-3.96417","1","0","0","0","0","0","1","0","0","1","0","1","1","0","0","0","1","0","1","0","0","0","1"
"Duncanville","32.6518","-96.90834","1","0","0","1","0","0","2","1","0","1","0","2","1","0","1","0","2","0","1","1","0","0","2"
"Dundaga","57.50498","22.35041","1","0","0","0","0","0","1","0","1","0","0","1","1","0","0","0","1","0","0","0","1","0","1"
"Dundalk","39.25066","-76.52052","2","0","0","0","0","0","2","0","0","2","0","2","0","0","2","0","2","0","1","1","0","0","2"
"Dundalk","54","-6.41667","2","0","0","0","0","0","2","0","0","2","0","2","0","0","2","0","2","0","1","1","0","0","2"
"Dundee","45.27817","-123.01094","24","0","0","0","5","0","30","7","14","3","2","26","6","5","17","2","30","13","5","10","0","2","30"
"Dundee","41.95727","-83.65966","24","0","0","0","5","0","30","7","14","3","2","26","6","5","17","2","30","13","5","10","0","2","30"
"Dundee","28.02252","-81.61924","24","0","0","0","5","0","30","7","14","3","2","26","6","5","17","2","30","13","5","10","0","2","30"
"Dundee","42.5234","-76.97663","24","0","0","0","5","0","30","7","14","3","2","26","6","5","17","2","30","13","5","10","0","2","30"
"Dundee","56.46913","-2.97489","24","0","0","0","5","0","30","7","14","3","2","26","6","5","17","2","30","13","5","10","0","2","30"
"Dundee","-28.16678","30.23371","24","0","0","0","5","0","30","7","14","3","2","26","6","5","17","2","30","13","5","10","0","2","30"
"Dundrum","53.29067","-6.25714","1","0","0","0","0","0","1","0","1","0","0","1","0","0","1","0","1","1","0","0","0","0","1"
"Dundrum","54.2575","-5.84455","1","0","0","0","0","0","1","0","1","0","0","1","0","0","1","0","1","1","0","0","0","0","1"
"Dunfermline","56.07156","-3.45887","9","0","0","0","3","0","14","1","5","5","0","11","7","1","6","0","14","2","0","9","1","2","14"
"Dungannon","54.50344","-6.76723","2","0","0","0","0","0","2","0","0","1","0","1","0","1","1","0","2","0","1","1","0","0","2"
"Dungarvan","52.08806","-7.62528","0","0","0","0","1","0","1","0","1","0","0","1","1","0","0","0","1","1","0","0","0","0","1"
"Dunoon","55.95031","-4.92734","1","0","0","0","0","0","1","0","0","1","0","1","1","0","0","0","1","0","1","0","0","0","1"
"Dunoon","-28.6846","153.31766","1","0","0","0","0","0","1","0","0","1","0","1","1","0","0","0","1","0","1","0","0","0","1"
"Duns","55.77704","-2.34575","1","0","0","0","1","0","2","1","3","0","0","4","4","0","1","0","5","0","0","2","0","3","5"
"Dunstable","42.67509","-71.48284","13","0","0","0","3","0","16","3","4","6","1","14","5","4","7","0","16","2","3","10","0","1","16"
"Dunstable","51.88571","-0.52288","13","0","0","0","3","0","16","3","4","6","1","14","5","4","7","0","16","2","3","10","0","1","16"
"Durban","-29.8579","31.0292","6","0","0","0","1","0","7","2","4","1","0","7","6","1","0","0","7","2","3","2","0","0","7"
"Durg","21.19147","81.27619","2","0","0","0","0","0","2","2","0","0","0","2","1","0","1","0","2","0","0","2","0","0","2"
"Durgapur","23.51583","87.30801","1","0","0","0","0","0","1","0","0","0","1","1","0","0","1","0","1","0","0","0","0","1","1"
"Durham","45.40206","-122.75287","87","6","0","3","7","0","109","26","29","40","1","96","36","10","61","2","109","26","28","53","0","2","109"
"Durham","39.64627","-121.79998","87","6","0","3","7","0","109","26","29","40","1","96","36","10","61","2","109","26","28","53","0","2","109"
"Durham","35.99403","-78.89862","87","6","0","3","7","0","109","26","29","40","1","96","36","10","61","2","109","26","28","53","0","2","109"
"Durham","42.39953","-74.17236","87","6","0","3","7","0","109","26","29","40","1","96","36","10","61","2","109","26","28","53","0","2","109"
"Durham","41.48176","-72.68121","87","6","0","3","7","0","109","26","29","40","1","96","36","10","61","2","109","26","28","53","0","2","109"
"Durham","43.13397","-70.92645","87","6","0","3","7","0","109","26","29","40","1","96","36","10","61","2","109","26","28","53","0","2","109"
"Durham","54.77676","-1.57566","87","6","0","3","7","0","109","26","29","40","1","96","36","10","61","2","109","26","28","53","0","2","109"
"Durrës","41.32355","19.45469","3","1","0","0","0","0","4","2","1","0","0","3","0","2","2","0","4","1","0","3","0","0","4"
"Dursley","51.68139","-2.35333","1","0","0","0","0","0","1","0","0","0","0","0","0","0","1","0","1","0","0","1","0","0","1"
"Düsseldorf","51.22172","6.77616","5","0","0","0","0","0","5","0","0","5","0","5","1","0","5","0","6","0","0","6","0","0","6"
"Düzce","40.83889","31.16389","1","0","0","0","0","0","1","0","0","0","0","0","0","1","0","0","1","1","0","0","0","0","1"
"Dymchurch","51.02544","0.99392","1","0","0","0","0","0","1","0","0","0","0","0","0","0","1","0","1","0","0","1","0","0","1"
"Dyserth","53.30032","-3.41262","0","0","0","0","0","0","1","0","1","0","0","1","1","0","0","0","1","0","0","1","0","0","1"
"Eagle Butte","45.00248","-101.23349","1","0","0","0","0","0","1","0","0","0","0","0","1","0","0","0","1","1","0","0","0","0","1"
"Eaglesham","55.74119","-4.27459","1","0","0","0","0","0","1","0","0","1","0","1","0","0","1","0","1","0","0","1","0","0","1"
"Ealing","51.51216","-0.30204","6","0","0","1","2","0","9","2","1","4","0","7","3","1","5","0","9","2","1","6","0","0","9"
"Ealing Broadway","51.51566","-0.30079","1","0","0","0","0","0","1","0","0","1","0","1","0","1","0","0","1","0","1","0","0","0","1"
"Eardisley","52.14045","-3.00843","1","0","0","0","0","0","1","0","0","1","0","1","0","0","1","0","1","0","1","0","0","0","1"
"Earl Shilton","52.57682","-1.31536","1","0","0","0","0","0","1","0","1","0","0","1","0","0","1","0","1","0","1","0","0","0","1"
"Easington","17.92397","-76.58824","2","0","0","0","0","0","2","0","1","1","0","2","1","0","1","0","2","0","1","1","0","0","2"
"Easington","54.78528","-1.35917","2","0","0","0","0","0","2","0","1","1","0","2","1","0","1","0","2","0","1","1","0","0","2"
"Easington","54.55345","-0.85058","2","0","0","0","0","0","2","0","1","1","0","2","1","0","1","0","2","0","1","1","0","0","2"
"Easington","53.65359","0.11501","2","0","0","0","0","0","2","0","1","1","0","2","1","0","1","0","2","0","1","1","0","0","2"
"Easingwold","54.1201","-1.1939","1","0","0","0","0","0","1","0","0","0","0","0","1","0","0","0","1","0","0","1","0","0","1"
"East Boldon","54.94452","-1.42815","5","0","0","0","0","0","5","0","1","3","0","4","2","2","1","0","5","2","2","1","0","0","5"
"Eastbourne","50.76871","0.28453","17","0","0","2","2","0","21","3","8","8","1","20","7","4","9","1","21","3","5","9","2","1","20"
"East Bridgford","52.97954","-0.96563","1","0","0","0","0","0","1","0","1","0","0","1","0","0","1","0","1","1","0","0","0","0","1"
"East Cowes","50.75774","-1.28815","1","0","0","0","0","0","1","0","0","1","0","1","0","0","1","0","1","0","1","0","0","0","1"
"East Dereham","52.68333","0.93333","1","0","0","0","0","0","1","0","1","0","0","1","0","1","0","0","1","0","0","0","0","1","1"
"East Grinstead","51.12382","-0.0061","7","0","0","0","1","0","8","1","2","4","0","7","2","2","4","0","8","1","3","4","0","0","8"
"East Horsley","51.27358","-0.43207","1","0","0","0","0","0","1","0","1","0","0","1","0","1","0","0","1","0","0","1","0","0","1"
"East Kilbride","55.76412","-4.17669","6","1","0","0","0","0","7","0","2","4","0","6","4","2","1","0","7","1","2","4","0","0","7"
"East Lansing","42.73698","-84.48387","1","0","0","0","0","0","1","0","0","0","0","0","0","0","1","0","1","1","0","0","0","0","1"
"East Leake","52.83015","-1.18103","1","0","0","0","0","0","1","0","0","0","0","0","0","0","1","0","1","0","0","1","0","0","1"
"Eastleigh","50.96667","-1.35","12","2","0","0","1","0","17","5","6","4","0","15","6","1","10","0","17","5","4","7","0","1","17"
"Eastleigh","-26.12965","28.15541","12","2","0","0","1","0","17","5","6","4","0","15","6","1","10","0","17","5","4","7","0","1","17"
"East London","-33.01529","27.91162","1","0","0","0","0","0","1","1","0","0","0","1","1","0","0","0","1","0","0","1","0","0","1"
"East Molesey","51.39872","-0.34916","2","1","0","0","0","0","3","0","1","2","0","3","2","0","1","0","3","0","0","3","0","0","3"
"East Rudham","52.8207","0.7111","1","0","0","0","0","0","1","0","0","0","0","0","0","1","0","0","1","0","0","1","0","0","1"
"East Tilbury","51.48053","0.41714","0","0","0","1","0","0","1","1","0","0","0","1","0","1","0","0","1","0","0","1","0","0","1"
"Eaton","40.53026","-104.71135","0","0","0","0","1","0","1","1","0","0","0","1","1","0","0","0","1","0","0","1","0","0","1"
"Eaton","40.34032","-85.3508","0","0","0","0","1","0","1","1","0","0","0","1","1","0","0","0","1","0","0","1","0","0","1"
"Eaton","39.74394","-84.63662","0","0","0","0","1","0","1","1","0","0","0","1","1","0","0","0","1","0","0","1","0","0","1"
"Eaton","53.18333","-2.2","0","0","0","0","1","0","1","1","0","0","0","1","1","0","0","0","1","0","0","1","0","0","1"
"Eaton","-33.31664","115.70503","0","0","0","0","1","0","1","1","0","0","0","1","1","0","0","0","1","0","0","1","0","0","1"
"Eaton","-12.4124","130.8807","0","0","0","0","1","0","1","1","0","0","0","1","1","0","0","0","1","0","0","1","0","0","1"
"Eau Claire","44.81135","-91.49849","1","0","0","0","0","0","1","0","0","0","0","0","1","0","0","0","1","0","0","1","0","0","1"
"Eau Claire","41.98505","-86.29974","1","0","0","0","0","0","1","0","0","0","0","0","1","0","0","0","1","0","0","1","0","0","1"
"Ebbw Vale","51.77714","-3.20792","9","0","0","0","1","0","10","2","5","2","0","9","1","3","6","0","10","6","1","3","0","0","10"
"Eccles","53.48333","-2.33333","3","0","0","0","0","0","3","0","3","0","0","3","1","0","2","0","3","0","0","3","0","0","3"
"Eccleshall","52.85789","-2.24971","0","0","0","0","0","0","1","0","0","1","0","1","0","0","1","0","1","0","1","0","0","0","1"
"Eckerö","60.21249","19.61442","1","0","0","0","0","0","1","0","1","0","0","1","0","0","1","0","1","1","0","0","0","0","1"
"Eckington","52.06667","-2.11667","2","0","0","0","0","0","2","0","1","1","0","2","0","1","1","0","2","0","0","1","1","0","2"
"Ede","7.73635","4.43536","1","0","0","0","0","0","1","0","1","0","0","1","0","0","1","0","1","0","0","1","0","0","1"
"Ede","52.03333","5.65833","1","0","0","0","0","0","1","0","1","0","0","1","0","0","1","0","1","0","0","1","0","0","1"
"Edenbridge","51.19172","0.06729","4","0","0","0","1","0","6","2","0","1","0","3","2","1","3","0","6","0","1","5","0","0","6"
"Eden Glen Ext 60","-26.12593","28.165","1","0","0","0","0","0","1","0","0","1","0","1","0","1","0","0","1","0","0","1","0","0","1"
"Edenvale","-26.14095","28.15247","2","0","0","0","0","0","2","1","0","1","0","2","0","0","2","0","2","0","1","1","0","0","2"
"Edgware","51.6128","-0.27539","4","0","0","1","1","0","6","2","0","3","0","5","2","1","3","0","6","0","3","3","0","0","6"
"Edinburgh","39.35422","-85.96666","127","4","0","8","14","0","162","23","47","68","1","139","58","24","79","1","162","20","36","97","2","7","162"
"Edinburgh","55.95206","-3.19648","127","4","0","8","14","0","162","23","47","68","1","139","58","24","79","1","162","20","36","97","2","7","162"
"Edison","31.55823","-84.73825","1","0","0","0","0","0","1","0","0","0","0","0","0","0","1","0","1","0","1","0","0","0","1"
"Edison","40.51872","-74.4121","1","0","0","0","0","0","1","0","0","0","0","0","0","0","1","0","1","0","1","0","0","0","1"
"Edmond","35.65283","-97.4781","1","0","0","0","0","0","1","0","0","0","0","0","1","0","0","0","1","0","0","1","0","0","1"
"Edmonton","53.55014","-113.46871","6","0","0","0","0","0","6","0","3","1","0","4","3","2","1","0","6","3","3","0","0","0","6"
"Edmonton","36.98006","-85.61219","6","0","0","0","0","0","6","0","3","1","0","4","3","2","1","0","6","3","3","0","0","0","6"
"Edmonton","-17.01902","145.74443","6","0","0","0","0","0","6","0","3","1","0","4","3","2","1","0","6","3","3","0","0","0","6"
"Edwardsburg","41.7956","-86.08084","1","0","0","0","0","0","1","0","0","0","0","0","0","0","1","0","1","0","1","0","0","0","1"
"Eenhana","-17.46667","16.33333","1","0","0","0","0","0","1","0","1","0","0","1","1","0","0","0","1","0","0","1","0","0","1"
"Eger","47.90265","20.37329","2","0","0","0","0","0","2","0","0","1","0","1","1","0","1","0","2","0","0","1","0","1","2"
"Egham","51.43158","-0.55239","6","0","0","0","0","0","8","1","2","4","0","7","3","0","5","0","8","1","1","6","0","0","8"
"Eglise Catholique, Centrale GIKO","-1.93653","29.8061","1","0","0","0","0","0","1","0","0","0","1","1","0","0","0","1","1","1","0","0","0","0","1"
"Egremont","54.47941","-3.52756","3","0","0","0","0","0","3","1","1","1","0","3","1","0","2","0","3","1","0","2","0","0","3"
"Eighty Four","40.18174","-80.13311","1","0","0","0","0","0","1","0","1","0","0","1","0","1","0","0","1","1","0","0","0","0","1"
"Eindhoven","51.44083","5.47778","2","0","0","0","0","0","2","0","2","0","0","2","1","0","1","0","2","1","1","0","0","0","2"
"Ekpoma","6.743","6.14029","2","0","0","0","0","0","2","1","0","0","0","1","1","0","1","0","2","0","0","2","0","0","2"
"Eksjö","57.66643","14.97205","1","0","0","0","0","0","1","0","0","0","1","1","1","0","0","0","1","0","0","0","0","1","1"
"Elbasan","41.1125","20.08222","3","1","0","0","0","0","4","1","1","1","0","3","1","1","1","0","3","0","1","1","0","1","3"
"El Bayadh","33.68318","1.01927","1","0","0","0","0","0","1","0","0","0","0","0","0","1","0","0","1","0","0","0","0","1","1"
"Elbląg","54.1522","19.40884","2","0","0","0","0","0","2","0","0","0","0","0","1","0","1","0","2","1","1","0","0","0","2"
"El Cajon","32.79477","-116.96253","3","0","0","0","0","0","3","1","1","0","0","2","2","0","1","0","3","1","1","1","0","0","3"
"Eldoret","0.52036","35.26993","9","0","0","0","0","0","9","0","6","0","0","6","2","6","1","0","9","5","0","0","0","4","9"
"Elford","52.69103","-1.72103","1","0","0","0","0","0","1","0","1","0","0","1","0","0","1","0","1","0","0","1","0","0","1"
"Elgin","45.56486","-117.91743","2","0","0","0","2","0","4","0","1","2","0","3","2","0","2","0","4","0","0","3","0","1","4"
"Elgin","46.4039","-101.84598","2","0","0","0","2","0","4","0","1","2","0","3","2","0","2","0","4","0","0","3","0","1","4"
"Elgin","34.78035","-98.29227","2","0","0","0","2","0","4","0","1","2","0","3","2","0","2","0","4","0","0","3","0","1","4"
"Elgin","41.98334","-98.08368","2","0","0","0","2","0","4","0","1","2","0","3","2","0","2","0","4","0","0","3","0","1","4"
"Elgin","30.34965","-97.37027","2","0","0","0","2","0","4","0","1","2","0","3","2","0","2","0","4","0","0","3","0","1","4"
"Elgin","44.13024","-92.25156","2","0","0","0","2","0","4","0","1","2","0","3","2","0","2","0","4","0","0","3","0","1","4"
"Elgin","42.95748","-91.63071","2","0","0","0","2","0","4","0","1","2","0","3","2","0","2","0","4","0","0","3","0","1","4"
"Elgin","42.03725","-88.28119","2","0","0","0","2","0","4","0","1","2","0","3","2","0","2","0","4","0","0","3","0","1","4"
"Elgin","34.17098","-80.79425","2","0","0","0","2","0","4","0","1","2","0","3","2","0","2","0","4","0","0","3","0","1","4"
"Elgin","34.67293","-80.71896","2","0","0","0","2","0","4","0","1","2","0","3","2","0","2","0","4","0","0","3","0","1","4"
"Elgin","57.64947","-3.31843","2","0","0","0","2","0","4","0","1","2","0","3","2","0","2","0","4","0","0","3","0","1","4"
"Elizabeth","39.36027","-104.59691","1","0","0","0","0","0","1","0","0","0","0","0","1","0","0","0","1","1","0","0","0","0","1"
"Elizabeth","30.86853","-92.79293","1","0","0","0","0","0","1","0","0","0","0","0","1","0","0","0","1","1","0","0","0","0","1"
"Elizabeth","42.31779","-90.22152","1","0","0","0","0","0","1","0","0","0","0","0","1","0","0","0","1","1","0","0","0","0","1"
"Elizabeth","39.06341","-81.39512","1","0","0","0","0","0","1","0","0","0","0","0","1","0","0","0","1","1","0","0","0","0","1"
"Elizabeth","40.26924","-79.88977","1","0","0","0","0","0","1","0","0","0","0","0","1","0","0","0","1","1","0","0","0","0","1"
"Elizabeth","40.66399","-74.2107","1","0","0","0","0","0","1","0","0","0","0","0","1","0","0","0","1","1","0","0","0","0","1"
"Elizabeth","-34.71944","138.67707","1","0","0","0","0","0","1","0","0","0","0","0","1","0","0","0","1","1","0","0","0","0","1"
"Elizabeth Downs","-34.69982","138.69132","1","0","0","0","0","0","1","0","1","0","0","1","1","0","0","0","1","1","0","0","0","0","1"
"El Jadid","33.25682","-8.50882","3","0","0","0","0","0","3","1","2","0","0","3","1","0","2","0","3","1","1","0","0","0","2"
"Elkridge","39.21261","-76.71358","0","1","0","0","0","0","1","0","1","0","0","1","1","0","0","0","1","1","0","0","0","0","1"
"Ellesmere","52.90838","-2.89806","1","0","0","0","0","0","1","1","0","0","0","1","0","0","1","0","1","0","0","1","0","0","1"
"Ellesmere Port","53.27875","-2.90134","9","0","0","1","0","0","10","2","3","3","0","8","2","2","6","0","10","3","3","3","0","1","10"
"Ellinikó","37.89013","23.74406","1","0","0","0","0","0","1","0","1","0","0","1","0","0","1","0","1","1","0","0","0","0","1"
"Ellon","57.36405","-2.07313","4","0","0","0","0","0","4","1","0","2","0","3","0","0","4","0","4","0","3","1","0","0","4"
"El Oued","33.35608","6.86319","1","0","0","0","0","0","1","0","1","0","0","1","0","1","0","0","1","1","0","0","0","0","1"
"Eloy Alfaro","-2.17579","-79.85519","1","0","0","0","0","0","1","1","0","0","0","1","0","1","0","0","1","0","1","0","0","0","1"
"El Paso","31.75872","-106.48693","1","0","0","0","0","0","1","0","0","0","0","0","0","1","0","0","1","0","0","1","0","0","1"
"El Paso","19.55651","-100.35656","1","0","0","0","0","0","1","0","0","0","0","0","0","1","0","0","1","0","0","1","0","0","1"
"El Paso","18.97889","-97.19","1","0","0","0","0","0","1","0","0","0","0","0","0","1","0","0","1","0","0","1","0","0","1"
"El Paso","44.76969","-92.34408","1","0","0","0","0","0","1","0","0","0","0","0","0","1","0","0","1","0","0","1","0","0","1"
"El Paso","40.7392","-89.01646","1","0","0","0","0","0","1","0","0","0","0","0","0","1","0","0","1","0","0","1","0","0","1"
"El Paso","9.65724","-73.74685","1","0","0","0","0","0","1","0","0","0","0","0","0","1","0","0","1","0","0","1","0","0","1"
"El Paso","28.65007","-17.88274","1","0","0","0","0","0","1","0","0","0","0","0","0","1","0","0","1","0","0","1","0","0","1"
"El Prat de Llobregat","41.32784","2.09472","1","0","0","0","0","0","1","1","0","0","0","1","1","0","0","0","1","0","0","1","0","0","1"
"Elst","51.91917","5.84167","1","0","0","0","0","0","1","0","0","1","0","1","0","1","0","0","1","0","1","0","0","0","1"
"Elsternwick","-37.88639","145.0025","1","0","0","0","0","0","1","0","0","1","0","1","0","0","1","0","1","0","0","1","0","0","1"
"Elstree","51.6403","-0.29693","3","1","0","1","0","0","5","3","1","1","0","5","2","0","3","0","5","0","4","0","0","1","5"
"El Tejar","19.07433","-96.16097","1","0","0","0","0","0","1","0","1","0","0","1","1","0","0","0","1","1","0","0","0","0","1"
"El Tejar","14.64683","-90.79122","1","0","0","0","0","0","1","0","1","0","0","1","1","0","0","0","1","1","0","0","0","0","1"
"El Tejar","8.42973","-82.57294","1","0","0","0","0","0","1","0","1","0","0","1","1","0","0","0","1","1","0","0","0","0","1"
"Ely","39.24744","-114.88863","15","0","0","0","0","0","15","2","2","7","2","13","3","3","9","0","15","1","5","9","0","0","15"
"Ely","47.90324","-91.86709","15","0","0","0","0","0","15","2","2","7","2","13","3","3","9","0","15","1","5","9","0","0","15"
"Ely","41.87362","-91.58518","15","0","0","0","0","0","15","2","2","7","2","13","3","3","9","0","15","1","5","9","0","0","15"
"Ely","52.39964","0.26196","15","0","0","0","0","0","15","2","2","7","2","13","3","3","9","0","15","1","5","9","0","0","15"
"Embu","-23.64889","-46.85222","2","0","0","1","0","0","3","0","1","0","2","3","2","0","1","0","3","0","1","1","0","1","3"
"Embu","-0.53987","37.45743","2","0","0","1","0","0","3","0","1","0","2","3","2","0","1","0","3","0","1","1","0","1","3"
"Empangeni","-28.76197","31.89329","1","0","0","0","0","0","1","1","0","0","0","1","0","1","0","0","1","0","0","1","0","0","1"
"Emsworth","40.51007","-80.0945","4","0","0","0","1","0","7","2","1","3","0","6","7","0","0","0","7","0","2","5","0","0","7"
"Emsworth","50.84779","-0.93697","4","0","0","0","1","0","7","2","1","3","0","6","7","0","0","0","7","0","2","5","0","0","7"
"Emure-Ekiti","7.43636","5.45925","1","0","0","0","0","0","1","1","0","0","0","1","0","0","0","0","0","0","1","0","0","0","1"
"Enfield Town","51.65147","-0.08497","15","0","0","0","0","0","15","3","2","3","0","8","5","2","8","0","15","4","6","5","0","0","15"
"Ennis","45.34882","-111.7297","1","0","0","0","0","0","1","0","0","1","0","1","0","0","1","0","1","0","0","1","0","0","1"
"Ennis","32.32931","-96.62527","1","0","0","0","0","0","1","0","0","1","0","1","0","0","1","0","1","0","0","1","0","0","1"
"Ennis","52.84361","-8.98639","1","0","0","0","0","0","1","0","0","1","0","1","0","0","1","0","1","0","0","1","0","0","1"
"Enniskillen","54.34615","-7.64133","7","0","0","0","1","0","8","0","1","2","0","3","2","1","5","0","8","3","1","4","0","0","8"
"Ennistimon","52.94472","-9.29222","1","0","0","0","0","0","1","0","0","1","0","1","1","0","0","0","1","0","0","1","0","0","1"
"Enschede","52.21833","6.89583","3","0","0","0","0","0","3","1","2","0","0","3","2","0","1","0","3","0","0","2","0","1","3"
"Ensenada","31.87149","-116.60071","3","0","0","0","1","0","4","2","1","0","0","3","2","1","1","0","4","1","1","1","0","1","4"
"Ensenada","25.86961","-97.86757","3","0","0","0","1","0","4","2","1","0","0","3","2","1","1","0","4","1","1","1","0","1","4"
"Ensenada","-34.86186","-57.91126","3","0","0","0","1","0","4","2","1","0","0","3","2","1","1","0","4","1","1","1","0","1","4"
"Enstone","51.91537","-1.45371","0","0","0","0","1","0","1","0","0","0","0","0","1","0","0","0","1","0","0","1","0","0","1"
"Entebbe","0.05621","32.47949","2","0","0","0","1","0","3","0","3","0","0","3","2","0","0","1","3","2","0","0","1","0","3"
"Entrecasteaux","43.51591","6.24204","1","0","0","0","0","0","1","0","0","1","0","1","0","0","1","0","1","0","0","1","0","0","1"
"Enugu","6.44132","7.49883","7","1","0","0","0","0","8","4","2","1","0","7","6","1","1","0","8","0","1","4","1","1","7"
"Epping","43.03342","-71.07423","4","0","0","0","1","0","5","2","3","0","0","5","2","1","2","0","5","2","0","3","0","0","5"
"Epping","51.69815","0.11055","4","0","0","0","1","0","5","2","3","0","0","5","2","1","2","0","5","2","0","3","0","0","5"
"Epping","49.11178","7.31706","4","0","0","0","1","0","5","2","3","0","0","5","2","1","2","0","5","2","0","3","0","0","5"
"Epping","-37.65","145.03333","4","0","0","0","1","0","5","2","3","0","0","5","2","1","2","0","5","2","0","3","0","0","5"
"Epping","-33.77271","151.08184","4","0","0","0","1","0","5","2","3","0","0","5","2","1","2","0","5","2","0","3","0","0","5"
"Epsom","43.22286","-71.33201","17","1","0","0","4","0","24","4","4","9","0","17","11","3","10","0","24","2","7","14","0","1","24"
"Epsom","51.3305","-0.27011","17","1","0","0","4","0","24","4","4","9","0","17","11","3","10","0","24","2","7","14","0","1","24"
"Epsom","-36.71667","144.31667","17","1","0","0","4","0","24","4","4","9","0","17","11","3","10","0","24","2","7","14","0","1","24"
"Erbil","36.18333","44.01193","49","5","0","0","0","0","55","26","12","8","0","46","16","14","25","0","55","6","8","34","0","7","55"
"Ericeira","38.96275","-9.41563","0","0","0","1","0","0","1","0","1","0","0","1","1","0","0","0","1","1","0","0","0","0","1"
"Erith","51.48315","0.17484","2","0","0","0","0","0","2","0","1","1","0","2","1","0","1","0","2","1","0","1","0","0","2"
"Erode","11.3428","77.72741","6","0","0","0","0","0","6","6","0","0","0","6","0","0","5","1","6","0","0","6","0","0","6"
"Erving","42.60009","-72.39814","0","0","0","1","0","0","1","1","0","0","0","1","0","1","0","0","1","0","0","1","0","0","1"
"Escazú","9.91887","-84.13989","2","0","0","0","0","0","2","0","0","0","0","0","2","0","0","0","2","0","0","2","0","0","2"
"Esch-sur-Alzette","49.49583","5.98056","1","0","0","0","0","0","1","0","0","1","0","1","0","0","1","0","1","0","1","0","0","0","1"
"Esher","51.36969","-0.36693","8","0","0","1","1","0","11","3","2","4","0","9","4","0","6","1","11","0","1","10","0","0","11"
"Eskişehir","39.77667","30.52056","1","0","0","0","0","0","1","0","0","0","0","0","0","0","1","0","1","1","0","0","0","0","1"
"Esmeraldas","0.9592","-79.65397","1","0","0","0","0","0","1","1","0","0","0","1","0","0","1","0","1","0","0","1","0","0","1"
"Esmeraldas","-19.7625","-44.31389","1","0","0","0","0","0","1","1","0","0","0","1","0","0","1","0","1","0","0","1","0","0","1"
"Espoo","60.2052","24.6522","1","0","0","0","0","0","1","0","1","0","0","1","1","0","0","0","1","0","0","1","0","0","1"
"Essen","51.46791","4.46901","2","0","0","0","1","0","3","0","2","0","0","2","3","0","0","0","3","1","0","0","2","0","3"
"Essen","51.45657","7.01228","2","0","0","0","1","0","3","0","2","0","0","2","3","0","0","0","3","1","0","0","2","0","3"
"Essen","52.72258","7.9371","2","0","0","0","1","0","3","0","2","0","0","2","3","0","0","0","3","1","0","0","2","0","3"
"Esslingen","47.28325","8.71038","1","0","0","0","0","0","1","0","1","0","0","1","1","0","0","0","1","0","0","1","0","0","1"
"Esslingen","48.73961","9.30473","1","0","0","0","0","0","1","0","1","0","0","1","1","0","0","0","1","0","0","1","0","0","1"
"Estelí","13.09185","-86.35384","1","0","0","0","0","0","1","0","0","0","0","0","0","1","0","0","1","0","0","1","0","0","1"
"Estella-Lizarra","42.67182","-2.03226","0","0","0","0","1","0","1","0","0","0","0","0","0","0","1","0","1","1","0","0","0","0","1"
"Etobicoke","43.65421","-79.56711","0","0","0","0","1","0","2","1","0","0","0","1","0","1","1","0","2","1","0","1","0","0","2"
"Eton","34.82508","-84.76327","2","0","0","0","0","0","2","0","0","0","0","0","2","0","0","0","2","0","0","2","0","0","2"
"Eton","51.48833","-0.60905","2","0","0","0","0","0","2","0","0","0","0","0","2","0","0","0","2","0","0","2","0","0","2"
"Eton","-21.26471","148.97237","2","0","0","0","0","0","2","0","0","0","0","0","2","0","0","0","2","0","0","2","0","0","2"
"Etwall","52.88353","-1.60023","0","0","0","0","1","0","1","0","0","1","0","1","0","1","0","0","1","0","0","1","0","0","1"
"Euless","32.83707","-97.08195","2","0","0","0","0","0","2","0","0","2","0","2","1","1","0","0","2","0","1","1","0","0","2"
"Evanston","41.26828","-110.96324","1","0","0","0","0","0","1","0","0","0","0","0","0","1","0","0","1","1","0","0","0","0","1"
"Evanston","42.04114","-87.69006","1","0","0","0","0","0","1","0","0","0","0","0","0","1","0","0","1","1","0","0","0","0","1"
"Evanston","-34.61657","138.73369","1","0","0","0","0","0","1","0","0","0","0","0","0","1","0","0","1","1","0","0","0","0","1"
"Evesham","52.09237","-1.94887","4","0","0","1","1","0","7","1","3","2","0","6","4","0","3","0","7","2","1","4","0","0","7"
"Évora","38.56667","-7.9","1","0","0","0","0","0","1","1","0","0","0","1","0","0","1","0","1","0","0","1","0","0","1"
"Ewenny","51.48183","-3.57367","1","0","0","0","0","0","1","0","0","1","0","1","0","0","1","0","1","0","0","1","0","0","1"
"Exeter","36.29606","-119.14205","51","1","0","3","5","0","63","10","15","26","2","53","18","6","37","2","63","6","11","42","0","4","63"
"Exeter","40.64417","-97.45033","51","1","0","3","5","0","63","10","15","26","2","53","18","6","37","2","63","6","11","42","0","4","63"
"Exeter","36.67229","-93.94104","51","1","0","3","5","0","63","10","15","26","2","53","18","6","37","2","63","6","11","42","0","4","63"
"Exeter","41.32064","-75.81908","51","1","0","3","5","0","63","10","15","26","2","53","18","6","37","2","63","6","11","42","0","4","63"
"Exeter","41.5776","-71.53756","51","1","0","3","5","0","63","10","15","26","2","53","18","6","37","2","63","6","11","42","0","4","63"
"Exeter","42.98148","-70.94783","51","1","0","3","5","0","63","10","15","26","2","53","18","6","37","2","63","6","11","42","0","4","63"
"Exeter","50.7236","-3.52751","51","1","0","3","5","0","63","10","15","26","2","53","18","6","37","2","63","6","11","42","0","4","63"
"Exeter","-34.83994","138.48902","51","1","0","3","5","0","63","10","15","26","2","53","18","6","37","2","63","6","11","42","0","4","63"
"Exeter","-41.29749","146.95055","51","1","0","3","5","0","63","10","15","26","2","53","18","6","37","2","63","6","11","42","0","4","63"
"Exeter","-34.61283","150.32083","51","1","0","3","5","0","63","10","15","26","2","53","18","6","37","2","63","6","11","42","0","4","63"
"Exmouth","50.61723","-3.40233","2","0","0","1","0","0","5","3","1","0","0","4","4","0","1","0","5","0","1","4","0","0","5"
"Exmouth","-21.93063","114.12091","2","0","0","1","0","0","5","3","1","0","0","4","4","0","1","0","5","0","1","4","0","0","5"
"Exton","40.029","-75.62077","1","0","0","0","0","0","1","0","0","1","0","1","0","0","1","0","1","0","0","1","0","0","1"
"Exton","52.69106","-0.63463","1","0","0","0","0","0","1","0","0","1","0","1","0","0","1","0","1","0","0","1","0","0","1"
"Eye","52.608","-0.19209","0","0","0","1","0","0","1","1","0","0","0","1","0","0","1","0","1","0","1","0","0","0","1"
"Eyemouth","55.8713","-2.0901","1","0","0","0","1","0","2","1","1","0","0","2","1","0","1","0","2","1","0","1","0","0","2"
"Eynsham","51.78077","-1.37454","1","0","0","0","0","0","1","0","0","1","0","1","0","1","0","0","1","0","1","0","0","0","1"
"Factoryville","41.56313","-75.78269","1","0","0","0","0","0","1","0","1","0","0","1","1","0","0","0","1","0","0","1","0","0","1"
"Factoryville","40.82482","-75.20962","1","0","0","0","0","0","1","0","1","0","0","1","1","0","0","0","1","0","0","1","0","0","1"
"Făgăraș","45.85","24.96667","1","0","0","0","0","0","1","1","0","0","0","1","0","0","1","0","1","0","0","1","0","0","1"
"Failsworth","53.50484","-2.16568","1","0","0","0","1","0","2","0","2","0","0","2","2","0","0","0","2","0","0","1","0","0","1"
"Fairfax","37.98715","-122.58887","2","0","0","0","0","0","2","1","0","1","0","2","0","0","2","0","2","0","1","1","0","0","2"
"Fairfax","36.57366","-96.7042","2","0","0","0","0","0","2","1","0","1","0","2","0","0","2","0","2","0","1","1","0","0","2"
"Fairfax","40.33861","-95.39331","2","0","0","0","0","0","2","1","0","1","0","2","0","0","2","0","2","0","1","1","0","0","2"
"Fairfax","44.52913","-94.72082","2","0","0","0","0","0","2","1","0","1","0","2","0","0","2","0","2","0","1","1","0","0","2"
"Fairfax","41.91945","-91.78101","2","0","0","0","0","0","2","1","0","1","0","2","0","0","2","0","2","0","1","1","0","0","2"
"Fairfax","39.14534","-84.39327","2","0","0","0","0","0","2","1","0","1","0","2","0","0","2","0","2","0","1","1","0","0","2"
"Fairfax","32.95905","-81.2365","2","0","0","0","0","0","2","1","0","1","0","2","0","0","2","0","2","0","1","1","0","0","2"
"Fairfax","38.84622","-77.30637","2","0","0","0","0","0","2","1","0","1","0","2","0","0","2","0","2","0","1","1","0","0","2"
"Faisalabad","31.41554","73.08969","31","1","0","0","1","0","33","16","7","6","1","30","11","9","13","0","33","9","1","22","2","4","38"
"Fakenham","52.82996","0.8477","3","0","0","0","0","0","3","0","3","0","0","3","2","0","1","0","3","2","0","1","0","0","3"
"Falam","22.91335","93.67779","2","0","0","0","0","0","2","0","1","0","1","2","1","0","0","1","2","0","0","2","0","0","2"
"Falkirk","56.0021","-3.78535","19","0","0","2","1","0","22","3","8","9","0","20","10","0","12","0","22","2","5","14","0","1","22"
"Fällanden","47.37169","8.63869","1","0","0","0","0","0","1","0","0","0","0","0","1","0","0","0","1","0","0","1","0","0","1"
"Fall River","43.38443","-89.04511","1","0","0","0","0","0","1","0","0","1","0","1","0","0","1","0","1","1","0","0","0","0","1"
"Fall River","41.70149","-71.15505","1","0","0","0","0","0","1","0","0","1","0","1","0","0","1","0","1","1","0","0","0","0","1"
"Fall River","44.81685","-63.6154","1","0","0","0","0","0","1","0","0","1","0","1","0","0","1","0","1","1","0","0","0","0","1"
"Falls Church","38.88233","-77.17109","1","0","0","0","0","0","1","0","0","1","0","1","0","1","0","0","1","0","0","1","0","0","1"
"Falmouth","38.67674","-84.33021","1","0","0","0","1","0","3","1","2","0","0","3","0","0","3","0","3","1","1","1","0","0","3"
"Falmouth","18.49358","-77.65587","1","0","0","0","1","0","3","1","2","0","0","3","0","0","3","0","3","1","1","1","0","0","3"
"Falmouth","38.32402","-77.46832","1","0","0","0","1","0","3","1","2","0","0","3","0","0","3","0","3","1","1","1","0","0","3"
"Falmouth","41.5515","-70.61475","1","0","0","0","1","0","3","1","2","0","0","3","0","0","3","0","3","1","1","1","0","0","3"
"Falmouth","43.72953","-70.24199","1","0","0","0","1","0","3","1","2","0","0","3","0","0","3","0","3","1","1","1","0","0","3"
"Falmouth","17.02741","-61.78136","1","0","0","0","1","0","3","1","2","0","0","3","0","0","3","0","3","1","1","1","0","0","3"
"Falmouth","50.15441","-5.07113","1","0","0","0","1","0","3","1","2","0","0","3","0","0","3","0","3","1","1","1","0","0","3"
"Fāqūs","30.72816","31.79697","1","0","0","0","1","0","2","0","0","1","1","2","1","0","1","0","2","1","0","1","0","0","2"
"Farafangana","-22.82223","47.82615","1","0","0","0","0","0","1","0","0","0","0","0","0","1","0","0","1","0","0","0","0","1","1"
"Fareham","50.85162","-1.17929","13","2","0","1","2","0","19","4","6","8","0","18","5","3","10","0","18","2","4","12","0","0","18"
"Faribault","44.29496","-93.26883","0","0","0","1","0","0","1","1","0","0","0","1","1","0","0","0","1","0","0","1","0","0","1"
"Faridabad","28.41124","77.31316","2","0","0","0","0","0","2","0","1","1","0","2","1","0","1","0","2","0","0","1","0","1","2"
"Farīdpur","28.20997","79.54149","3","0","0","0","0","0","3","0","0","0","2","2","1","1","0","1","3","1","1","0","0","1","3"
"Farīdpur","23.60612","89.84064","3","0","0","0","0","0","3","0","0","0","2","2","1","1","0","1","3","1","1","0","0","1","3"
"Faringdon","51.65644","-1.58676","1","0","0","0","1","0","2","1","0","1","0","2","1","0","1","0","2","0","0","2","0","0","2"
"Farmers Branch","32.92651","-96.89612","2","0","0","0","0","0","2","1","0","0","0","1","1","0","1","0","2","0","0","2","0","0","2"
"Farnborough","52.14289","-1.36926","18","0","0","0","0","0","18","0","4","11","1","16","3","4","11","0","18","4","5","8","0","1","18"
"Farnborough","51.53333","-1.36667","18","0","0","0","0","0","18","0","4","11","1","16","3","4","11","0","18","4","5","8","0","1","18"
"Farnborough","51.29424","-0.75565","18","0","0","0","0","0","18","0","4","11","1","16","3","4","11","0","18","4","5","8","0","1","18"
"Farnborough","51.35948","0.06905","18","0","0","0","0","0","18","0","4","11","1","16","3","4","11","0","18","4","5","8","0","1","18"
"Farnborough","-23.09122","150.74148","18","0","0","0","0","0","18","0","4","11","1","16","3","4","11","0","18","4","5","8","0","1","18"
"Farnham","45.28338","-72.98244","12","0","0","1","4","0","17","6","4","3","0","13","8","1","8","0","17","2","4","11","0","0","17"
"Farnham","51.21444","-0.80054","12","0","0","1","4","0","17","6","4","3","0","13","8","1","8","0","17","2","4","11","0","0","17"
"Farnham Royal","51.54208","-0.61584","1","0","0","0","0","0","1","1","0","0","0","1","0","0","1","0","1","1","0","0","0","0","1"
"Farnsfield","53.10223","-1.0332","2","0","0","0","0","0","2","0","1","1","0","2","0","0","2","0","2","0","2","0","0","0","2"
"Faro","37.01869","-7.92716","2","0","0","0","0","0","2","1","0","0","0","1","0","1","1","0","2","0","0","1","0","1","2"
"Farrukhābād","27.39134","79.5793","1","0","0","0","0","0","1","1","0","0","0","1","1","0","0","0","1","0","0","1","0","0","1"
"Farshūţ","26.05494","32.16329","1","0","0","0","0","0","1","1","0","0","0","1","0","1","0","0","1","0","0","1","0","0","1"
"Fatehpur","27.99486","74.95628","1","0","0","0","0","0","1","1","0","0","0","1","1","0","0","0","1","0","0","1","0","0","1"
"Fatehpur","25.92774","80.81266","1","0","0","0","0","0","1","1","0","0","0","1","1","0","0","0","1","0","0","1","0","0","1"
"Fatehpur","27.17281","81.21061","1","0","0","0","0","0","1","1","0","0","0","1","1","0","0","0","1","0","0","1","0","0","1"
"Faversham","51.3148","0.88856","0","0","0","0","1","0","1","0","1","0","0","1","1","0","0","0","1","0","0","1","0","0","1"
"Fayetteville","36.06258","-94.15743","1","0","0","0","0","0","1","0","1","0","0","1","0","0","1","0","1","0","0","1","0","0","1"
"Fayetteville","35.15203","-86.57055","1","0","0","0","0","0","1","0","1","0","0","1","0","0","1","0","1","0","0","1","0","0","1"
"Fayetteville","33.14567","-86.40581","1","0","0","0","0","0","1","0","1","0","0","1","0","0","1","0","1","0","0","1","0","0","1"
"Fayetteville","33.44873","-84.45493","1","0","0","0","0","0","1","0","1","0","0","1","0","0","1","0","1","0","0","1","0","0","1"
"Fayetteville","38.05289","-81.10399","1","0","0","0","0","0","1","0","1","0","0","1","0","0","1","0","1","0","0","1","0","0","1"
"Fayetteville","35.05266","-78.87836","1","0","0","0","0","0","1","0","1","0","0","1","0","0","1","0","1","0","0","1","0","0","1"
"Fayetteville","39.9112","-77.54999","1","0","0","0","0","0","1","0","1","0","0","1","0","0","1","0","1","0","0","1","0","0","1"
"Fayetteville","43.02979","-76.00436","1","0","0","0","0","0","1","0","1","0","0","1","0","0","1","0","1","0","0","1","0","0","1"
"Fazilpur","32.17629","75.06583","1","0","0","0","0","0","1","1","0","0","0","1","0","0","1","0","1","0","0","1","0","0","1"
"Felixstowe","51.96375","1.3511","3","0","0","0","0","0","3","0","3","0","0","3","1","0","2","0","3","1","0","2","0","0","3"
"Felling","54.95297","-1.57152","1","0","0","0","0","0","1","1","0","0","0","1","0","0","1","0","1","0","1","0","0","0","1"
"Feltham","51.4462","-0.41388","3","1","0","1","0","0","5","3","0","1","0","4","1","0","4","0","5","0","2","3","0","0","5"
"Feni","23.0144","91.3966","2","0","0","0","1","0","3","2","0","1","0","3","2","1","0","0","3","1","0","2","0","0","3"
"Fenstanton","52.29903","-0.06712","2","0","0","0","0","0","2","0","2","0","0","2","1","0","1","0","2","0","2","0","0","0","2"
"Ferizaj","42.37056","21.15528","1","0","0","0","0","0","1","0","0","0","0","0","0","0","1","0","1","0","0","1","0","0","1"
"Fernando de la Mora","-25.3386","-57.52167","1","0","0","0","0","0","1","0","0","0","0","0","0","1","0","0","1","0","0","1","0","0","1"
"Ferndale","40.57624","-124.26394","6","0","0","0","0","0","7","1","3","3","0","7","1","1","5","0","7","2","2","3","0","0","7"
"Ferndale","48.8465","-122.59101","6","0","0","0","0","0","7","1","3","3","0","7","1","1","5","0","7","2","2","3","0","0","7"
"Ferndale","42.46059","-83.13465","6","0","0","0","0","0","7","1","3","3","0","7","1","1","5","0","7","2","2","3","0","0","7"
"Ferndale","40.28896","-78.91475","6","0","0","0","0","0","7","1","3","3","0","7","1","1","5","0","7","2","2","3","0","0","7"
"Ferndale","39.18316","-76.64024","6","0","0","0","0","0","7","1","3","3","0","7","1","1","5","0","7","2","2","3","0","0","7"
"Ferndale","51.66056","-3.4475","6","0","0","0","0","0","7","1","3","3","0","7","1","1","5","0","7","2","2","3","0","0","7"
"Ferndale","-32.03494","115.92233","6","0","0","0","0","0","7","1","3","3","0","7","1","1","5","0","7","2","2","3","0","0","7"
"Ferndown","50.80743","-1.89975","1","0","0","0","0","0","1","0","1","0","0","1","0","0","1","0","1","0","1","0","0","0","1"
"Ferntree Gully","-37.88461","145.29539","1","0","0","0","0","0","1","0","0","1","0","1","0","0","1","0","1","1","0","0","0","0","1"
"Ferozepore","30.92574","74.61311","2","0","0","0","0","0","2","2","0","0","0","2","1","1","0","0","2","0","0","2","0","0","2"
"Fès","34.03313","-5.00028","5","0","0","0","0","0","5","2","1","0","2","5","1","1","1","2","5","1","0","4","0","0","5"
"Fichē","9.8","38.73333","0","0","0","0","0","0","0","1","0","0","0","1","0","1","0","0","1","0","0","1","0","0","1"
"Fier","40.72389","19.55611","5","2","0","0","0","0","7","3","1","1","0","5","4","0","3","0","7","0","1","4","0","2","7"
"Figueira da Foz","40.15085","-8.86179","0","0","0","0","0","0","1","0","0","0","0","0","0","1","0","0","1","1","0","0","0","0","1"
"Figueras","43.53943","-7.02559","1","0","0","0","0","0","1","1","0","0","0","1","1","0","0","0","1","0","1","0","0","0","1"
"Filabusi","-20.53333","29.28502","1","0","0","0","0","0","1","0","1","0","0","1","0","1","0","0","1","0","0","0","0","1","1"
"Filey","54.21","-0.28917","3","0","0","0","0","0","3","0","1","2","0","3","1","0","2","0","3","1","0","2","0","0","3"
"Findon","50.86816","-0.40735","1","0","0","0","0","0","1","0","0","0","0","0","1","0","0","0","1","0","0","1","0","0","1"
"Findon","-34.9","138.53333","1","0","0","0","0","0","1","0","0","0","0","0","1","0","0","0","1","0","0","1","0","0","1"
"Finedon","52.33917","-0.65008","1","0","0","0","0","0","1","0","1","0","0","1","0","0","1","0","1","0","0","1","0","0","1"
"Finote Selam","10.7","37.26667","1","0","0","0","0","0","1","0","1","0","0","1","0","0","0","0","0","0","0","0","0","0","0"
"Fishers","39.95559","-86.01387","2","0","0","0","0","0","2","1","0","0","0","1","0","0","2","0","2","0","0","2","0","0","2"
"Fishguard","51.99376","-4.97631","2","0","0","0","0","0","2","1","0","1","0","2","0","1","1","0","2","0","1","1","0","0","2"
"Fittleworth","50.9644","-0.56185","1","0","0","0","0","0","1","0","0","0","0","0","1","0","0","0","1","0","0","1","0","0","1"
"Fivemiletown","54.38333","-7.3","1","0","0","0","0","0","1","0","0","1","0","1","0","0","1","0","1","1","0","0","0","0","1"
"Fleckney","52.53497","-1.04598","1","0","0","0","0","0","1","0","1","0","0","1","0","0","1","0","1","1","0","0","0","0","1"
"Fleet","51.28333","-0.83333","18","0","0","0","2","0","21","3","6","7","0","16","9","1","11","0","21","1","7","13","0","0","21"
"Fleet","52.79321","0.05854","18","0","0","0","2","0","21","3","6","7","0","16","9","1","11","0","21","1","7","13","0","0","21"
"Fleetwood","40.45398","-75.81798","3","1","0","1","1","0","6","0","1","3","0","4","1","1","4","0","6","0","2","4","0","0","6"
"Fleetwood","53.92527","-3.01085","3","1","0","1","1","0","6","0","1","3","0","4","1","1","4","0","6","0","2","4","0","0","6"
"Flemington","31.85965","-81.564","1","0","0","0","0","0","1","1","0","0","0","1","1","0","0","0","1","0","0","1","0","0","1"
"Flemington","41.12646","-77.47165","1","0","0","0","0","0","1","1","0","0","0","1","1","0","0","0","1","0","0","1","0","0","1"
"Flemington","40.51233","-74.85933","1","0","0","0","0","0","1","1","0","0","0","1","1","0","0","0","1","0","0","1","0","0","1"
"Flemington","-37.78825","144.93001","1","0","0","0","0","0","1","1","0","0","0","1","1","0","0","0","1","0","0","1","0","0","1"
"Flensburg","54.78431","9.43961","1","0","0","0","0","0","1","0","0","1","0","1","1","0","0","0","1","0","0","1","0","0","1"
"Flint","43.01253","-83.68746","2","0","0","0","0","0","2","2","0","0","0","2","1","0","1","0","2","0","1","1","0","0","2"
"Flint","53.24488","-3.13231","2","0","0","0","0","0","2","2","0","0","0","2","1","0","1","0","2","0","1","1","0","0","2"
"Flitwick","52.00338","-0.49472","3","0","0","0","1","0","4","0","0","3","0","3","2","0","2","0","4","0","2","2","0","0","4"
"Florence","43.98262","-124.09984","2","0","0","0","0","0","2","1","0","0","0","1","0","1","1","0","2","0","0","2","0","0","2"
"Florence","46.63159","-114.079","2","0","0","0","0","0","2","1","0","0","0","1","0","1","1","0","2","0","0","2","0","0","2"
"Florence","33.03145","-111.38734","2","0","0","0","0","0","2","1","0","0","0","1","0","1","1","0","2","0","0","2","0","0","2"
"Florence","38.39028","-105.1186","2","0","0","0","0","0","2","1","0","0","0","1","0","1","1","0","2","0","0","2","0","0","2"
"Florence","30.8413","-97.79363","2","0","0","0","0","0","2","1","0","0","0","1","0","1","1","0","2","0","0","2","0","0","2"
"Florence","32.15348","-90.1312","2","0","0","0","0","0","2","1","0","0","0","1","0","1","1","0","2","0","0","2","0","0","2"
"Florence","45.92218","-88.2518","2","0","0","0","0","0","2","1","0","0","0","1","0","1","1","0","2","0","0","2","0","0","2"
"Florence","34.79981","-87.67725","2","0","0","0","0","0","2","1","0","0","0","1","0","1","1","0","2","0","0","2","0","0","2"
"Florence","38.99895","-84.62661","2","0","0","0","0","0","2","1","0","0","0","1","0","1","1","0","2","0","0","2","0","0","2"
"Florence","34.19543","-79.76256","2","0","0","0","0","0","2","1","0","0","0","1","0","1","1","0","2","0","0","2","0","0","2"
"Florence","39.73428","-74.91822","2","0","0","0","0","0","2","1","0","0","0","1","0","1","1","0","2","0","0","2","0","0","2"
"Florence","40.11955","-74.80544","2","0","0","0","0","0","2","1","0","0","0","1","0","1","1","0","2","0","0","2","0","0","2"
"Florence","43.77925","11.24626","2","0","0","0","0","0","2","1","0","0","0","1","0","1","1","0","2","0","0","2","0","0","2"
"Floreşti","44.76306","22.94778","1","0","0","0","0","0","1","0","0","0","0","0","1","0","0","0","1","0","0","1","0","0","1"
"Floreşti","46.74574","23.49375","1","0","0","0","0","0","1","0","0","0","0","0","1","0","0","0","1","0","0","1","0","0","1"
"Floreşti","45.05","25.78333","1","0","0","0","0","0","1","0","0","0","0","0","1","0","0","0","1","0","0","1","0","0","1"
"Floreşti","47.89137","28.29312","1","0","0","0","0","0","1","0","0","0","0","0","1","0","0","0","1","0","0","1","0","0","1"
"Florianópolis","-27.59667","-48.54917","1","0","0","0","0","0","1","1","0","0","0","1","0","1","0","0","1","1","0","0","0","0","1"
"Florida","15.03333","-88.83333","2","0","0","0","0","0","2","0","1","0","0","1","0","0","2","0","2","1","0","1","0","0","2"
"Florida","21.52536","-78.22579","2","0","0","0","0","0","2","0","1","0","0","1","0","0","2","0","2","1","0","1","0","0","2"
"Florida","3.3223","-76.2348","2","0","0","0","0","0","2","0","1","0","0","1","0","0","2","0","2","1","0","1","0","0","2"
"Florida","41.33176","-74.35682","2","0","0","0","0","0","2","0","1","0","0","1","0","0","2","0","2","1","0","1","0","0","2"
"Florida","42.66675","-73.01121","2","0","0","0","0","0","2","0","1","0","0","1","0","0","2","0","2","1","0","1","0","0","2"
"Florida","18.36245","-66.56128","2","0","0","0","0","0","2","0","1","0","0","1","0","0","2","0","2","1","0","1","0","0","2"
"Florida","-34.09556","-56.21417","2","0","0","0","0","0","2","0","1","0","0","1","0","0","2","0","2","1","0","1","0","0","2"
"Floridablanca","7.06222","-73.08644","1","0","0","0","0","0","1","0","1","0","0","1","1","0","0","0","1","0","0","0","0","1","1"
"Floridablanca","14.9775","120.5285","1","0","0","0","0","0","1","0","1","0","0","1","1","0","0","0","1","0","0","0","0","1","1"
"Flourtown","40.10344","-75.2124","1","0","0","0","0","0","1","0","0","0","0","0","1","0","0","0","1","0","0","1","0","0","1"
"Foča","43.50646","18.77854","6","0","0","0","0","0","6","0","0","0","0","0","0","6","0","0","6","6","0","0","0","0","6"
"Folkestone","51.08169","1.16734","9","0","0","0","1","0","10","1","3","3","0","7","2","2","6","0","10","3","2","5","0","0","10"
"Fomento","22.10475","-79.72141","1","0","0","0","0","0","1","0","1","0","0","1","1","0","0","0","1","1","0","0","0","0","1"
"Fond du Sac","-20.04732","57.584","1","0","0","0","0","0","1","1","0","0","0","1","0","0","1","0","1","0","1","0","0","0","1"
"Fontainebleau","48.40908","2.70177","0","0","0","0","0","0","1","1","0","0","0","1","0","0","1","0","1","0","0","1","0","0","1"
"Footscray","-37.8","144.9","1","0","0","0","0","0","1","1","0","0","0","1","0","0","1","0","1","0","0","1","0","0","1"
"Førde","61.45217","5.85717","1","0","0","0","0","0","1","0","1","0","0","1","0","0","1","0","1","0","0","1","0","0","1"
"Fordingbridge","50.92747","-1.79029","1","0","0","0","0","0","1","0","0","0","0","0","0","0","1","0","1","0","0","1","0","0","1"
"Forest Row","51.09641","0.03262","1","0","0","0","0","0","1","0","1","0","0","1","0","0","1","0","1","1","0","0","0","0","1"
"Forfar","56.64382","-2.89001","3","0","0","1","0","0","4","2","1","1","0","4","2","1","1","0","4","1","1","2","0","0","4"
"Formby","53.55838","-3.06999","1","0","0","0","1","0","2","0","1","1","0","2","1","0","1","0","2","0","0","2","0","0","2"
"Fort Abbas","29.19344","72.85525","1","0","0","0","0","0","1","0","1","0","0","1","0","0","1","0","1","0","0","0","0","0","0"
"Fort Lauderdale","26.12231","-80.14338","0","0","0","1","0","0","1","0","0","0","0","0","0","1","0","0","1","0","0","1","0","0","1"
"Fort Lee","37.4957","-77.33526","1","0","0","0","0","0","1","0","0","0","0","0","0","0","1","0","1","0","0","1","0","0","1"
"Fort Lee","37.24694","-77.33442","1","0","0","0","0","0","1","0","0","0","0","0","0","0","1","0","1","0","0","1","0","0","1"
"Fort Lee","40.85093","-73.97014","1","0","0","0","0","0","1","0","0","0","0","0","0","0","1","0","1","0","0","1","0","0","1"
"Fort Myers","26.62168","-81.84059","2","0","0","0","0","0","2","0","1","1","0","2","0","0","2","0","2","0","1","1","0","0","2"
"Fort Portal","0.66174","30.2748","1","0","0","0","0","0","1","0","0","1","0","1","0","0","1","0","1","0","0","1","0","0","1"
"Fort William","56.81648","-5.11208","2","0","0","0","0","0","2","0","1","1","0","2","2","0","0","0","2","0","0","1","0","1","2"
"Fort Worth","32.72541","-97.32085","1","0","0","0","0","0","1","0","0","0","0","0","1","0","0","0","1","1","0","0","0","0","1"
"Foulridge","53.87579","-2.16864","1","0","0","0","0","0","1","0","0","0","1","1","1","0","0","0","1","1","0","0","0","0","1"
"Founex","46.33277","6.19243","1","0","0","0","0","0","1","0","0","1","0","1","1","0","0","0","1","0","1","0","0","0","1"
"Fountain Valley","33.70918","-117.95367","1","0","0","0","0","0","1","0","0","0","0","0","0","0","1","0","1","0","0","1","0","0","1"
"Fowlmere","52.09343","0.07433","1","0","0","0","0","0","1","0","1","0","0","1","0","0","1","0","1","0","0","1","0","0","1"
"Foxrock","53.26667","-6.17417","1","0","0","0","0","0","1","0","0","0","0","0","1","0","0","0","1","0","0","1","0","0","1"
"Fraijanes","14.46528","-90.44083","1","0","0","0","0","0","1","0","1","0","0","1","1","0","0","0","1","0","1","0","0","0","1"
"Francistown","-21.17","27.50778","1","0","0","0","0","0","1","0","1","0","0","1","0","1","0","0","1","1","0","0","0","0","1"
"Frankfurt am Main","50.11552","8.68417","3","1","0","0","0","0","4","1","1","0","0","2","1","0","3","0","4","0","0","4","0","0","4"
"Franklin","42.01354","-111.80717","2","0","0","0","0","0","2","1","1","0","0","2","1","0","1","0","2","0","0","2","0","0","2"
"Franklin","40.09612","-98.95258","2","0","0","0","0","0","2","1","1","0","0","2","1","0","1","0","2","0","0","2","0","0","2"
"Franklin","31.02602","-96.48524","2","0","0","0","0","0","2","1","1","0","0","2","1","0","1","0","2","0","0","2","0","0","2"
"Franklin","29.79604","-91.5015","2","0","0","0","0","0","2","1","1","0","0","2","1","0","1","0","2","0","0","2","0","0","2"
"Franklin","39.62033","-90.044","2","0","0","0","0","0","2","1","1","0","0","2","1","0","1","0","2","0","0","2","0","0","2"
"Franklin","42.88863","-88.03842","2","0","0","0","0","0","2","1","1","0","0","2","1","0","1","0","2","0","0","2","0","0","2"
"Franklin","35.92506","-86.86889","2","0","0","0","0","0","2","1","1","0","0","2","1","0","1","0","2","0","0","2","0","0","2"
"Franklin","36.72226","-86.57722","2","0","0","0","0","0","2","1","1","0","0","2","1","0","1","0","2","0","0","2","0","0","2"
"Franklin","39.48061","-86.05499","2","0","0","0","0","0","2","1","1","0","0","2","1","0","1","0","2","0","0","2","0","0","2"
"Franklin","33.27762","-85.098","2","0","0","0","0","0","2","1","1","0","0","2","1","0","1","0","2","0","0","2","0","0","2"
"Franklin","39.55895","-84.30411","2","0","0","0","0","0","2","1","1","0","0","2","1","0","1","0","2","0","0","2","0","0","2"
"Franklin","35.18232","-83.38154","2","0","0","0","0","0","2","1","1","0","0","2","1","0","1","0","2","0","0","2","0","0","2"
"Franklin","42.52226","-83.30604","2","0","0","0","0","0","2","1","1","0","0","2","1","0","1","0","2","0","0","2","0","0","2"
"Franklin","35.72125","-80.49895","2","0","0","0","0","0","2","1","1","0","0","2","1","0","1","0","2","0","0","2","0","0","2"
"Franklin","41.39784","-79.83144","2","0","0","0","0","0","2","1","1","0","0","2","1","0","1","0","2","0","0","2","0","0","2"
"Franklin","38.64289","-79.33115","2","0","0","0","0","0","2","1","1","0","0","2","1","0","1","0","2","0","0","2","0","0","2"
"Franklin","36.67765","-76.92246","2","0","0","0","0","0","2","1","1","0","0","2","1","0","1","0","2","0","0","2","0","0","2"
"Franklin","41.12204","-74.58044","2","0","0","0","0","0","2","1","1","0","0","2","1","0","1","0","2","0","0","2","0","0","2"
"Franklin","45.03338","-73.91591","2","0","0","0","0","0","2","1","1","0","0","2","1","0","1","0","2","0","0","2","0","0","2"
"Franklin","43.44424","-71.6473","2","0","0","0","0","0","2","1","1","0","0","2","1","0","1","0","2","0","0","2","0","0","2"
"Franklin","42.08343","-71.39673","2","0","0","0","0","0","2","1","1","0","0","2","1","0","1","0","2","0","0","2","0","0","2"
"Franklin","44.58702","-68.23224","2","0","0","0","0","0","2","1","1","0","0","2","1","0","1","0","2","0","0","2","0","0","2"
"Franklin","-43.08884","147.00906","2","0","0","0","0","0","2","1","1","0","0","2","1","0","1","0","2","0","0","2","0","0","2"
"Franklin","-35.19946","149.14329","2","0","0","0","0","0","2","1","1","0","0","2","1","0","1","0","2","0","0","2","0","0","2"
"Fraser","39.94499","-105.81723","0","0","0","1","0","0","1","0","1","0","0","1","1","0","0","0","1","0","0","1","0","0","1"
"Fraser","42.5392","-82.94937","0","0","0","1","0","0","1","0","1","0","0","1","1","0","0","0","1","0","0","1","0","0","1"
"Fraser","-35.1917","149.04534","0","0","0","1","0","0","1","0","1","0","0","1","1","0","0","0","1","0","0","1","0","0","1"
"Frederick","40.09915","-104.9372","1","0","0","0","0","0","1","1","0","0","0","1","0","1","0","0","1","0","0","1","0","0","1"
"Frederick","34.39203","-99.01841","1","0","0","0","0","0","1","1","0","0","0","1","0","1","0","0","1","0","0","1","0","0","1"
"Frederick","39.41427","-77.41054","1","0","0","0","0","0","1","1","0","0","0","1","0","1","0","0","1","0","0","1","0","0","1"
"Frederiksberg","55.41618","11.56934","1","0","0","0","0","0","1","0","0","0","0","0","1","0","0","0","1","0","0","1","0","0","1"
"Frederiksberg","55.67938","12.53463","1","0","0","0","0","0","1","0","0","0","0","0","1","0","0","0","1","0","0","1","0","0","1"
"Freedom","36.93523","-121.77301","1","0","0","0","0","0","1","0","0","1","0","1","1","0","0","0","1","0","0","1","0","0","1"
"Freedom","40.68562","-80.25173","1","0","0","0","0","0","1","0","0","1","0","1","1","0","0","0","1","0","0","1","0","0","1"
"Freedom","43.8123","-71.03562","1","0","0","0","0","0","1","0","0","1","0","1","1","0","0","0","1","0","0","1","0","0","1"
"Freedom","44.53035","-69.29782","1","0","0","0","0","0","1","0","0","1","0","1","1","0","0","0","1","0","0","1","0","0","1"
"Freetown","41.76677","-71.03282","20","0","0","0","0","0","20","5","6","0","6","17","15","3","2","0","20","5","1","11","3","2","22"
"Freetown","17.04791","-61.70332","20","0","0","0","0","0","20","5","6","0","6","17","15","3","2","0","20","5","1","11","3","2","22"
"Freetown","8.43194","-13.28972","20","0","0","0","0","0","20","5","6","0","6","17","15","3","2","0","20","5","1","11","3","2","22"
"Freetown","8.48714","-13.2356","20","0","0","0","0","0","20","5","6","0","6","17","15","3","2","0","20","5","1","11","3","2","22"
"Freiburg","47.9959","7.85222","3","0","0","0","0","0","3","0","1","0","0","1","1","1","1","0","3","1","0","2","0","0","3"
"Freiburg","53.82529","9.28803","3","0","0","0","0","0","3","0","1","0","0","1","1","1","1","0","3","1","0","2","0","0","3"
"Freistadt","48.51103","14.50453","1","0","0","0","0","0","1","0","0","0","0","0","0","1","0","0","1","1","0","0","0","0","1"
"Fremantle","-32.05632","115.74557","2","0","0","0","0","0","2","0","1","1","0","2","1","0","1","0","2","1","1","0","0","0","2"
"Frimley","51.31667","-0.74544","0","1","0","0","0","0","1","0","0","1","0","1","0","0","1","0","1","0","0","1","0","0","1"
"Frinton-on-Sea","51.83061","1.24424","3","0","0","0","1","0","4","0","2","1","0","3","3","0","1","0","4","3","0","1","0","0","4"
"Frizington","54.54185","-3.4946","2","6","0","0","1","0","9","5","2","1","0","8","7","1","1","0","9","6","2","1","0","0","9"
"Frodsham","53.29485","-2.72745","1","0","0","0","0","0","1","0","0","0","0","0","1","0","0","0","1","0","0","1","0","0","1"
"Frome","18.29407","-78.15469","4","0","0","0","0","0","5","1","1","2","0","4","2","0","3","0","5","1","2","2","0","0","5"
"Frome","51.22834","-2.32211","4","0","0","0","0","0","5","1","1","2","0","4","2","0","3","0","5","1","2","2","0","0","5"
"Front Royal","38.91817","-78.19444","0","0","0","0","1","0","1","0","0","1","0","1","0","1","0","0","1","0","0","1","0","0","1"
"Fujiang","46.03267","127.45638","1","0","0","0","0","0","1","0","0","0","1","1","0","0","0","1","1","0","0","1","0","0","1"
"Fulda","43.87052","-95.60029","1","0","0","0","0","0","1","0","0","0","1","1","0","0","0","1","1","1","0","0","0","0","1"
"Fulda","50.55162","9.67518","1","0","0","0","0","0","1","0","0","0","1","1","0","0","0","1","1","1","0","0","0","0","1"
"Fulton","38.4963","-122.76999","0","0","0","0","1","0","1","1","0","0","0","1","1","0","0","0","1","0","0","1","0","0","1"
"Fulton","28.0614","-97.0411","0","0","0","0","1","0","1","1","0","0","0","1","1","0","0","0","1","0","0","1","0","0","1"
"Fulton","38.84671","-91.94796","0","0","0","0","1","0","1","1","0","0","0","1","1","0","0","0","1","0","0","1","0","0","1"
"Fulton","41.86725","-90.15957","0","0","0","0","1","0","1","1","0","0","0","1","1","0","0","0","1","0","0","1","0","0","1"
"Fulton","36.50423","-88.87423","0","0","0","0","1","0","1","1","0","0","0","1","1","0","0","0","1","0","0","1","0","0","1"
"Fulton","34.27399","-88.40921","0","0","0","0","1","0","1","1","0","0","0","1","1","0","0","0","1","0","0","1","0","0","1"
"Fulton","39.15094","-76.92303","0","0","0","0","1","0","1","1","0","0","0","1","1","0","0","0","1","0","0","1","0","0","1"
"Fulton","43.32285","-76.41716","0","0","0","0","1","0","1","1","0","0","0","1","1","0","0","0","1","0","0","1","0","0","1"
"Funafuti","-8.52425","179.19417","1","0","0","0","0","0","1","0","0","0","0","0","0","0","0","1","1","0","0","0","0","1","1"
"Fyfield","51.41667","-1.78333","0","0","0","0","1","0","1","0","1","0","0","1","1","0","0","0","1","0","0","1","0","0","1"
"Fyfield","51.74065","0.26976","0","0","0","0","1","0","1","0","1","0","0","1","1","0","0","0","1","0","0","1","0","0","1"
"Fylde","53.83333","-2.91667","1","0","0","0","0","0","1","1","0","0","0","1","0","1","0","0","1","0","0","1","0","0","1"
"Gaalkacyo","6.76972","47.43083","1","0","0","0","0","0","1","1","0","0","0","1","1","0","0","0","1","0","0","1","0","0","1"
"Gaborone","-24.65451","25.90859","4","0","0","0","0","0","4","0","2","0","2","4","3","0","0","0","3","1","0","2","0","1","4"
"Gabrovo","41.8","25.26667","2","0","0","0","0","0","2","0","0","1","0","1","0","1","1","0","2","1","0","1","0","0","2"
"Gabrovo","42.87472","25.33417","2","0","0","0","0","0","2","0","0","1","0","1","0","1","1","0","2","1","0","1","0","0","2"
"Gaerwen","53.22112","-4.27362","0","0","0","0","0","0","1","1","0","0","0","1","1","0","0","0","1","0","0","1","0","0","1"
"Gafsa","34.425","8.78417","2","0","0","0","0","0","2","0","1","1","0","2","0","0","2","0","2","0","0","2","0","0","2"
"Gaibandha","25.3293","89.5438","2","0","0","0","0","0","2","0","1","0","1","2","2","0","0","0","2","0","1","1","0","0","2"
"Gaillimh","53.27245","-9.05095","1","0","0","0","0","0","1","0","0","1","0","1","0","0","1","0","1","0","1","0","0","0","1"
"Gainesville","33.62594","-97.13335","2","0","0","0","0","0","2","0","0","1","0","1","1","0","1","0","2","0","1","1","0","0","2"
"Gainesville","36.60312","-92.42822","2","0","0","0","0","0","2","0","0","1","0","1","1","0","1","0","2","0","1","1","0","0","2"
"Gainesville","34.29788","-83.82407","2","0","0","0","0","0","2","0","0","1","0","1","1","0","1","0","2","0","1","1","0","0","2"
"Gainesville","29.65163","-82.32483","2","0","0","0","0","0","2","0","0","1","0","1","1","0","1","0","2","0","1","1","0","0","2"
"Gainesville","38.79567","-77.61388","2","0","0","0","0","0","2","0","0","1","0","1","1","0","1","0","2","0","1","1","0","0","2"
"Gainford","54.54718","-1.73601","1","0","0","0","0","0","1","0","0","1","0","1","0","0","1","0","1","0","0","1","0","0","1"
"Gainsborough","53.38333","-0.76667","3","0","0","0","0","0","3","1","0","0","0","1","1","1","1","0","3","0","1","1","0","1","3"
"Galanta","48.19001","17.72747","1","0","0","0","0","0","1","0","0","1","0","1","1","0","0","0","1","0","0","1","0","0","1"
"Galashiels","55.61458","-2.80695","2","1","0","0","0","0","3","0","2","1","0","3","1","1","1","0","3","1","2","0","0","0","3"
"Galaţi","45.43687","28.05028","3","0","0","0","0","0","3","0","0","2","1","3","0","0","2","1","3","0","1","2","0","0","3"
"Galgate","53.99362","-2.79201","1","0","0","0","0","0","1","0","1","0","0","1","0","1","0","0","1","0","1","0","0","0","1"
"Galița","44.09995","27.49117","0","0","0","0","1","0","1","0","0","0","0","0","0","1","0","0","1","1","0","0","0","0","1"
"Galle","6.0461","80.2103","2","0","0","0","0","0","2","1","0","0","1","2","1","0","0","1","2","0","0","0","1","1","2"
"Gambat","27.3517","68.5215","1","0","0","0","0","0","1","1","0","0","0","1","1","0","0","0","1","0","0","1","0","0","1"
"Gambēla","8.25","34.58333","1","0","0","0","1","0","2","0","1","1","0","2","0","1","0","0","1","1","0","0","0","1","2"
"Gampaha","7.0897","79.9925","3","0","0","0","1","0","4","4","0","0","0","4","1","1","1","1","4","0","0","4","0","0","4"
"Gandhinagar","23.21667","72.68333","1","0","0","0","0","0","1","1","0","0","0","1","0","0","0","0","0","0","0","0","0","0","0"
"Ganja","40.68278","46.36056","1","0","0","0","0","0","2","0","0","1","1","2","0","1","0","1","2","1","0","1","0","0","2"
"Gänserndorf","48.33925","16.72016","1","0","0","0","0","0","1","1","0","0","0","1","1","0","0","0","1","0","0","1","0","0","1"
